county,school,total_enrollment,american_indian_alaskan_native,asian,asian_pacific_islander,pacific_islander,black,hispanic,white,two_or_more_race,male,female,num_free_reduced_meals,district_number,city,zip,school_code,year
grays harbor,a j west elementary,410,19,9,0,9,4,182,184,12,221,189,286,14005,aberdeen,98520,2834,2015
grays harbor,central park elementary,174,5,3,0,3,1,25,121,19,87,87,91,14005,aberdeen,98520,3216,2015
grays harbor,harbor high,116,6,1,0,1,2,23,76,8,64,52,87,14005,aberdeen,98520,3857,2015
grays harbor,hopkins elementary,39,0,0,0,0,1,9,24,5,23,16,51,14005,aberdeen,98520,3154,2015
grays harbor,j m weatherwax high,909,37,33,5,38,14,225,568,27,477,432,480,14005,aberdeen,98520,3476,2015
grays harbor,mcdermoth elementary,373,14,7,0,7,3,112,215,22,177,196,233,14005,aberdeen,98520,2449,2015
grays harbor,miller junior high,443,20,11,3,14,4,118,274,13,219,224,296,14005,aberdeen,98520,2305,2015
grays harbor,robert gray elementary,303,8,2,0,2,2,102,168,21,147,156,228,14005,aberdeen,98520,2763,2015
grays harbor,stevens elementary,475,32,19,2,21,10,156,228,28,248,227,352,14005,aberdeen,98520,2971,2015
lewis,adna elementary,246,1,3,0,3,2,16,223,1,132,114,68,21226,adna,98522,2227,2015
lewis,adna middle/high,366,2,1,0,1,1,19,330,13,192,174,83,21226,adna,98522,2441,2015
lincoln,almira elementary,114,0,2,0,2,1,8,99,4,62,52,47,22017,almira,99103,2860,2015
skagit,anacortes high,813,9,28,1,29,14,67,686,6,401,412,186,29103,anacortes,98221,2467,2015
skagit,anacortes middle,366,3,22,2,24,7,24,302,6,183,183,113,29103,anacortes,98221,2707,2015
skagit,cap sante high,49,1,0,0,0,0,4,43,1,20,29,27,29103,anacortes,98221,5176,2015
skagit,fidalgo elementary,432,3,12,2,14,6,37,362,10,231,201,125,29103,anacortes,98221,3182,2015
skagit,island view elementary,416,2,13,0,13,6,41,349,5,206,210,164,29103,anacortes,98221,3252,2015
skagit,mount erie elementary,488,2,15,2,17,8,47,401,13,245,243,152,29103,anacortes,98221,3057,2015
skagit,whitney elementary anacortes,125,0,2,1,3,1,7,111,3,70,55,34,29103,anacortes,98221,3404,2015
snohomish,arlington high,1646,23,32,18,50,21,156,1356,40,850,796,382,31016,arlington,98223,2523,2015
snohomish,arlington special educ,21,1,0,0,0,0,4,15,1,12,9,8,31016,arlington,98223,2277,2015
snohomish,eagle creek elementary,549,4,4,0,4,2,110,400,29,309,240,272,31016,arlington,98223,4327,2015
snohomish,haller middle,678,8,20,6,26,10,82,523,29,337,341,183,31016,arlington,98223,5010,2015
snohomish,kent prairie elementary,607,4,7,1,8,7,71,469,48,316,291,263,31016,arlington,98223,4436,2015
snohomish,pioneer elementary,603,2,9,3,12,11,66,467,45,305,298,174,31016,arlington,98223,4573,2015
snohomish,post middle,565,8,11,2,13,4,67,455,18,284,281,220,31016,arlington,98223,3124,2015
snohomish,presidents elementary,570,11,0,0,0,5,68,435,51,311,259,249,31016,arlington,98223,4154,2015
snohomish,weston high,131,1,0,0,0,1,15,108,6,75,56,78,31016,arlington,98223,4287,2015
asotin,asotin elementary,279,1,0,0,0,1,16,241,20,134,145,84,02420,asotin,99402,2507,2015
asotin,asotin jr sr high,341,4,3,0,3,0,26,292,16,167,174,94,02420,asotin,99402,2434,2015
king,alpac elementary,525,2,52,16,68,13,137,252,53,277,248,351,17408,pacific,98047,3825,2015
king,arthur jacobsen elementary,578,0,83,11,94,46,127,256,55,279,299,287,17408,auburn,98092,5082,2015
king,auburn mountainview high,1531,11,143,26,169,129,230,889,103,781,750,577,17408,auburn,98092,5037,2015
king,auburn riverside high,1636,9,172,31,203,83,381,842,118,786,850,572,17408,auburn,98092,4474,2015
king,auburn senior high,1554,54,87,58,145,122,381,726,126,822,732,840,17408,auburn,98002,2795,2015
king,cascade middle,734,2,52,39,91,68,163,352,58,394,340,461,17408,auburn,98002,2394,2015
king,chinook elementary,389,61,9,10,19,17,164,88,40,213,176,291,17408,auburn,98092,3439,2015
king,dick scobee elementary,505,1,26,32,58,51,128,204,63,259,246,423,17408,auburn,98002,2932,2015
king,evergreen heights elementary,530,0,61,19,80,61,119,205,65,249,281,307,17408,auburn,98001,3745,2015
king,gildo rey elementary,599,5,30,51,81,27,300,134,52,303,296,482,17408,auburn,98002,3669,2015
king,hazelwood elementary,578,5,39,13,52,14,156,306,45,289,289,294,17408,auburn,98092,4347,2015
king,ilalko elementary,626,7,50,20,70,20,186,265,78,307,319,369,17408,auburn,98092,4417,2015
king,lake view elementary,347,0,11,3,14,1,49,253,30,186,161,152,17408,auburn,98092,4120,2015
king,lakeland hills elementary,671,6,73,3,76,31,132,355,71,327,344,163,17408,auburn,98092,5051,2015
king,lea hill elementary,402,1,23,9,32,72,59,187,51,221,181,266,17408,auburn,98092,3525,2015
king,mt baker middle,913,5,75,24,99,47,270,418,74,461,452,460,17408,auburn,98002,4462,2015
king,olympic middle,701,35,42,48,90,39,253,231,53,372,329,507,17408,auburn,98002,3169,2015
king,pioneer elementary,494,1,22,24,46,16,299,100,32,239,255,417,17408,auburn,98002,3227,2015
king,rainier middle,881,4,86,12,98,94,160,470,55,446,435,427,17408,auburn,98092,4385,2015
king,special ed,109,1,7,3,10,6,36,49,7,68,41,8,17408,auburn,98002,1915,2015
king,terminal park elementary,411,3,17,30,47,34,98,172,57,205,206,301,17408,auburn,98002,2659,2015
king,washington elementary,461,0,11,40,51,41,128,159,82,214,247,359,17408,auburn,98002,2326,2015
king,west auburn senior high,261,8,5,6,11,14,92,99,37,122,139,183,17408,auburn,98001,2702,2015
kitsap,bainbridge high,1261,5,54,1,55,13,68,1033,87,622,639,78,18303,bainbridge island,98110,2395,2015
kitsap,bainbridge special education services,34,1,1,0,1,0,1,31,0,25,9,0,18303,bainbridge island,98110,1939,2015
kitsap,capt johnston blakely elem,365,5,9,0,9,2,18,306,25,205,160,34,18303,bainbridge island,98110,3552,2015
kitsap,capt. charles wilkes elem,395,0,7,0,7,0,25,326,37,219,176,20,18303,bainbridge island,98110,3043,2015
kitsap,eagle harbor high,144,0,3,0,3,0,6,125,10,75,69,16,18303,bainbridge island,98110,1935,2015
kitsap,mosaic home education partnership,57,0,0,0,0,0,5,46,6,30,27,7,18303,bainbridge island,98110,1841,2015
kitsap,odyssey multiage program,126,0,4,2,6,1,5,109,5,67,59,3,18303,bainbridge island,98110,1699,2015
kitsap,ordway elementary,402,3,19,0,19,4,37,290,49,193,209,50,18303,bainbridge island,98110,4062,2015
kitsap,sakai intermediate,574,4,17,0,17,2,47,466,38,283,291,48,18303,bainbridge island,98110,4542,2015
kitsap,woodward middle,538,5,21,1,22,5,37,408,61,276,262,39,18303,bainbridge island,98110,4505,2015
clark,amboy middle,616,1,0,0,0,0,19,586,10,314,302,234,06119,battle ground,98604,2671,2015
clark,battle ground high,2183,4,20,10,30,15,152,1889,93,1176,1007,661,06119,battle ground,98604,2415,2015
clark,cam academy,586,0,11,0,11,0,27,521,27,283,303,76,06119,battle ground,98604,1836,2015
clark,captain strong,651,1,6,1,7,4,71,535,33,356,295,307,06119,battle ground,98604,4352,2015
clark,chief umtuch middle,593,3,12,3,15,3,55,484,33,334,259,235,06119,battle ground,98604,5133,2015
clark,daybreak middle,509,1,8,3,11,2,45,424,26,263,246,214,06119,battle ground,98604,5089,2015
clark,daybreak primary,577,1,5,2,7,5,51,482,31,300,277,276,06119,battle ground,98604,5090,2015
clark,glenwood heights primary,642,0,21,2,23,8,61,515,35,303,339,264,06119,vancouver,98662,3018,2015
clark,homelink river,965,3,12,1,13,13,63,826,47,443,522,278,06119,battle ground,98604,1875,2015
clark,laurin middle,593,1,31,2,33,6,70,453,30,299,294,227,06119,battle ground,98604,3545,2015
clark,maple grove k-8,498,1,15,5,20,1,52,395,29,243,255,244,06119,battle ground,98604,5291,2015
clark,open doors battle ground,1,0,0,0,0,1,0,0,0,0,1,6,06119,battle ground,98604,5360,2015
clark,pleasant valley middle,497,5,14,2,16,3,81,352,40,256,241,186,06119,vancouver,98686,3997,2015
clark,pleasant valley primary,604,6,38,9,47,6,75,422,48,297,307,248,06119,battle ground,98604,3996,2015
clark,prairie high,1555,3,56,4,60,13,170,1202,107,786,769,432,06119,battle ground,98604,4104,2015
clark,preschool infant other,32,0,1,1,2,1,3,25,1,19,13,16,06119,battle ground,98604,4108,2015
clark,summit view high,413,3,1,0,1,1,22,366,20,215,198,229,06119,battle ground,98604,4450,2015
clark,tukes valley middle,533,0,3,0,3,2,38,472,18,263,270,187,06119,battle ground,98604,5131,2015
clark,tukes valley primary,643,0,2,0,2,0,50,550,41,327,316,225,06119,battle ground,98642,5132,2015
clark,yacolt primary,821,1,0,0,0,0,18,780,22,438,383,345,06119,yacolt,98675,2910,2015
king,ardmore elementary,343,0,74,2,76,29,117,97,24,170,173,169,17405,bellevue,98008,3633,2015
king,bellevue big picture,343,1,67,0,67,11,23,215,26,196,147,40,17405,bellevue,98007,5240,2015
king,bellevue high,1544,3,417,5,422,50,103,828,138,870,674,142,17405,bellevue,98004,2701,2015
king,bennett elementary,476,0,179,1,180,5,29,234,28,251,225,18,17405,bellevue,98008,3705,2015
king,central educational services,90,0,21,0,21,3,23,35,8,65,25,16,17405,bellevue,98009,5281,2015
king,cherry crest elementary,574,0,279,0,279,6,18,224,47,295,279,20,17405,bellevue,98005,3742,2015
king,chinook middle,1026,0,285,2,287,26,63,533,117,515,511,124,17405,bellevue,98006,3338,2015
king,clyde hill elementary,662,2,251,1,252,11,38,308,51,344,318,25,17405,bellevue,98007,2847,2015
king,eastgate elementary,443,3,144,1,145,7,32,200,56,251,192,81,17405,bellevue,98006,3036,2015
king,enatai elementary,543,0,139,0,139,19,57,271,57,274,269,96,17405,bellevue,98007,2846,2015
king,highland middle,532,0,106,0,106,22,156,204,44,273,259,233,17405,bellevue,98006,3166,2015
king,interlake senior high,1590,2,531,2,533,46,230,647,132,828,762,313,17405,bellevue,98008,3588,2015
king,international,568,1,193,0,193,5,15,292,62,269,299,30,17405,bellevue,98005,3522,2015
king,jing mei elementary,176,0,100,0,100,1,8,30,37,75,101,9,17405,bellevue,98006,5308,2015
king,lake hills elementary,485,3,87,0,87,17,207,133,38,231,254,305,17405,bellevue,98007,3225,2015
king,medina elementary,555,1,220,0,220,1,16,272,45,292,263,12,17405,medina,98039,3436,2015
king,newport heights elementary,624,3,199,7,206,15,47,280,73,350,274,134,17405,bellevue,98006,3437,2015
king,newport senior high,1730,3,747,3,750,37,85,710,145,885,845,162,17405,bellevue,98006,3486,2015
king,odle middle,782,2,407,0,407,22,108,188,55,437,345,208,17405,bellevue,98007,3631,2015
king,phantom lake elementary,406,0,89,1,90,13,76,183,44,229,177,135,17405,bellevue,98008,3168,2015
king,puesta del sol elementary,571,0,71,0,71,5,117,313,65,279,292,32,17405,bellevue,98006,3224,2015
king,sammamish senior high,949,4,190,0,190,50,191,443,71,504,445,299,17405,bellevue,98005,3282,2015
king,sherwood forest elementary,430,0,94,1,95,38,127,132,38,225,205,206,17405,bellevue,98008,3339,2015
king,somerset elementary,709,0,470,0,470,5,19,159,56,359,350,35,17405,bellevue,98006,3789,2015
king,spiritridge elementary,614,0,287,1,288,9,28,238,51,301,313,64,17405,bellevue,98008,3634,2015
king,stevenson elementary,460,0,210,1,211,25,160,46,18,234,226,238,17405,bellevue,98007,3100,2015
king,tillicum middle,706,0,126,3,129,21,82,415,59,331,375,118,17405,bellevue,98008,3435,2015
king,tyee middle,907,0,436,1,437,13,61,297,99,482,425,140,17405,bellevue,98006,3283,2015
king,woodridge elementary,625,0,257,7,264,25,54,230,52,338,287,134,17405,bellevue,98005,3167,2015
whatcom,alderwood elementary,244,6,17,1,18,5,103,102,10,132,112,192,37501,bellingham,98225,3200,2015
whatcom,bellingham high,1067,14,25,1,26,11,137,798,81,534,533,290,37501,bellingham,98225,2553,2015
whatcom,bellingham re-engagement program,23,2,0,0,0,1,4,15,1,10,13,23,37501,bellingham,98225,5340,2015
whatcom,birchwood elementary,295,4,12,8,20,5,96,152,18,153,142,209,37501,bellingham,98225,2431,2015
whatcom,carl cozier elementary,271,3,14,1,15,5,52,179,17,137,134,161,37501,bellingham,98229,2817,2015
whatcom,columbia elementary,275,0,4,0,4,2,22,234,13,148,127,54,37501,bellingham,98225,2365,2015
whatcom,cordata elementary,362,2,54,1,55,7,77,189,32,190,172,266,37501,bellingham,98226,5239,2015
whatcom,fairhaven middle,623,6,33,2,35,8,45,484,45,331,292,121,37501,bellingham,98225,2066,2015
whatcom,geneva elementary,431,2,2,1,3,12,39,346,29,239,192,119,37501,bellingham,98229,2262,2015
whatcom,happy valley elementary,412,1,22,1,23,4,42,315,27,213,199,136,37501,bellingham,98225,3134,2015
whatcom,kulshan middle,601,4,12,0,12,9,123,403,50,315,286,245,37501,bellingham,98229,4442,2015
whatcom,northern heights elementary,438,5,39,1,40,9,58,285,41,222,216,146,37501,bellingham,98226,4571,2015
whatcom,options high,97,4,0,0,0,2,19,60,12,43,54,54,37501,bellingham,98225,1647,2015
whatcom,parkview elementary,297,3,3,0,3,6,37,217,31,157,140,109,37501,bellingham,98225,3202,2015
whatcom,roosevelt elementary,418,5,14,0,14,6,101,258,34,217,201,250,37501,bellingham,98226,2067,2015
whatcom,sehome high,1140,9,60,3,63,11,114,861,82,614,526,263,37501,bellingham,98225,3576,2015
whatcom,shuksan middle,607,11,74,3,77,8,169,299,43,299,308,382,37501,bellingham,98225,3201,2015
whatcom,silver beach elementary,427,1,18,0,18,2,35,335,36,229,198,89,37501,bellingham,98226,2175,2015
whatcom,squalicum high,1375,19,132,11,143,19,245,861,88,697,678,552,37501,bellingham,98226,4515,2015
whatcom,sunnyland elementary,303,5,21,1,22,3,51,200,22,157,146,181,37501,bellingham,98225,2387,2015
whatcom,visions (seamar youth center),26,1,0,0,0,2,3,20,0,0,26,10,37501,bellingham,98225,1799,2015
whatcom,wade king elementary,452,3,24,1,25,7,40,347,30,238,214,84,37501,bellingham,98229,5125,2015
whatcom,whatcom middle,601,6,29,1,30,7,47,476,35,316,285,152,37501,bellingham,98225,2075,2015
adams,benge elementary,14,0,1,0,1,0,0,13,0,8,6,0,01122,benge,99105,3142,2015
pierce,acceleration academy,98,7,7,0,7,12,8,56,8,56,42,65,27403,spanaway,98387,5372,2015
pierce,bethel high,1621,31,101,38,139,135,206,1037,73,869,752,657,27403,spanaway,98387,2807,2015
pierce,bethel middle,659,11,35,25,60,74,117,344,53,324,335,322,27403,spanaway,98387,3250,2015
pierce,camas prairie elementary,578,6,36,25,61,77,87,289,58,313,265,317,27403,spanaway,98387,4296,2015
pierce,cedarcrest middle,625,12,56,34,90,85,105,279,54,337,288,353,27403,spanaway,98387,4186,2015
pierce,centennial elementary bethel,469,4,13,7,20,23,56,321,45,261,208,274,27403,graham,98338,4331,2015
pierce,challenger high,308,6,14,10,24,26,48,188,16,158,150,166,27403,spanaway,98387,1510,2015
pierce,chester h thompson elementary,524,5,14,37,51,54,131,208,75,246,278,384,27403,tacoma,98445,3649,2015
pierce,clover creek elementary,645,4,21,23,44,57,99,358,83,342,303,303,27403,tacoma,98446,2576,2015
pierce,cougar mountain middle,562,17,21,6,27,22,58,417,21,306,256,254,27403,graham,98338,4578,2015
pierce,elk plain school of choice,486,4,19,2,21,43,72,289,57,243,243,135,27403,spanaway,98397,2877,2015
pierce,evergreen elementary,466,5,33,38,71,31,111,188,60,250,216,316,27403,spanaway,98387,4099,2015
pierce,frederickson elementary,559,5,20,17,37,42,125,275,75,310,249,264,27403,puyallup,98375,5159,2015
pierce,frontier middle,743,18,27,4,31,28,81,542,43,386,357,262,27403,graham,98338,4407,2015
pierce,graham elementary,685,3,14,5,19,36,88,450,89,358,327,212,27403,graham,98338,4297,2015
pierce,graham kapowsin high,1839,31,96,18,114,119,217,1271,87,938,901,517,27403,graham,98338,5033,2015
pierce,kapowsin elementary,383,2,3,3,6,6,24,307,38,221,162,144,27403,graham,98338,2748,2015
pierce,liberty middle,719,13,32,14,46,66,103,445,46,373,346,274,27403,spanaway,98387,5206,2015
pierce,naches trail elementary,455,7,19,12,31,22,61,246,88,232,223,222,27403,tacoma,98446,4102,2015
pierce,nelson elementary,584,10,15,12,27,7,76,410,54,292,292,230,27403,graham,98338,5160,2015
pierce,north star elementary,490,3,12,8,20,22,60,330,55,255,235,200,27403,graham,98338,4538,2015
pierce,pioneer valley elementary,476,4,16,16,32,29,76,275,60,256,220,205,27403,spanaway,98387,4381,2015
pierce,rocky ridge elementary,475,6,6,4,10,10,83,330,36,234,241,276,27403,graham,98338,4227,2015
pierce,roy elementary,278,1,2,3,5,4,33,210,25,142,136,156,27403,roy,98580,2543,2015
pierce,shining mountain elementary,639,2,21,35,56,28,148,309,96,356,283,363,27403,spanaway,98387,4103,2015
pierce,spanaway elementary,351,4,11,13,24,35,58,163,67,184,167,210,27403,spanaway,98387,2399,2015
pierce,spanaway lake high,1647,26,167,85,252,310,256,700,102,874,773,767,27403,spanaway,98387,4158,2015
pierce,spanaway middle,723,18,58,36,94,88,143,323,57,378,345,427,27403,tacoma,98445,3751,2015
pierce,thompson preschool,24,0,0,0,0,1,10,11,2,16,8,26,27403,tacoma,98445,1560,2015
klickitat,bickleton elementary & high,84,0,1,0,1,2,23,55,3,43,41,17,20203,bickleton,99322,3392,2015
whatcom,blaine elementary,449,4,10,6,16,6,60,341,22,239,210,224,37503,blaine,98230,2713,2015
whatcom,blaine high,686,6,20,9,29,9,101,500,41,360,326,282,37503,blaine,98230,3136,2015
whatcom,blaine home connections,67,0,0,1,1,2,1,60,3,35,32,4,37503,blaine,98230,5021,2015
whatcom,blaine middle,471,3,10,11,21,7,55,359,26,239,232,238,37503,blaine,98230,3796,2015
whatcom,blaine primary,505,4,21,4,25,5,53,385,33,251,254,235,37503,blaine,98230,4476,2015
whatcom,point roberts primary,18,0,0,0,0,0,0,16,2,5,13,0,37503,point roberts,98281,4459,2015
lewis,boistfort elem,88,1,0,0,0,0,8,79,0,51,37,61,21234,curtis,98538,2516,2015
kitsap,armin jahr elementary,462,10,18,14,32,22,101,223,74,219,243,355,18100,bremerton,98310,3641,2015
kitsap,bremerton high,1239,20,77,31,108,63,208,643,197,676,563,668,18100,bremerton,98337,3109,2015
kitsap,bremerton home link program,27,0,0,0,0,0,3,24,0,15,12,20,18100,bremerton,98312,1749,2015
kitsap,crownhill elementary,410,3,4,5,9,19,76,226,77,229,181,240,18100,bremerton,98312,3108,2015
kitsap,kitsap lake elementary,404,2,12,5,17,25,68,230,62,192,212,209,18100,bremerton,98312,4421,2015
kitsap,mountain view middle,831,6,31,26,57,40,144,433,151,448,383,508,18100,bremerton,98310,4441,2015
kitsap,naval avenue elementary,374,2,6,11,17,25,100,171,59,178,196,224,18100,bremerton,98312,3171,2015
kitsap,renaissance alternative high,194,6,1,5,6,12,21,119,30,108,86,139,18100,bremerton,98312,1737,2015
kitsap,special services,52,0,0,1,1,4,10,26,11,32,20,33,18100,bremerton,98312,5161,2015
kitsap,west hills s.t.e.m. academy,653,8,33,15,48,41,116,338,102,358,295,451,18100,bremerton,98312,2613,2015
okanogan,brewster alternative,20,0,0,0,0,0,19,1,0,12,8,19,24111,brewster,98812,5272,2015
okanogan,brewster high,250,2,0,0,0,0,212,34,2,135,115,212,24111,brewster,98812,2800,2015
okanogan,brewster middle,219,3,0,0,0,0,199,16,1,114,105,189,24111,brewster,98812,4223,2015
douglas,bridgeport aurora high,17,0,1,0,1,0,14,2,0,11,6,14,09075,bridgeport,98813,1900,2015
douglas,bridgeport elementary,437,0,1,0,1,0,398,33,5,216,221,369,09075,bridgeport,98813,2562,2015
douglas,bridgeport high,209,0,0,0,0,1,173,33,2,107,102,170,09075,bridgeport,98813,2788,2015
douglas,bridgeport middle,174,1,0,0,0,0,165,7,1,98,76,160,09075,bridgeport,98813,4213,2015
jefferson,brinnon elementary,43,0,0,1,1,0,4,35,3,24,19,37,16046,brinnon,98320,2836,2015
skagit,allen elementary,433,3,9,1,10,2,267,136,15,220,213,337,29100,bow,98232,3603,2015
skagit,bay view elementary,533,4,11,1,12,3,120,373,21,280,253,175,29100,burlington,98233,4412,2015
skagit,becc,38,0,2,0,2,0,21,14,1,26,12,25,29100,burlington,98233,1650,2015
skagit,burlington edison high,1131,14,23,3,26,11,355,700,25,580,551,430,29100,burlington,98233,2362,2015
skagit,burlington-edison alternative,57,2,0,0,0,1,32,22,0,30,27,28,29100,burlington,98233,1928,2015
skagit,edison elementary - burlington/edison,484,6,4,1,5,7,63,386,17,259,225,127,29100,edison,98232,2379,2015
skagit,lucille umbarger elementary,684,9,10,1,11,1,340,299,24,346,338,437,29100,burlington,98233,3251,2015
skagit,west view elementary,426,1,6,0,6,0,297,116,6,204,222,301,29100,burlington,98233,2946,2015
clark,camas high,2005,8,128,10,138,20,138,1567,134,1038,967,281,06117,camas,98607,4567,2015
clark,dorothy fox,476,3,35,3,38,2,34,350,49,248,228,51,06117,camas,98607,4182,2015
clark,grass valley elementary,526,0,41,2,43,8,45,371,59,256,270,56,06117,camas,98607,5158,2015
clark,hayes freedom high,134,0,3,1,4,1,7,117,5,73,61,56,06117,camas,98607,5104,2015
clark,helen baller elem,553,1,17,0,17,4,51,441,39,279,274,111,06117,camas,98607,2725,2015
clark,liberty middle,743,2,17,2,19,9,63,603,47,383,360,155,06117,camas,98607,5054,2015
clark,papermaker preschool,50,0,1,0,1,0,6,36,7,35,15,17,06117,camas,98607,5055,2015
clark,prune hill elem,483,3,56,2,58,2,38,351,31,240,243,77,06117,camas,98607,4563,2015
clark,skyridge middle,894,4,71,7,78,8,65,662,77,437,457,81,06117,camas,98607,4508,2015
clark,woodburn elementary,396,0,20,0,20,1,40,301,34,209,187,118,06117,camas,98607,5309,2015
clallam,cape flattery preschool,9,6,0,0,0,0,0,2,1,7,2,0,05401,sekiu,98381,1787,2015
clallam,clallam bay high & elementary,119,8,0,0,0,0,28,63,20,59,60,66,05401,clallam bay,98326,3422,2015
clallam,neah bay elementary,155,99,0,0,0,0,27,6,23,74,81,131,05401,neah bay,98357,2594,2015
clallam,neah bay junior/ senior high,173,93,0,0,0,0,31,9,40,87,86,120,05401,neah bay,98357,3145,2015
pierce,carbonado historical school 19,183,0,1,0,1,0,9,163,10,94,89,53,27019,carbonado,98323,2466,2015
chelan,beaver valley,35,0,0,0,0,0,0,35,0,20,15,10,04228,leavenworth,98826,4566,2015
chelan,cascade high,450,5,5,0,5,1,133,303,3,236,214,157,04228,leavenworth,98826,3564,2015
chelan,icicle river middle,305,4,4,0,4,2,85,207,3,149,156,142,04228,leavenworth,98826,4403,2015
chelan,cashmere high,485,5,6,0,6,3,175,291,5,237,248,187,04222,cashmere,98815,3268,2015
chelan,cashmere middle,476,3,2,0,2,4,181,276,10,235,241,233,04222,cashmere,98815,2315,2015
chelan,vale elementary,585,0,3,0,3,2,249,320,11,298,287,310,04222,cashmere,98815,2787,2015
cowlitz,castle rock elementary,593,3,4,3,7,1,58,485,39,306,287,299,08401,castle rock,98611,2762,2015
cowlitz,castle rock high,398,9,4,4,8,2,41,318,20,217,181,168,08401,castle rock,98611,2281,2015
cowlitz,castle rock middle,282,2,1,3,4,1,27,231,17,146,136,143,08401,castle rock,98611,3969,2015
klickitat,centerville elementary,81,0,0,1,1,0,2,78,0,45,36,34,20215,centerville,98613,2251,2015
kitsap,brownsville elementary,429,1,12,5,17,5,47,277,82,223,206,130,18401,bremerton,98311,2994,2015
kitsap,central kitsap high,1513,7,112,12,124,46,146,954,236,764,749,339,18401,silverdale,98383,2615,2015
kitsap,clear creek elementary,553,1,21,4,25,23,102,343,59,304,249,250,18401,silverdale,98383,4016,2015
kitsap,cottonwood elementary,360,1,26,11,37,9,38,194,81,187,173,150,18401,bremerton,98311,4014,2015
kitsap,cougar valley elementary,506,6,10,1,11,22,56,349,62,264,242,168,18401,silverdale,98383,4341,2015
kitsap,emerald heights elementary,626,3,34,7,41,13,79,400,90,326,300,160,18401,silverdale,98383,4444,2015
kitsap,esquire hills elementary,396,4,24,10,34,15,44,222,77,205,191,209,18401,bremerton,98311,4015,2015
kitsap,green mountain elementary,427,0,1,2,3,6,39,330,49,202,225,155,18401,bremerton,98312,4393,2015
kitsap,klahowya secondary,931,4,17,4,21,9,74,737,86,497,434,256,18401,silverdale,98383,4509,2015
kitsap,olympic high,1168,8,102,25,127,58,132,594,249,646,522,443,18401,bremerton,98311,4100,2015
kitsap,pinecrest elementary,505,0,25,5,30,22,83,270,100,260,245,257,18401,bremerton,98311,4527,2015
kitsap,silver ridge elementary,449,3,23,4,27,4,61,267,87,238,211,139,18401,silverdale,98383,4372,2015
kitsap,silverdale elementary,474,1,31,6,37,10,45,312,69,248,226,191,18401,silverdale,98383,4101,2015
kitsap,woodlands elementary,449,2,34,9,43,15,68,224,97,227,222,271,18401,bremerton,98311,4135,2015
spokane,adams elementary,454,0,14,4,18,5,31,387,13,232,222,235,32356,spokane valley,99037,3259,2015
spokane,bowdish middle,508,5,6,2,8,17,36,399,43,268,240,260,32356,spokane valley,99206,3260,2015
spokane,broadway elementary,472,5,4,13,17,8,70,336,36,257,215,356,32356,spokane valley,99206,2892,2015
spokane,central valley high,2046,12,35,9,44,30,117,1761,82,1055,991,584,32356,spokane valley,99037,3065,2015
spokane,chester elementary,341,1,7,0,7,4,19,301,9,177,164,78,32356,spokane valley,99206,3929,2015
spokane,evergreen middle,695,3,10,2,12,4,40,604,32,376,319,266,32356,spokane valley,99206,3890,2015
spokane,greenacres elementary,629,8,5,0,5,4,49,535,28,336,293,249,32356,spokane valley,99016,2157,2015
spokane,greenacres middle,770,1,21,2,23,3,53,652,38,384,386,190,32356,spokane valley,99016,3573,2015
spokane,horizon middle,484,10,3,1,4,3,23,419,25,240,244,141,32356,spokane valley,99206,4185,2015
spokane,i-tracc,75,0,0,0,0,1,3,70,1,30,45,65,32356,spokane valley,99037,5166,2015
spokane,liberty lake elementary,672,1,15,0,15,5,23,602,26,342,330,114,32356,liberty lake,99019,4529,2015
spokane,mcdonald elementary,346,10,1,0,1,11,24,289,11,192,154,206,32356,spokane valley,99216,3127,2015
spokane,north pines middle,499,9,10,11,21,21,50,376,22,261,238,353,32356,spokane valley,99206,2776,2015
spokane,opportunity elementary,472,7,13,4,17,15,44,372,17,242,230,339,32356,spokane valley,99206,2113,2015
spokane,ponderosa elementary,343,1,0,1,1,1,20,318,2,187,156,112,32356,spokane valley,99206,4098,2015
spokane,progress elementary,394,5,8,2,10,11,35,321,12,189,205,262,32356,spokane valley,99037,2953,2015
spokane,south pines elementary,386,0,5,0,5,6,26,341,8,193,193,215,32356,spokane valley,99206,3307,2015
spokane,spokane valley learning academy,80,0,2,0,2,2,0,75,1,39,41,20,32356,spokane valley,99216,1964,2015
spokane,summit,323,1,3,0,3,2,7,299,11,156,167,68,32356,spokane valley,99216,3465,2015
spokane,sunrise elementary,578,2,8,3,11,7,28,507,23,303,275,150,32356,spokane valley,99206,4160,2015
spokane,university elementary,281,1,2,0,2,7,18,242,11,166,115,151,32356,spokane valley,99206,3064,2015
spokane,university high,1823,15,9,11,20,29,94,1552,113,952,871,655,32356,spokane valley,99216,3415,2015
lewis,centralia high,1088,8,14,4,18,12,289,730,31,571,517,591,21401,centralia,98531,2166,2015
lewis,centralia middle,538,3,3,1,4,5,175,336,15,264,274,370,21401,centralia,98531,3240,2015
lewis,edison elementary,341,0,5,1,6,1,125,189,20,166,175,275,21401,centralia,98531,2244,2015
lewis,fords prairie elementary,383,3,1,0,1,2,134,225,18,197,186,310,21401,centralia,98531,2704,2015
lewis,futurus high,79,2,0,1,1,1,24,50,1,41,38,55,21401,centralia,98531,5359,2015
lewis,jefferson lincoln elementary,502,1,1,1,2,3,176,303,17,249,253,418,21401,centralia,98531,3172,2015
lewis,oakview elementary,382,2,2,1,3,8,122,231,16,203,179,285,21401,centralia,98531,2291,2015
lewis,washington elementary,372,3,2,2,4,7,136,215,7,194,178,282,21401,centralia,98531,2768,2015
lewis,chehalis middle,642,3,11,0,11,8,93,495,32,311,331,305,21302,chehalis,98532,4311,2015
lewis,olympic elementary,413,2,4,1,5,2,79,298,27,214,199,243,21302,longview,98632,2726,2015
lewis,w f west high,972,8,17,0,17,7,137,752,51,477,495,349,21302,chehalis,98532,2799,2015
spokane,betz elementary,428,3,8,1,9,8,60,333,15,221,207,231,32360,cheney,99004,2954,2015
spokane,birth to three,32,2,1,0,1,0,2,26,1,19,13,3,32360,cheney,99004,5126,2015
spokane,cheney high,1246,14,29,4,33,19,113,969,98,635,611,457,32360,cheney,99004,3610,2015
spokane,cheney middle,488,9,6,2,8,1,56,371,43,250,238,248,32360,cheney,99004,2447,2015
spokane,homeworks,78,0,0,0,0,1,5,72,0,39,39,10,32360,cheney,99004,5035,2015
spokane,phil snowdon elementary,443,10,6,6,12,12,39,337,33,236,207,249,32360,cheney,99004,5294,2015
spokane,salnave elementary,387,4,4,1,5,6,38,315,19,210,177,236,32360,cheney,99004,3761,2015
spokane,sunset elementary,381,17,12,6,18,11,42,261,32,200,181,265,32360,airway heights,99001,2814,2015
spokane,three springs high,51,1,0,0,0,1,6,39,4,25,26,30,32360,cheney,99004,1769,2015
spokane,westwood middle,467,6,10,2,12,9,36,376,28,242,225,239,32360,spokane,99224,5269,2015
spokane,windsor elementary,454,4,5,0,5,6,27,368,44,268,186,192,32360,spokane,99224,3309,2015
stevens,gess elementary,339,1,3,2,5,3,18,302,10,198,141,241,33036,chewelah,99109,2664,2015
stevens,jenkins junior/senior high,445,3,0,0,0,5,10,423,4,228,217,212,33036,chewelah,99109,2404,2015
jefferson,chimacum creek primary,229,4,1,0,1,1,12,196,15,135,94,136,16049,chimacum,98325,4552,2015
jefferson,chimacum elementary,208,3,3,0,3,1,15,170,16,121,87,122,16049,chimacum,98325,2697,2015
jefferson,chimacum high,335,4,14,1,15,3,22,274,17,163,172,127,16049,chimacum,98325,3275,2015
jefferson,chimacum middle,221,5,1,0,1,4,19,179,13,97,124,101,16049,chimacum,98325,4261,2015
jefferson,pi program,81,1,1,1,2,0,3,68,7,40,41,30,16049,chimacum,98325,1724,2015
asotin,charles francis adams high,775,25,4,0,4,7,47,675,17,389,386,330,02250,clarkston,99403,2299,2015
asotin,educational opportunity center,148,4,0,0,0,1,17,120,6,76,72,89,02250,clarkston,99403,1617,2015
asotin,grantham elementary,257,0,0,0,0,0,24,212,21,138,119,223,02250,clarkston,99403,2962,2015
asotin,heights elementary,381,2,2,0,2,3,19,338,17,190,191,129,02250,clarkston,99403,4384,2015
asotin,highland elementary,340,4,4,0,4,3,40,266,23,151,189,265,02250,clarkston,99403,3266,2015
asotin,lincoln middle,369,9,6,0,6,4,26,312,12,173,196,216,02250,clarkston,99403,2501,2015
asotin,parkway elementary,353,7,6,0,6,14,14,308,4,192,161,248,02250,clarkston,99403,2823,2015
asotin,special services,46,1,0,0,0,1,2,37,5,32,14,30,02250,clarkston,99403,3616,2015
kittitas,cle elum roslyn elementary,405,7,2,0,2,2,35,343,16,204,201,194,19404,cle elum,98922,2328,2015
kittitas,cle elum roslyn high,283,3,5,2,7,3,29,229,12,152,131,88,19404,cle eum,98922,2329,2015
kittitas,swiftwater learning center,29,1,0,0,0,0,2,26,0,13,16,17,19404,cle elum,98922,1987,2015
kittitas,walter strom middle,204,1,2,0,2,2,17,172,10,105,99,79,19404,cle elum,98922,2570,2015
pierce,alfaretta house,123,0,0,2,2,9,26,76,10,88,35,4,27400,lakewood,98499,1825,2015
pierce,beachwood elementary,331,1,13,5,18,42,76,140,54,180,151,136,27400,jblm lewis north,98433,3454,2015
pierce,carter lake elementary,406,2,9,8,17,49,75,233,30,219,187,170,27400,jblm mcchord field,98439,3457,2015
pierce,clover park high,1223,10,99,72,171,203,442,253,144,643,580,903,27400,lakewood,98499,2425,2015
pierce,custer elementary,315,1,15,12,27,52,77,142,16,177,138,249,27400,lakewood,98498,2943,2015
pierce,dower elementary,304,2,22,18,40,54,77,81,50,154,150,235,27400,lakewood,98499,3455,2015
pierce,evergreen elementary,599,2,10,25,35,65,163,290,44,332,267,356,27400,jblm lewis main,98433,4396,2015
pierce,harrison prep,489,7,31,11,42,48,111,201,80,201,288,252,27400,lakewood,98499,5027,2015
pierce,hillside elementary,528,7,17,16,33,74,144,214,56,279,249,367,27400,jblm lewis main,98433,3298,2015
pierce,hudtloff middle,759,3,45,21,66,92,242,255,101,398,361,492,27400,lakewood,98498,3248,2015
pierce,idlewild elementary,450,0,21,1,22,28,79,239,82,253,197,213,27400,lakewood,98498,3117,2015
pierce,lake louise elementary,357,5,4,21,25,36,79,122,90,180,177,281,27400,lakewood,98498,3351,2015
pierce,lakes high,1397,7,93,47,140,204,287,566,193,738,659,678,27400,lakewood,98498,3456,2015
pierce,lakeview hope academy,515,1,17,40,57,62,250,94,51,285,230,479,27400,lakewood,98499,2652,2015
pierce,lochburn middle,546,1,29,42,71,84,211,104,75,267,279,501,27400,lakewood,98499,3602,2015
pierce,mann middle,404,1,15,21,36,48,81,197,41,208,196,221,27400,lakewood,98498,3297,2015
pierce,meriwether elementary,293,2,8,3,11,38,68,134,40,151,142,93,27400,jblm lewis north,98433,5364,2015
pierce,oakbrook elementary,306,4,20,8,28,29,66,127,52,164,142,194,27400,lakewood,98498,3763,2015
pierce,park lodge elementary,337,1,15,14,29,59,72,111,65,171,166,262,27400,lakewood,98499,2189,2015
pierce,rainier elementary,541,6,20,6,26,59,136,254,60,276,265,311,27400,jblm lewis main,98433,5365,2015
pierce,re-entry high,5,0,0,1,1,0,0,3,1,2,3,2,27400,lakewood,98499,1880,2015
pierce,special education services/relife,12,0,0,0,0,2,2,7,1,8,4,5,27400,lakewood,98499,1882,2015
pierce,tillicum elementary,389,3,4,24,28,36,149,123,50,200,189,339,27400,lakewood,98498,2651,2015
pierce,transition day students,16,0,0,0,0,1,2,13,0,11,5,5,27400,lakewood,98499,5297,2015
pierce,tyee park elementary,396,0,4,32,36,58,166,78,58,197,199,351,27400,lakewood,98499,3249,2015
pierce,woodbrook middle,504,6,16,29,45,70,139,194,50,255,249,393,27400,lakewood,98439,3500,2015
whitman,colfax high,299,0,2,0,2,2,6,267,22,162,137,85,38300,colfax,99111,3366,2015
whitman,leonard m jennings elementary,297,0,2,0,2,1,15,257,22,153,144,104,38300,colfax,99111,2894,2015
walla walla,college place high,261,1,9,0,9,3,52,194,2,137,124,50,36250,college place,99362,5362,2015
walla walla,davis elementary,610,4,6,2,8,3,286,298,11,312,298,396,36250,college place,99324,2114,2015
walla walla,john sager middle,275,1,0,2,2,0,113,154,5,156,119,173,36250,college place,99324,3541,2015
whitman,colton,164,0,4,0,4,2,2,150,6,84,80,40,38306,colton,99113,2588,2015
stevens,columbia high and elementary,147,32,1,0,1,0,8,85,21,84,63,111,33206,hunters,99137,3508,2015
walla walla,columbia elementary,354,0,0,0,0,5,126,218,5,190,164,205,36400,burbank,99323,3613,2015
walla walla,columbia high,287,3,2,0,2,0,64,204,14,140,147,97,36400,burbank,99323,4049,2015
walla walla,columbia middle,208,1,0,0,0,2,69,129,7,105,103,106,36400,burbank,99323,3012,2015
stevens,colville junior high,390,9,3,2,5,2,9,343,22,189,201,201,33115,colville,99114,3831,2015
stevens,colville senior high,551,14,5,0,5,1,27,476,28,273,278,223,33115,colville,99114,3310,2015
stevens,fort colville elementary,355,5,3,1,4,1,12,321,12,192,163,212,33115,colville,99114,4180,2015
stevens,hofstetter elementary,376,3,1,1,2,2,26,334,9,177,199,229,33115,colville,99114,2957,2015
stevens,panorama,127,3,0,0,0,2,8,111,3,61,66,94,33115,colville,99114,1594,2015
skagit,concrete elementary,273,8,1,0,1,0,16,246,2,147,126,189,29011,concrete,98237,2577,2015
skagit,concrete high,246,4,1,1,2,0,9,228,3,139,107,125,29011,concrete,98237,2810,2015
skagit,special services,2,0,0,0,0,0,0,2,0,1,1,5,29011,concrete,98237,5087,2015
skagit,twin cedars high,10,1,0,0,0,0,1,8,0,5,5,16,29011,concrete,98237,1605,2015
skagit,conway,452,2,4,0,4,5,59,379,3,234,218,110,29317,mount vernon,98274,2578,2015
grays harbor,cosmopolis elementary,144,0,0,0,0,0,19,110,15,74,70,77,14099,cosmopolis,98537,3326,2015
grant,almira coulee hartline high,81,0,0,0,0,0,5,74,2,41,40,32,13151,coulee city,99115,2968,2015
grant,coulee city elementary,76,0,0,0,0,1,5,66,4,38,38,45,13151,coulee city,99115,2693,2015
island,coupeville elementary,404,0,1,0,1,4,54,300,45,182,222,143,15204,coupeville,98239,3664,2015
island,coupeville high,297,1,5,1,6,8,32,225,25,138,159,92,15204,coupeville,98239,2625,2015
island,coupeville middle,219,0,4,0,4,4,26,160,25,110,109,80,15204,coupeville,98239,4004,2015
clallam,crescent,218,5,0,0,0,0,5,185,23,112,106,101,05313,joyce,98343,3473,2015
clallam,homeconnection,66,0,0,0,0,0,2,63,1,33,33,18,05313,joyce,98343,5030,2015
lincoln,creston elementary,55,1,0,0,0,0,2,48,4,35,20,22,22073,creston,99117,2862,2015
lincoln,creston jr-sr high,44,1,0,0,0,0,0,41,2,23,21,14,22073,creston,99117,2863,2015
ferry,curlew elem & high,194,4,0,0,0,4,7,166,13,98,96,116,10050,curlew,99118,2006,2015
pend oreille,bess herian elementary,120,40,0,0,0,0,3,55,22,67,53,84,26059,cusick,99119,2770,2015
pend oreille,cusick jr sr high,150,45,1,0,1,1,7,82,14,86,64,74,26059,cusick,99119,2423,2015
kittitas,damman elementary,40,1,0,1,1,0,0,38,0,14,26,0,19007,ellensburg,98926,2077,2015
snohomish,darrington elementary,296,17,3,0,3,1,24,225,26,151,145,184,31330,darrington,98241,3609,2015
lincoln,davenport elementary,265,4,1,0,1,1,8,249,2,116,149,165,22207,davenport,99122,2668,2015
lincoln,davenport senior high,325,7,2,0,2,0,7,307,2,163,162,174,22207,davenport,99122,3173,2015
columbia,dayton elementary,211,2,2,0,2,2,30,168,7,111,100,122,07002,dayton,99328,2830,2015
columbia,dayton high,143,8,2,0,2,1,17,114,1,66,77,78,07002,dayton,99328,2302,2015
columbia,dayton middle,88,4,1,0,1,4,15,62,2,40,48,58,07002,dayton,99328,4011,2015
spokane,arcadia elementary,439,11,2,1,3,1,18,403,3,218,221,263,32414,deer park,99006,2173,2015
spokane,deer park early learning center,7,0,0,0,0,0,1,6,0,3,4,11,32414,deer park,99006,5270,2015
spokane,deer park elementary,425,12,0,1,1,5,28,378,1,232,193,262,32414,deer park,99006,2430,2015
spokane,deer park high,628,14,1,0,1,11,23,577,2,306,322,317,32414,deer park,99006,4123,2015
spokane,deer park home link program,486,5,5,1,6,6,16,450,3,228,258,94,32414,deer park,99006,1852,2015
spokane,deer park middle,454,10,5,0,5,11,16,411,1,251,203,252,32414,deer park,99006,3261,2015
pierce,dieringer heights elementary,502,4,31,1,32,1,37,388,40,247,255,65,27343,lake tapps,98391,4548,2015
pierce,lake tapps elementary,479,3,30,3,33,3,36,355,49,248,231,64,27343,lake tapps,98391,3683,2015
pierce,north tapps middle,510,3,29,5,34,2,37,390,44,247,263,54,27343,lake tapps,98391,4416,2015
spokane,children first,33,1,0,0,0,1,3,24,4,22,11,20,32361,spokane valley,99216,1937,2015
spokane,continuous curriculum,516,1,15,0,15,2,24,434,40,244,272,134,32361,spokane,99216,1712,2015
spokane,east farms,388,8,2,6,8,4,50,285,33,199,189,238,32361,newman lake,99025,4097,2015
spokane,east valley high,1044,11,17,5,22,16,91,832,72,567,477,458,32361,spokane valley,99216,3360,2015
spokane,east valley middle,479,8,5,2,7,7,62,359,36,263,216,298,32361,spokane valley,99216,5346,2015
spokane,otis orchards,406,8,5,0,5,3,24,334,32,204,202,237,32361,otis orchards,99027,2955,2015
spokane,trent,449,4,3,12,15,11,79,285,55,227,222,375,32361,spokane valley,99206,2653,2015
spokane,trentwood,461,4,8,1,9,1,34,387,26,226,235,308,32361,spokane valley,99216,3128,2015
yakima,east valley central middle,693,10,7,1,8,8,320,338,9,357,336,419,39090,yakima,98901,4055,2015
yakima,east valley elementary,528,9,1,0,1,2,244,258,14,290,238,354,39090,yakima,98901,4487,2015
yakima,east valley high,852,12,9,2,11,8,355,456,10,444,408,403,39090,yakima,98901,2344,2015
yakima,moxee elementary,513,2,0,1,1,7,311,184,8,253,260,317,39090,moxee,98936,2530,2015
yakima,terrace heights elementary,511,2,10,0,10,4,158,315,22,272,239,298,39090,yakima,98901,2821,2015
douglas,cascade elementary,471,0,2,0,2,0,170,293,6,250,221,218,09206,east wenatchee,98802,3659,2015
douglas,clovis point,591,0,3,2,5,2,315,249,20,302,289,419,09206,east wenatchee,98802,4590,2015
douglas,eastmont junior high,884,4,13,2,15,5,380,453,27,451,433,488,09206,east wenatchee,98802,3372,2015
douglas,eastmont senior high,1400,5,7,1,8,6,553,790,38,741,659,646,09206,east wenatchee,98802,2727,2015
douglas,grant elementary,483,2,6,1,7,1,230,233,10,260,223,283,09206,east wenatchee,98802,2966,2015
douglas,kenroy elementary,445,2,1,0,1,0,195,238,9,211,234,282,09206,east wenatchee,98802,3212,2015
douglas,rock island elementary,225,0,0,0,0,0,166,58,1,138,87,197,09206,rock island,98850,2563,2015
kittitas,easton,111,4,0,0,0,1,25,80,1,55,56,69,19028,easton,98925,3554,2015
pierce,columbia crest a-stem academy,194,0,0,0,0,1,15,163,15,92,102,93,27404,ashford,98304,2808,2015
pierce,eatonville elementary,363,9,3,0,3,3,24,301,23,173,190,184,27404,eatonville,98328,2205,2015
pierce,eatonville high,652,11,4,3,7,6,45,551,32,324,328,210,27404,eatonville,98328,2206,2015
pierce,eatonville middle,393,2,2,1,3,2,27,344,15,191,202,167,27404,eatonville,98328,4230,2015
pierce,new beginnings,16,0,0,0,0,0,3,11,2,9,7,8,27404,eatonville,98328,5332,2015
pierce,weyerhaeuser elementary,287,1,3,2,5,1,15,239,26,147,140,111,27404,eatonville,98328,2361,2015
snohomish,alderwood middle,714,3,137,8,145,42,166,302,56,362,352,331,31015,lynnwood,98037,3560,2015
snohomish,beverly elementary,516,1,60,10,70,34,108,232,71,261,255,255,31015,lynnwood,98037,3302,2015
snohomish,brier elementary,432,2,26,4,30,12,55,286,47,241,191,87,31015,brier,98036,3536,2015
snohomish,brier terrace middle,654,1,97,3,100,20,82,371,80,328,326,195,31015,brier,98036,3650,2015
snohomish,cedar valley community,419,1,39,1,40,32,242,86,18,219,200,373,31015,lynnwood,98036,3409,2015
snohomish,cedar way elementary,447,2,66,8,74,34,51,224,62,234,213,216,31015,mtlk terrace,98043,3304,2015
snohomish,challenge elementary,293,1,68,0,68,10,17,161,36,154,139,20,31015,mtlk terrace,98043,1520,2015
snohomish,chase lake elementary,374,0,23,4,27,46,92,161,48,212,162,218,31015,edmonds,98020,3534,2015
snohomish,college place elementary,505,6,28,0,28,58,230,143,40,266,239,388,31015,lynnwood,98036,3691,2015
snohomish,college place middle,525,6,47,0,47,47,128,249,48,262,263,250,31015,lynnwood,98036,3754,2015
snohomish,early childhood center,152,1,21,2,23,24,27,61,16,113,39,105,31015,lynnwood,98036,3185,2015
snohomish,edmonds career access program,305,3,17,4,21,19,66,181,15,157,148,93,31015,lynnwood,98036,5358,2015
snohomish,edmonds elearning academy,84,0,3,1,4,0,8,65,7,44,40,32,31015,lynnwood,98036,1519,2015
snohomish,edmonds elementary,351,4,14,0,14,12,45,233,43,180,171,68,31015,edmonds,98020,3606,2015
snohomish,edmonds heights k-12,503,1,34,0,34,7,50,353,58,254,249,90,31015,edmonds,98020,1966,2015
snohomish,edmonds woodway high,1679,10,237,10,247,119,260,899,144,838,841,513,31015,edmonds,98026,3123,2015
snohomish,hazelwood elementary,514,2,80,1,81,29,97,255,50,276,238,197,31015,lynnwood,98036,3607,2015
snohomish,hilltop elementary,551,2,100,2,102,17,60,325,45,303,248,116,31015,lynnwood,98036,3689,2015
snohomish,lynndale elementary,448,1,33,7,40,39,114,208,46,228,220,247,31015,lynnwood,98036,3122,2015
snohomish,lynnwood elementary,591,3,111,7,118,45,129,225,71,321,270,332,31015,lynnwood,98037,3503,2015
snohomish,lynnwood high,1442,5,318,11,329,111,273,604,120,726,716,596,31015,bothell,98012,3755,2015
snohomish,maplewood parent coop,464,0,36,0,36,12,15,365,36,240,224,38,31015,edmonds,98026,1685,2015
snohomish,martha lake elementary,516,5,114,6,120,30,99,216,46,259,257,221,31015,lynnwood,98037,2887,2015
snohomish,meadowdale elementary,498,1,70,0,70,37,119,221,50,265,233,265,31015,lynnwood,98037,3504,2015
snohomish,meadowdale high,1591,12,194,8,202,92,231,920,134,839,752,504,31015,lynnwood,98037,3464,2015
snohomish,meadowdale middle,675,1,81,5,86,43,136,353,56,370,305,289,31015,lynnwood,98037,3353,2015
snohomish,mountlake terrace elementary,444,1,30,9,39,18,127,207,52,229,215,257,31015,mountlake terrace,98043,3254,2015
snohomish,mountlake terrace high,1267,14,149,6,155,67,199,711,121,674,593,386,31015,mtlk terrace,98043,3303,2015
snohomish,oak heights elementary,550,1,87,5,92,26,119,275,37,260,290,229,31015,lynnwood,98037,3608,2015
snohomish,scriber lake high,290,2,10,1,11,12,64,177,24,170,120,157,31015,edmonds,98020,3854,2015
snohomish,seaview elementary,375,1,18,2,20,10,42,252,50,195,180,102,31015,edmonds,98020,3461,2015
snohomish,sherwood elementary,437,4,18,0,18,24,64,275,52,222,215,127,31015,edmonds,98020,3605,2015
snohomish,spruce elementary,506,0,92,8,100,69,117,167,53,257,249,302,31015,lynnwood,98037,3410,2015
snohomish,terrace park elementary,368,5,39,3,42,21,69,179,52,176,192,136,31015,mtlk terrace,98043,2888,2015
snohomish,westgate elementary,468,4,33,1,34,34,84,253,59,253,215,159,31015,edmonds,98020,3186,2015
spokane,structural alt confinement,28,4,0,0,0,2,0,22,0,18,10,27,32801,spokane,99205,3507,2015
thurston,gravity high,331,31,6,0,6,16,41,237,0,207,124,0,34801,tumwater,98512,5305,2015
kittitas,ellensburg developmental preschool,51,0,0,1,1,1,15,34,0,30,21,1,19401,ellensburg,98926,1924,2015
kittitas,ellensburg high,970,17,22,1,23,12,137,776,5,485,485,292,19401,ellensburg,98926,2996,2015
kittitas,k-12 ellensburg learning center,15,1,0,0,0,0,1,13,0,6,9,11,19401,ellensburg,98926,5097,2015
kittitas,lincoln elementary,472,6,10,2,12,4,103,343,4,234,238,187,19401,ellensburg,98926,2741,2015
kittitas,morgan middle,682,6,9,2,11,5,111,543,6,338,344,269,19401,ellensburg,98926,2453,2015
kittitas,mt. stuart elementary,491,4,2,0,2,4,96,382,3,255,236,276,19401,ellensburg,98926,3596,2015
kittitas,valley view elementary,470,2,3,1,4,7,89,358,10,226,244,194,19401,ellensburg,98936,4411,2015
grays harbor,east grays harbor high,38,0,2,0,2,0,3,28,5,10,28,21,14068,elma,98541,1629,2015
grays harbor,elma elementary,582,12,5,0,5,5,123,396,41,297,285,292,14068,elma,98541,3217,2015
grays harbor,elma high,547,8,5,0,5,5,56,439,34,280,267,152,14068,elma,98541,2137,2015
grays harbor,elma middle,324,1,1,0,1,0,55,244,23,165,159,124,14068,elma,98541,4245,2015
whitman,endicott/st john elem and middle,105,2,0,0,0,0,3,97,3,57,48,61,38308,endicott,99125,2207,2015
chelan,entiat middle and high,193,1,1,2,3,1,66,110,12,99,94,112,04127,entiat,98822,3317,2015
chelan,paul rumburg elementary,163,0,0,0,0,1,69,91,2,81,82,109,04127,entiat,98822,2688,2015
king,black diamond elementary,254,2,0,2,2,0,46,185,19,132,122,82,17216,black diamond,98010,3430,2015
king,byron kibler elementary,359,1,3,5,8,5,77,245,23,180,179,150,17216,enumclaw,98022,2980,2015
king,enumclaw middle,448,11,1,0,1,7,46,370,13,240,208,152,17216,enumclaw,98022,4210,2015
king,enumclaw sr high,1396,26,10,3,13,8,155,1147,47,716,680,334,17216,enumclaw,98022,3330,2015
king,southwood elementary,261,2,3,0,3,2,34,210,10,128,133,86,17216,enumclaw,98022,3739,2015
king,special ed,20,0,0,0,0,0,0,19,1,11,9,12,17216,enumclaw,98022,1523,2015
king,sunrise elementary,367,0,2,0,2,4,51,300,10,196,171,120,17216,enumclaw,98022,4289,2015
king,thunder mountain middle,454,10,2,1,3,1,58,367,15,248,206,110,17216,enumclaw,98022,4550,2015
king,westwood elementary,258,6,1,0,1,2,53,185,11,139,119,79,17216,enumclaw,98022,3585,2015
grant,beezley springs elementary,19,0,2,0,2,0,2,14,1,13,6,2,13165,ephrata,98823,4229,2015
grant,columbia ridge elementary,494,0,0,0,0,2,182,298,12,250,244,339,13165,ephrata,98823,2793,2015
grant,ephrata high,702,3,8,0,8,2,184,490,15,347,355,290,13165,ephrata,98823,2920,2015
grant,ephrata middle,359,0,1,0,1,1,105,248,4,186,173,189,13165,ephrata,98823,3373,2015
grant,grant elementary,453,1,2,0,2,5,126,310,9,250,203,267,13165,ephrata,98823,3092,2015
grant,parkway,322,1,4,0,4,0,81,230,6,151,171,186,13165,ephrata,98823,2695,2015
lewis,evaline elementary,37,0,0,0,0,0,6,29,2,18,19,25,21036,winlock,98596,2355,2015
snohomish,cascade high,1812,15,221,22,243,95,306,1057,96,941,871,764,31002,everett,98203,3407,2015
snohomish,cedar wood elementary,635,0,166,2,168,14,50,358,45,305,330,66,31002,bothell,98012,4382,2015
snohomish,eisenhower middle,818,11,109,7,116,43,141,470,37,421,397,341,31002,everett,98208,3752,2015
snohomish,emerson elementary,623,1,61,9,70,32,223,243,54,308,315,438,31002,everett,98208,3184,2015
snohomish,everett high,1440,29,86,45,131,66,235,915,64,734,706,654,31002,everett,98201,2126,2015
snohomish,evergreen middle,930,5,87,21,108,32,232,512,41,454,476,553,31002,everett,98203,3253,2015
snohomish,forest view elementary,612,1,125,0,125,13,48,391,34,303,309,63,31002,everett,98208,5091,2015
snohomish,garfield elementary,380,3,8,10,18,9,96,209,45,190,190,301,31002,everett,98201,2065,2015
snohomish,gateway middle,810,4,149,4,153,7,78,496,72,403,407,83,31002,everett,98208,4437,2015
snohomish,hawthorne elementary school - everett,469,5,44,48,92,29,147,177,19,249,220,429,31002,everett,98201,2883,2015
snohomish,heatherwood middle,970,2,188,2,190,35,134,522,87,466,504,273,31002,mill creek,98012,4334,2015
snohomish,henry m. jackson high,2139,11,405,7,412,66,236,1300,114,1084,1055,404,31002,mill creek,98012,4438,2015
snohomish,jackson elementary,373,5,6,8,14,17,70,237,30,199,174,247,31002,everett,98201,2751,2015
snohomish,jefferson elementary,557,0,70,4,74,28,79,345,31,257,300,232,31002,everett,98208,3533,2015
snohomish,lowell elementary - everett,501,6,36,4,40,22,136,243,54,247,254,367,31002,everett,98203,2811,2015
snohomish,madison elementary,440,1,35,7,42,33,170,172,22,219,221,345,31002,everett,98203,2669,2015
snohomish,mill creek elementary,684,7,129,5,134,19,59,406,59,371,313,100,31002,mill creek,98012,4316,2015
snohomish,monroe elementary,549,1,50,3,53,29,105,320,41,284,265,244,31002,everett,98208,3686,2015
snohomish,north middle,658,8,35,35,70,44,148,358,30,347,311,410,31002,everett,98201,2364,2015
snohomish,nw learning center,8,0,0,0,0,1,3,4,0,8,0,7,31002,everett,98213,1663,2015
snohomish,penny creek elementary,730,0,146,2,148,28,75,435,44,394,336,182,31002,everett,98208,4530,2015
snohomish,port gardner,142,0,1,0,1,1,8,127,5,72,70,25,31002,everett,98201,1907,2015
snohomish,sequoia high,246,7,9,6,15,10,34,169,11,110,136,164,31002,everett,98201,4137,2015
snohomish,silver firs elementary,553,1,68,1,69,21,73,336,53,296,257,130,31002,everett,98208,4298,2015
snohomish,silver lake elementary - everett,531,4,73,3,76,22,135,266,28,261,270,269,31002,everett,98208,2545,2015
snohomish,special services,144,0,10,2,12,3,25,90,14,86,58,61,31002,everett,98213,3903,2015
snohomish,view ridge elementary,579,1,27,3,30,17,71,441,19,288,291,213,31002,everett,98203,3002,2015
snohomish,whittier elementary,452,4,19,4,23,21,58,315,31,237,215,199,31002,everett,98201,2752,2015
snohomish,woodside elementary,806,1,78,3,81,25,213,396,90,409,397,345,31002,bothell,98012,4125,2015
clark,49th street academy,119,1,4,0,4,10,10,80,14,97,22,88,06114,vancouver,98682,1646,2015
clark,burnt bridge creek elementary,478,1,18,9,27,4,78,308,60,260,218,220,06114,vancouver,98682,4299,2015
clark,burton elementary,461,1,17,14,31,4,104,289,32,255,206,296,06114,vancouver,98682,3736,2015
clark,cascade middle,890,8,31,34,65,35,200,520,62,442,448,581,06114,vancouver,98684,3785,2015
clark,columbia valley elementary,500,1,49,2,51,19,78,311,40,269,231,190,06114,vancouver,98683,4587,2015
clark,covington middle,1043,3,38,23,61,39,234,649,57,558,485,684,06114,vancouver,98662,3320,2015
clark,crestline elementary,473,3,11,12,23,20,193,183,51,229,244,352,06114,vancouver,98683,3822,2015
clark,early childhood center,155,0,10,4,14,7,19,102,13,119,36,81,06114,vancouver,98682,1530,2015
clark,ellsworth elementary,444,4,13,4,17,8,144,238,33,226,218,280,06114,vancouver,98664,3148,2015
clark,endeavour elementary,679,1,37,11,48,18,171,381,60,354,325,416,06114,vancouver,98684,5136,2015
clark,evergreen high,1806,17,82,57,139,69,311,1133,137,970,836,904,06114,vancouver,98684,2724,2015
clark,fircrest elementary,451,2,18,15,33,7,65,295,49,223,228,265,06114,vancouver,98684,3971,2015
clark,fishers landing elementary,651,0,123,2,125,8,56,403,59,332,319,124,06114,vancouver,98683,4499,2015
clark,frontier middle,803,5,52,5,57,19,131,544,47,416,387,373,06114,vancouver,98682,4498,2015
clark,harmony elementary,708,2,47,9,56,22,76,492,60,369,339,197,06114,vancouver,98684,4380,2015
clark,hearthwood elementary,425,0,13,5,18,11,75,268,53,201,224,242,06114,vancouver,98684,4163,2015
clark,heritage high,1925,17,92,37,129,55,374,1241,109,1021,904,919,06114,vancouver,98682,4523,2015
clark,illahee elementary,651,1,111,9,120,15,87,369,59,329,322,167,06114,camas,98607,4560,2015
clark,image elementary,645,0,31,14,45,7,130,402,61,331,314,403,06114,vancouver,98682,3994,2015
clark,legacy high,234,3,1,1,2,9,48,157,15,110,124,125,06114,vancouver,98684,4042,2015
clark,marrion elementary,523,2,10,7,17,9,184,264,47,256,267,377,06114,vancouver,98664,3618,2015
clark,mill plain elementary,494,7,11,24,35,14,138,258,42,256,238,313,06114,vancouver,98684,2829,2015
clark,mountain view high,1848,11,185,26,211,59,345,1088,134,973,875,657,06114,vancouver,98683,4162,2015
clark,orchards elementary,585,3,17,12,29,12,145,356,40,310,275,454,06114,vancouver,98662,2912,2015
clark,pacific middle,1009,6,71,14,85,27,119,690,82,516,493,383,06114,vancouver,98684,4209,2015
clark,pioneer elementary,668,2,41,14,55,15,168,398,30,345,323,351,06114,vancouver,98682,4445,2015
clark,riverview elementary,472,0,15,6,21,10,102,281,58,248,224,229,06114,vancouver,98684,3995,2015
clark,shahala middle,1161,0,203,5,208,39,147,672,95,594,567,289,06114,vancouver,98683,4561,2015
clark,sifton elementary,498,0,19,5,24,8,117,318,31,234,264,300,06114,vancouver,98682,3149,2015
clark,silver star elementary,455,1,13,8,21,9,63,321,40,228,227,291,06114,vancouver,98662,3823,2015
clark,sunset elementary,540,7,25,12,37,12,99,345,40,285,255,316,06114,vancouver,98662,3970,2015
clark,union high,2122,12,229,23,252,61,229,1433,135,1113,1009,561,06114,camas,98607,5111,2015
clark,wyeast middle,875,10,25,13,38,38,245,487,57,466,409,479,06114,vancouver,98683,4051,2015
clark,york elementary,510,3,25,0,25,10,93,329,50,277,233,223,06114,vancouver,98682,4579,2015
stevens,evergreen,20,3,1,0,1,3,1,12,0,15,5,14,33205,gifford,99131,3197,2015
king,adelaide elementary,401,1,33,30,63,31,131,114,61,229,172,268,17210,federal way,98023,3519,2015
king,birth to three development center,119,1,11,4,15,12,42,36,13,71,48,66,17210,federal way,98093,5279,2015
king,brigadoon elementary,342,2,18,17,35,33,93,132,47,170,172,210,17210,federal way,98023,3700,2015
king,camelot elementary,337,0,36,8,44,28,58,159,48,171,166,227,17210,auburn,98001,3547,2015
king,career academy at truman high,161,3,11,3,14,19,47,68,10,69,92,79,17210,federal way,98003,5163,2015
king,decatur high,1314,9,153,50,203,179,294,518,111,700,614,615,17210,federal way,98023,3766,2015
king,dynamic family services,6,0,0,0,0,1,2,3,0,5,1,5,17210,kent,98030,5280,2015
king,employment transition program,34,0,2,2,4,4,3,20,3,24,10,22,17210,federal way,98023,1950,2015
king,enterprise elementary,492,3,75,23,98,56,122,148,65,266,226,294,17210,federal way,98023,4470,2015
king,federal way high,1636,19,167,135,302,240,473,444,158,835,801,917,17210,federal way,98003,2417,2015
king,federal way public academy,305,1,75,3,78,22,34,139,31,129,176,77,17210,federal way,98003,1789,2015
king,federal way public school eceap,2,0,0,0,0,0,1,0,1,2,0,9,17210,federal way,98003,5218,2015
king,federal way public schools headstart,19,0,0,1,1,0,6,7,5,10,9,17,17210,federal way,98003,5219,2015
king,federal way running start home,1,0,0,0,0,0,0,1,0,0,1,0,17210,federal way,98003,5107,2015
king,gateway to college,46,0,4,2,6,6,16,15,3,32,14,17,17210,federal way,98003,5255,2015
king,green gables elementary,407,5,34,11,45,41,57,188,71,211,196,148,17210,federal way,98023,4426,2015
king,illahee middle,747,2,135,41,176,84,148,240,97,365,382,383,17210,federal way,98003,3898,2015
king,internet academy,274,2,11,1,12,23,25,185,27,112,162,94,17210,federal way,98003,1759,2015
king,kilo middle,539,3,49,19,68,53,147,200,68,263,276,345,17210,auburn,98001,3701,2015
king,lake dolloff elementary,418,2,60,7,67,68,71,143,67,214,204,297,17210,auburn,98001,3738,2015
king,lake grove elementary,382,0,17,23,40,53,138,96,55,179,203,297,17210,federal way,98023,3568,2015
king,lakeland elementary,377,4,50,11,61,25,55,187,45,183,194,198,17210,auburn,98001,2841,2015
king,lakota middle,778,3,81,39,120,95,153,295,112,410,368,442,17210,federal way,98023,3381,2015
king,mark twain elementary,557,4,54,59,113,102,231,63,44,275,282,406,17210,federal way,98003,3627,2015
king,meredith hill elementary,406,2,61,5,66,24,82,195,37,222,184,185,17210,auburn,98001,4480,2015
king,mirror lake elementary,459,2,44,28,72,84,174,78,49,229,230,352,17210,federal way,98003,3159,2015
king,nautilus k-8,506,4,43,29,72,33,145,195,57,250,256,294,17210,federal way,98003,3625,2015
king,olympic view elementary,383,0,11,22,33,28,200,72,50,196,187,299,17210,federal way,98023,3432,2015
king,panther lake elementary,423,5,54,37,91,63,111,78,75,220,203,323,17210,federal way,98003,3329,2015
king,rainier view elementary,375,1,22,11,33,47,92,145,57,188,187,279,17210,federal way,98003,4422,2015
king,sacajawea middle,709,2,92,50,142,77,216,190,82,350,359,461,17210,federal way,98003,3626,2015
king,sequoyah middle,527,4,69,20,89,59,95,218,62,274,253,321,17210,auburn,98001,5029,2015
king,sherwood forest elementary,470,0,70,14,84,35,108,176,67,235,235,246,17210,federal way,98023,4374,2015
king,silver lake elementary school - federal way,397,0,48,28,76,54,119,96,52,209,188,260,17210,federal way,98023,4343,2015
king,star lake elementary,468,3,44,16,60,63,115,141,86,259,209,254,17210,kent,98031,3160,2015
king,sunnycrest elementary,575,5,38,31,69,67,259,76,99,295,280,435,17210,kent,98032,3567,2015
king,support,71,0,4,1,5,3,16,23,24,48,23,34,17210,federal way,98003,1951,2015
king,thomas jefferson high,1831,10,364,38,402,183,453,639,144,930,901,926,17210,auburn,98001,3584,2015
king,todd beamer high,1779,14,285,74,359,228,285,697,196,890,889,835,17210,federal way,98003,4570,2015
king,totem middle,633,4,73,40,113,94,237,106,79,315,318,462,17210,kent,98031,3431,2015
king,twin lakes elementary,385,3,18,23,41,59,80,138,64,212,173,262,17210,federal way,98023,3628,2015
king,valhalla elementary,603,1,77,15,92,52,248,137,73,290,313,436,17210,auburn,98001,3582,2015
king,wildwood elementary,532,1,30,36,66,69,270,76,50,280,252,386,17210,federal way,98003,3583,2015
king,woodmont k-8,479,4,62,13,75,70,122,148,60,255,224,279,17210,des moines,98198,3328,2015
whatcom,beach elem,34,0,0,0,0,0,2,31,1,17,17,16,37502,lummi island,98262,2263,2015
whatcom,cascadia elementary,493,6,36,2,38,3,120,305,21,253,240,259,37502,ferndale,98248,5207,2015
whatcom,central elementary,336,7,14,3,17,5,66,210,31,166,170,196,37502,ferndale,98248,2458,2015
whatcom,custer elem,328,5,4,0,4,2,77,228,12,159,169,175,37502,custer,98240,2607,2015
whatcom,eagleridge elementary,502,105,11,0,11,10,80,257,39,260,242,291,37502,ferndale,98248,4482,2015
whatcom,ferndale high,1501,92,51,1,52,13,252,1014,78,781,720,517,37502,ferndale,98248,2488,2015
whatcom,ferndale special services,25,8,0,0,0,0,5,11,1,16,9,0,37502,ferndale,98248,5084,2015
whatcom,horizon middle,544,62,18,0,18,2,109,322,31,274,270,219,37502,ferndale,98248,4554,2015
whatcom,skyline elementary,426,84,7,0,7,7,61,238,29,215,211,180,37502,ferndale,98248,4130,2015
whatcom,vista middle,570,48,26,1,27,5,99,357,34,309,261,256,37502,ferndale,98248,3762,2015
whatcom,windward high,190,10,3,0,3,4,19,147,7,87,103,60,37502,ferndale,98248,5245,2015
pierce,columbia junior high,581,9,43,16,59,22,106,318,67,304,277,239,27417,tacoma,98424,4582,2015
pierce,discovery primary,624,4,38,25,63,20,134,319,84,321,303,328,27417,milton,98354,2878,2015
pierce,endeavour intermediate,577,4,48,23,71,22,145,244,91,280,297,300,27417,milton,98354,2809,2015
pierce,fife high,778,9,58,28,86,33,144,410,96,410,368,316,27417,tacoma,98424,2773,2015
pierce,hedden elementary,529,3,36,15,51,19,81,308,67,269,260,259,27417,edgewood,98372,4557,2015
pierce,surprise lake middle,558,6,40,22,62,21,101,310,58,283,275,257,27417,milton,98354,3798,2015
benton,finley elementary,396,1,0,0,0,0,165,211,19,214,182,294,03053,kennewick,99337,3078,2015
benton,finley middle,208,2,1,0,1,1,96,102,6,113,95,158,03053,kennewick,99337,4031,2015
benton,river view high,311,2,1,0,1,2,117,177,12,169,142,206,03053,kennewick,99337,2367,2015
pierce,brookdale elementary,481,10,29,44,73,27,124,160,87,236,245,387,27402,tacoma,98444,3180,2015
pierce,central avenue elementary,434,2,31,9,40,20,82,221,69,224,210,329,27402,tacoma,98446,2398,2015
pierce,christensen elementary,431,5,28,30,58,78,112,110,68,206,225,379,27402,tacoma,98444,3301,2015
pierce,collins elementary,397,2,29,4,33,15,79,211,57,230,167,224,27402,tacoma,98446,2257,2015
pierce,elmhurst elementary,416,5,18,27,45,50,71,154,91,222,194,352,27402,tacoma,98445,3532,2015
pierce,franklin pierce high,1192,14,101,36,137,114,236,575,116,598,594,611,27402,tacoma,98445,2876,2015
pierce,gates secondary,191,4,7,7,14,19,32,102,20,92,99,125,27402,tacoma,98444,4063,2015
pierce,harvard elementary,426,1,37,11,48,35,235,58,49,227,199,366,27402,tacoma,98445,3000,2015
pierce,james sales elementary,459,6,11,28,39,48,151,136,79,241,218,383,27402,tacoma,98444,2945,2015
pierce,learning support,78,1,6,0,6,8,27,31,5,55,23,76,27402,tacoma,98444,5129,2015
pierce,midland elementary,528,2,38,31,69,55,155,169,78,255,273,430,27402,tacoma,98445,2340,2015
pierce,morris ford middle,922,6,73,27,100,85,252,388,91,495,427,678,27402,tacoma,98445,3300,2015
pierce,perry g keithley middle,718,3,35,56,91,97,183,256,88,353,365,571,27402,tacoma,98444,3401,2015
pierce,washington high,972,9,77,105,182,165,174,337,105,523,449,653,27402,tacoma,98444,3648,2015
spokane,freeman elementary,353,1,4,2,6,2,12,322,10,187,166,106,32358,rockford,99030,3794,2015
spokane,freeman high,327,10,7,1,8,4,19,280,6,176,151,64,32358,rockford,99030,3192,2015
spokane,freeman middle,243,2,5,0,5,3,20,212,1,124,119,58,32358,rockford,99030,4593,2015
whitman,garfield at palouse high,26,2,0,0,0,0,0,24,0,15,11,14,38302,palouse,99161,1962,2015
whitman,garfield elementary,52,0,0,0,0,0,1,50,1,30,22,33,38302,garfield,99130,2895,2015
whitman,garfield middle,26,0,0,0,0,0,1,25,0,12,14,13,38302,garfield,99130,2896,2015
klickitat,glenwood elementary,35,3,0,0,0,0,8,19,5,20,15,22,20401,glenwood,98619,3047,2015
klickitat,glenwood secondary,33,0,0,0,0,0,2,25,6,17,16,8,20401,glenwood,98619,3048,2015
klickitat,goldendale high,325,13,5,2,7,1,38,247,19,188,137,145,20404,goldendale,98620,2856,2015
klickitat,goldendale middle,273,19,3,0,3,1,45,199,6,147,126,148,20404,goldendale,98620,3393,2015
klickitat,goldendale primary,322,12,2,0,2,3,37,245,23,163,159,221,20404,goldendale,98620,2677,2015
klickitat,goldendale support service center,5,0,1,0,1,0,0,4,0,5,0,0,20404,goldendale,98620,5012,2015
grant,lake roosevelt elementary,399,124,1,2,3,1,45,132,94,201,198,270,13301,coulee dam,99116,2802,2015
grant,lake roosevelt jr/sr high,342,167,2,0,2,2,36,82,53,176,166,208,13301,coulee dam,99116,2801,2015
yakima,contract learning center,59,0,0,0,0,1,49,8,1,24,35,35,39200,grandview,98930,1776,2015
yakima,grandview high,837,0,0,0,0,0,754,78,5,395,442,481,39200,grandview,98930,2555,2015
yakima,grandview middle,810,0,1,0,1,0,749,56,4,393,417,552,39200,grandview,98930,3071,2015
yakima,mcclure elementary,641,0,0,0,0,1,609,29,2,336,305,437,39200,grandview,98930,2345,2015
yakima,smith elementary,610,1,1,0,1,0,575,32,1,311,299,507,39200,grandview,98930,3013,2015
yakima,thompson elementary,599,0,0,0,0,0,532,65,2,315,284,472,39200,grandview,98930,2756,2015
yakima,granger high,431,16,0,0,0,0,392,16,7,236,195,348,39204,granger,98932,3314,2015
yakima,granger middle,459,9,0,0,0,0,429,16,5,241,218,403,39204,granger,98932,2531,2015
yakima,roosevelt elementary,634,18,0,0,0,1,598,10,7,342,292,568,39204,granger,98932,4535,2015
snohomish,crossroads high,177,4,0,0,0,1,28,132,12,95,82,94,31332,granite falls,98252,5171,2015
snohomish,granite falls high,608,10,14,3,17,4,45,517,15,316,292,187,31332,granite falls,98252,2580,2015
snohomish,granite falls middle,406,4,2,1,3,4,31,350,14,219,187,154,31332,granite falls,98252,4113,2015
snohomish,granite falls open doors,16,2,0,0,0,0,0,13,1,9,7,14,31332,granite falls,98252,5349,2015
snohomish,monte cristo elementary,334,10,4,1,5,2,35,250,32,176,158,167,31332,granite falls,98252,4479,2015
snohomish,mountain way elementary,506,10,1,1,2,8,43,431,12,260,246,236,31332,granite falls,98252,4330,2015
mason,grapeview elementary & middle,224,5,3,0,3,0,14,187,15,111,113,101,23054,grapeview,98546,2145,2015
spokane,great northern elementary,46,4,3,0,3,0,0,39,0,29,17,2,32312,spokane,99224,2097,2015
clark,green mountain,142,0,0,0,0,0,6,135,1,71,71,61,06103,woodland,98674,2484,2015
thurston,griffin,650,15,15,1,16,11,51,502,55,326,324,118,34324,olympia,98502,2406,2015
lincoln,harrington elementary,48,0,0,0,0,0,1,44,3,26,22,26,22204,harrington,99134,2743,2015
lincoln,harrington high,43,1,0,0,0,0,2,36,4,21,22,25,22204,harrington,99134,3113,2015
yakima,highland high,381,1,1,0,1,3,261,104,11,215,166,262,39203,cowiche,98923,4559,2015
yakima,highland junior high,192,2,1,0,1,2,134,48,5,102,90,143,39203,cowiche,98923,2718,2015
yakima,marcus whitman-cowiche elementary,360,2,1,0,1,0,262,87,8,193,167,285,39203,cowiche,98923,3072,2015
yakima,tieton intermediate,269,1,1,0,1,1,209,53,4,126,143,222,39203,tieton,98947,3073,2015
king,beverly park elem at glendale,481,11,50,23,73,80,221,68,28,251,230,387,17401,seattle,98168,2765,2015
king,big picture,190,1,3,2,5,14,68,91,11,97,93,107,17401,burien,98148,5028,2015
king,bow lake elementary,701,3,107,57,164,150,247,90,46,355,346,568,17401,seatac,98188,2982,2015
king,career link,205,3,27,8,35,26,87,45,9,113,92,0,17401,seattle,98146,5116,2015
king,cascade middle,584,11,133,28,161,77,257,44,34,293,291,493,17401,seattle,98146,3163,2015
king,cedarhurst elementary,737,5,146,32,178,63,299,156,36,361,376,518,17401,burien,98168,2926,2015
king,chinook middle,630,3,101,39,140,102,282,82,21,306,324,514,17401,seatac,98188,3098,2015
king,choice academy,126,1,8,2,10,3,32,73,7,51,75,42,17401,seattle,98148,1539,2015
king,des moines elementary,411,3,46,3,49,54,91,172,42,211,200,182,17401,des moines,98198,2418,2015
king,gregory heights elementary,674,2,53,29,82,39,226,269,56,362,312,356,17401,burien,98166,2844,2015
king,hazel valley elementary,653,7,91,22,113,52,347,93,41,331,322,535,17401,burien,98146,2699,2015
king,highline high,1317,12,165,59,224,121,522,352,86,688,629,776,17401,burien,98148,2325,2015
king,highline home school center,14,0,0,0,0,0,1,13,0,8,6,2,17401,burien,98148,5371,2015
king,hilltop elementary,631,3,98,42,140,46,343,64,35,339,292,535,17401,seattle,98168,3165,2015
king,madrona elementary,663,1,42,42,84,154,350,43,31,344,319,612,17401,seatac,98198,3278,2015
king,marvista elementary,640,12,41,11,52,83,135,320,38,338,302,263,17401,normandy park,98166,3097,2015
king,mcmicken heights elementary,546,1,85,41,126,123,168,95,33,287,259,425,17401,seatac,98188,2734,2015
king,midway elementary,629,4,59,63,122,82,326,52,43,317,312,548,17401,des moines,98198,2984,2015
king,mount rainier high,1663,12,224,45,269,197,421,612,152,835,828,807,17401,des moines,98198,3279,2015
king,mount view elementary,677,6,117,21,138,62,397,58,16,341,336,583,17401,seattle,98146,2144,2015
king,new start,105,0,2,5,7,13,61,18,6,65,40,88,17401,seattle,98146,1972,2015
king,north hill elementary,587,10,44,6,50,60,116,280,71,302,285,310,17401,des moines,98148,2983,2015
king,pacific middle,651,6,72,27,99,67,188,238,53,349,302,357,17401,des moines,98198,3333,2015
king,parkside elementary,600,2,85,27,112,108,142,179,57,330,270,393,17401,des moines,98198,3335,2015
king,puget sound high,18,0,5,0,5,2,7,3,1,8,10,25,17401,burien,98148,5172,2015
king,raisbeck aviation high,433,2,81,2,83,20,38,266,24,281,152,48,17401,tukwila,98108,3553,2015
king,seahurst elementary,604,8,45,16,61,63,327,101,44,293,311,496,17401,burien,98166,3382,2015
king,shorewood elementary,463,8,85,16,101,42,112,162,38,243,220,276,17401,burien,98146,2842,2015
king,southern heights elementary,315,3,66,10,76,23,146,30,37,175,140,253,17401,seattle,98168,3032,2015
king,sylvester middle,658,10,117,27,144,41,272,153,38,347,311,444,17401,burien,98166,2927,2015
king,valley view early childhood center,156,2,17,1,18,18,59,47,12,104,52,72,17401,seatac,98188,5119,2015
king,white center heights elementary,614,4,155,20,175,142,196,68,29,316,298,526,17401,seattle,98146,2639,2015
clark,hockinson heights elementary,774,1,10,0,10,7,34,695,27,399,375,165,06098,brush prairie,98606,5311,2015
clark,hockinson high,700,3,19,0,19,5,28,632,13,379,321,117,06098,brush prairie,98606,4568,2015
clark,hockinson middle,431,2,7,0,7,1,21,390,10,225,206,77,06098,brush prairie,98606,3319,2015
grays harbor,central elementary,237,17,2,0,2,5,32,172,9,120,117,160,14028,hoquiam,98550,2972,2015
grays harbor,emerson elementary,237,12,0,0,0,2,63,154,6,117,120,175,14028,hoquiam,98550,2268,2015
grays harbor,hoquiam high,490,33,7,0,7,10,92,322,26,241,249,252,14028,hoquiam,98550,3622,2015
grays harbor,hoquiam homelink,49,2,0,0,0,0,10,35,2,23,26,48,14028,hoquiam,98550,5191,2015
grays harbor,hoquiam middle,378,12,4,2,6,8,55,286,11,202,176,238,14028,hoquiam,98550,2391,2015
grays harbor,lincoln elementary,259,15,0,0,0,1,55,173,15,137,122,180,14028,hoquiam,98550,3621,2015
ferry,inchelium elementary,125,96,0,0,0,0,0,3,26,57,68,93,10070,inchelium,99138,4215,2015
ferry,inchelium high,56,45,2,0,2,0,1,4,4,30,26,44,10070,inchelium,99138,2603,2015
ferry,inchelium middle,51,40,1,0,1,0,0,1,9,27,24,37,10070,inchelium,99138,4214,2015
snohomish,index elementary,46,0,0,0,0,0,1,45,0,20,26,18,31063,index,98256,2948,2015
king,apollo elementary,596,0,182,0,182,9,68,294,43,303,293,112,17411,renton,98059,3746,2015
king,beaver lake middle,871,0,250,5,255,6,52,516,42,447,424,44,17411,issaquah,98029,4460,2015
king,briarwood elementary,582,0,112,5,117,11,44,353,57,301,281,89,17411,renton,98059,3440,2015
king,cascade ridge elementary,548,0,175,0,175,7,23,298,45,297,251,8,17411,sammamish,98075,4565,2015
king,challenger elementary,605,0,184,3,187,4,48,308,58,311,294,23,17411,issaquah,98029,4300,2015
king,clark elementary,594,2,119,0,119,17,65,340,51,303,291,130,17411,issaquah,98027,2738,2015
king,cougar ridge elementary,591,1,206,0,206,7,25,308,44,312,279,9,17411,bellevue,98006,4375,2015
king,creekside elementary,696,1,183,0,183,3,34,440,35,336,360,20,17411,sammamish,98075,5201,2015
king,discovery elementary,581,0,277,1,278,4,38,227,34,273,308,5,17411,issaquah,98075,4376,2015
king,endeavour elementary,683,2,228,2,230,2,50,356,43,345,338,46,17411,issaquah,98029,4493,2015
king,grand ridge elementary,734,0,251,0,251,10,43,369,61,384,350,31,17411,issaquah,98029,5056,2015
king,issaquah high,2106,5,420,5,425,25,162,1375,114,1071,1035,178,17411,issaquah,98027,3385,2015
king,issaquah middle,769,4,154,5,159,18,87,470,31,378,391,110,17411,issaquah,98027,3038,2015
king,issaquah special services,91,0,19,0,19,1,10,51,10,50,41,1,17411,issaquah,98027,1624,2015
king,issaquah valley elementary,645,2,52,1,53,13,112,404,61,324,321,151,17411,issaquah,98027,3673,2015
king,liberty sr high,1278,6,194,6,200,32,119,862,59,627,651,134,17411,renton,98059,3962,2015
king,maple hills elementary,408,2,3,1,4,3,21,343,35,198,210,39,17411,renton,98059,3637,2015
king,maywood middle,1018,1,212,5,217,24,99,629,48,509,509,140,17411,renton,98059,3636,2015
king,newcastle elementary,586,0,165,1,166,12,45,301,62,288,298,39,17411,newcastle,98059,4592,2015
king,pacific cascade middle,922,1,244,3,247,32,50,546,46,448,474,71,17411,issaquah,98029,5200,2015
king,pine lake middle,844,1,271,5,276,16,52,463,36,442,402,33,17411,sammamish,98075,3879,2015
king,skyline high,2137,6,552,5,557,41,122,1317,94,1113,1024,86,17411,sammamish,98075,4495,2015
king,sunny hills elementary,605,0,153,2,155,10,36,357,47,306,299,47,17411,sammamish,98075,3386,2015
king,sunset elementary,651,3,133,4,137,12,41,414,44,344,307,48,17411,bellevue,98008,3228,2015
franklin,kahlotus elem & high,45,0,0,0,0,0,13,30,2,22,23,38,11056,kahlotus,99335,3214,2015
cowlitz,kalama elem,431,1,5,4,9,3,21,392,5,227,204,175,08402,kalama,98625,2915,2015
cowlitz,barnes elementary,353,1,0,3,3,1,74,257,17,187,166,299,08458,kelso,98626,3323,2015
cowlitz,beacon hill elementary,527,0,3,2,5,1,86,403,32,261,266,289,08458,longview,98632,3578,2015
cowlitz,butler acres elementary,376,3,5,1,6,1,37,301,28,180,196,165,08458,kelso,98626,3082,2015
cowlitz,carrolls elementary,145,5,4,0,4,0,13,115,8,79,66,33,08458,carrolls,98609,2913,2015
cowlitz,catlin elementary,278,1,1,0,1,3,47,206,20,147,131,223,08458,kelso,98626,2691,2015
cowlitz,coweeman middle,584,24,10,3,13,4,84,414,45,289,295,282,08458,kelso,98626,3322,2015
cowlitz,huntington middle,560,7,5,5,10,1,92,397,53,277,283,298,08458,kelso,98626,2916,2015
cowlitz,kelso high,1517,34,24,6,30,9,207,1133,104,754,763,673,08458,kelso,98626,2266,2015
cowlitz,kelso virtual academy,14,0,0,0,0,0,1,10,3,3,11,21,08458,kelso,98626,5194,2015
cowlitz,loowit high,27,0,1,0,1,0,4,21,1,14,13,21,08458,kelso,98626,1934,2015
cowlitz,rose valley elementary,126,3,0,0,0,1,10,108,4,57,69,41,08458,kelso,98626,2596,2015
cowlitz,special education,14,2,0,0,0,0,0,11,1,9,5,6,08458,kelso,98626,5076,2015
cowlitz,wallace elementary,378,2,2,10,12,1,142,199,22,205,173,322,08458,kelso,98626,2624,2015
benton,amistad elementary,572,1,8,0,8,30,362,164,7,287,285,549,03017,kennewick,99336,4418,2015
benton,canyon view elementary,593,3,1,1,2,7,214,342,25,321,272,438,03017,kennewick,99337,4072,2015
benton,cascade elementary,591,1,2,0,2,7,91,467,23,333,258,256,03017,kennewick,99337,4202,2015
benton,cottonwood elementary,661,4,7,0,7,11,26,599,14,342,319,93,03017,kennewick,99338,5220,2015
benton,desert hills middle,990,7,23,0,23,11,146,784,19,538,452,238,03017,kennewick,99338,4028,2015
benton,eastgate elementary,520,0,4,0,4,4,384,119,9,282,238,474,03017,kennewick,99336,2824,2015
benton,edison elementary school - kennewick,620,2,4,0,4,16,154,432,12,302,318,491,03017,kennewick,99336,3315,2015
benton,hawthorne elementary school - kennewick,528,0,2,3,5,13,277,212,21,263,265,422,03017,kennewick,99336,3077,2015
benton,highlands middle,944,4,18,5,23,26,411,460,20,475,469,697,03017,kennewick,99336,3267,2015
benton,horse heaven hills middle,919,8,8,3,11,12,233,623,32,492,427,394,03017,kennewick,99337,4429,2015
benton,kamiakin high,1778,12,43,6,49,37,365,1276,39,932,846,544,03017,kennewick,99336,3731,2015
benton,keewaydin discovery center,210,0,2,0,2,3,67,131,7,142,68,61,03017,kennewick,99336,2000,2015
benton,kennewick high,1527,12,43,0,43,43,644,756,29,837,690,995,03017,kennewick,99336,2826,2015
benton,legacy high,166,3,0,0,0,4,42,114,3,86,80,117,03017,kennewick,99336,1884,2015
benton,lincoln elementary,521,0,14,4,18,15,80,388,20,282,239,278,03017,kennewick,99338,4181,2015
benton,mid-columbia parent partnership,279,2,4,0,4,5,12,252,4,143,136,55,03017,kennewick,99336,1941,2015
benton,park middle,831,4,27,2,29,32,475,272,19,428,403,742,03017,kennewick,99336,3472,2015
benton,phoenix high,54,0,1,0,1,0,11,41,1,22,32,36,03017,kennewick,99338,5106,2015
benton,ridge view elementary,569,2,22,0,22,1,74,442,28,290,279,100,03017,kennewick,99338,4446,2015
benton,southgate elementary,612,1,11,1,12,14,123,439,23,314,298,282,03017,kennewick,99337,4073,2015
benton,southridge high,1677,9,31,4,35,31,430,1145,27,830,847,707,03017,kennewick,99338,4484,2015
benton,sunset view elementary,540,5,16,0,16,23,57,413,26,267,273,227,03017,kennewick,99336,4136,2015
benton,vista elementary,552,5,11,0,11,20,93,394,29,263,289,416,03017,kennewick,99336,3369,2015
benton,washington elementary,536,2,2,0,2,11,218,282,21,275,261,417,03017,kennewick,99337,3144,2015
benton,westgate elementary,569,3,60,5,65,46,77,362,16,309,260,503,03017,kennewick,99336,2825,2015
king,birth to age 2,109,0,13,1,14,13,21,50,11,66,43,3,17415,kent,98030,5150,2015
king,carriage crest elementary,426,1,93,2,95,30,50,201,49,221,205,104,17415,renton,98058,4353,2015
king,cedar heights middle,646,5,45,10,55,55,98,374,59,351,295,281,17415,covington,98042,4440,2015
king,cedar valley elementary,303,4,6,1,7,26,101,142,23,179,124,195,17415,covington,98042,3676,2015
king,covington elementary,487,5,56,3,59,43,109,236,35,263,224,240,17415,covington,98042,3388,2015
king,crestwood elementary,489,4,30,1,31,10,68,324,52,260,229,116,17415,covington,98042,4126,2015
king,east hill elementary,594,1,122,20,142,113,177,91,70,304,290,461,17415,kent,98031,2851,2015
king,emerald park elementary,487,0,146,10,156,81,83,115,52,239,248,274,17415,kent,98031,4545,2015
king,fairwood elementary,437,0,47,3,50,46,73,197,71,210,227,179,17415,renton,98058,3678,2015
king,george t. daniel elementary,590,1,58,12,70,132,210,123,54,307,283,486,17415,kent,98030,4413,2015
king,glenridge elementary,458,0,132,4,136,69,57,146,50,229,229,264,17415,kent,98031,4489,2015
king,grass lake elementary,424,2,17,1,18,16,55,307,26,214,210,109,17415,kent,98042,3708,2015
king,horizon elementary,447,3,66,10,76,47,74,208,39,216,231,240,17415,kent,98042,4345,2015
king,igrad,451,5,40,10,50,61,120,183,32,253,198,172,17415,kent,98030,5275,2015
king,jenkins creek elementary,381,2,27,8,35,17,67,206,54,189,192,181,17415,covington,98042,4301,2015
king,kent elementary,687,1,48,53,101,59,364,95,67,359,328,577,17415,kent,98032,4520,2015
king,kent mountain view academy,342,1,55,6,61,28,54,158,40,176,166,115,17415,des moines,98198,3014,2015
king,kent phoenix academy,298,2,17,4,21,39,75,130,31,126,172,195,17415,kent,98030,5098,2015
king,kent-meridian high,2187,9,471,92,563,423,575,487,130,1170,1017,1399,17415,kent,98030,2797,2015
king,kentlake high,1504,6,118,26,144,95,233,900,126,763,741,523,17415,kent,98042,4492,2015
king,kentridge high,2238,12,526,41,567,229,247,981,202,1130,1108,679,17415,kent,98031,3640,2015
king,kentwood high,2000,10,422,29,451,180,309,879,171,1071,929,699,17415,covington,98042,4128,2015
king,lake youngs elementary,481,6,110,0,110,23,63,235,44,246,235,138,17415,kent,98042,3550,2015
king,martin sortun elementary,612,2,207,11,218,80,90,168,54,316,296,314,17415,kent,98030,4294,2015
king,mattson middle,604,5,75,8,83,58,102,301,55,326,278,255,17415,covington,98042,4127,2015
king,meadow ridge elementary,573,3,131,31,162,103,119,139,47,338,235,445,17415,kent,98030,4465,2015
king,meeker middle,683,2,175,16,191,138,125,175,52,355,328,396,17415,renton,98058,3764,2015
king,meridian elementary,641,0,112,2,114,59,115,297,56,333,308,317,17415,kent,98042,2565,2015
king,meridian middle,682,6,189,29,218,101,149,165,43,356,326,411,17415,kent,98031,3233,2015
king,mill creek middle,877,4,139,35,174,162,320,168,49,454,423,670,17415,kent,98032,5016,2015
king,millennium elementary,575,2,95,12,107,89,161,166,50,300,275,428,17415,kent,98030,4581,2015
king,neely o brien elementary,744,3,154,27,181,127,224,120,89,395,349,494,17415,kent,98032,4356,2015
king,northwood middle,639,4,118,13,131,65,72,276,91,320,319,191,17415,renton,98058,4485,2015
king,panther lake elementary,657,1,120,14,134,83,203,159,77,352,305,455,17415,kent,98031,5178,2015
king,park orchard elementary,556,0,88,10,98,88,190,110,70,294,262,438,17415,kent,98031,3491,2015
king,pine tree elementary,530,2,75,23,98,102,99,162,67,280,250,375,17415,kent,98030,3593,2015
king,regional justice center,13,0,0,0,0,6,4,2,1,13,0,6,17415,kent,98030,1807,2015
king,ridgewood elementary,511,3,112,13,125,35,46,224,78,274,237,98,17415,renton,98058,4293,2015
king,sawyer woods elementary,456,1,18,5,23,14,37,325,56,234,222,129,17415,black diamond,98010,4466,2015
king,scenic hill elementary,611,2,39,13,52,106,257,125,69,319,292,528,17415,kent,98030,3389,2015
king,soos creek elementary,356,0,71,14,85,45,60,120,46,203,153,178,17415,kent,98031,3707,2015
king,springbrook elementary,533,5,88,28,116,75,207,96,34,281,252,387,17415,kent,98031,3677,2015
king,sunrise elementary,553,1,175,15,190,49,68,176,69,291,262,176,17415,kent,98042,4420,2015
stevens,columbia virtual academy - kettle falls,190,10,3,0,3,2,9,162,4,83,107,55,33212,kettle falls,99141,5180,2015
stevens,kettle falls elementary,269,4,2,0,2,2,15,239,7,141,128,176,33212,kettle falls,99141,2385,2015
stevens,kettle falls high,248,2,2,3,5,0,17,216,8,129,119,122,33212,kettle falls,99141,4206,2015
stevens,kettle falls middle,221,8,1,0,1,0,13,194,5,110,111,125,33212,kettle falls,99141,3198,2015
benton,kiona-benton city high,481,2,2,0,2,3,172,287,15,263,218,232,03052,benton city,99320,2904,2015
benton,kiona-benton city middle,330,2,2,0,2,1,138,181,6,163,167,210,03052,benton city,99320,3961,2015
benton,kiona-benton city primary,486,3,1,0,1,1,227,233,21,244,242,347,03052,benton city,99320,2759,2015
benton,kiona-benton intermediate,204,1,1,0,1,0,91,107,4,114,90,130,03052,benton city,99320,4217,2015
kittitas,kittitas b-5 special ed program,9,0,0,0,0,0,2,7,0,5,4,5,19403,kittitas,98934,5086,2015
kittitas,kittitas elementary,287,0,1,0,1,0,59,223,4,141,146,152,19403,kittitas,98934,2569,2015
kittitas,kittitas high,367,1,6,0,6,2,83,269,6,193,174,146,19403,kittitas,98934,2766,2015
klickitat,klickitat elem & high,80,1,0,0,0,0,2,69,8,42,38,45,20402,klickitat,98628,3494,2015
clark,la center elementary,670,1,4,0,4,5,49,593,18,359,311,207,06101,la center,98629,2558,2015
clark,la center high,550,4,11,0,11,2,34,492,7,285,265,111,06101,la center,98629,4431,2015
clark,la center home school academy,12,0,0,0,0,1,2,8,1,4,8,1,06101,la center,98629,5326,2015
clark,la center middle,389,3,3,0,3,1,19,358,5,196,193,101,06101,la center,98629,3371,2015
skagit,la conner elementary,268,96,1,0,1,0,20,141,10,142,126,153,29311,la conner,98257,2522,2015
skagit,la conner high,225,60,2,4,6,2,25,128,4,113,112,98,29311,la conner,98257,2276,2015
skagit,la conner middle,131,43,2,0,2,0,16,66,4,71,60,62,29311,la conner,98257,3900,2015
whitman,lacrosse elementary,27,0,0,0,0,0,0,27,0,15,12,9,38126,lacrosse,99143,2087,2015
whitman,lacrosse high,35,0,1,0,1,2,0,32,0,19,16,13,38126,lacrosse,99143,2088,2015
chelan,chelan high,419,2,1,0,1,0,212,198,6,220,199,239,04129,chelan,98816,4260,2015
chelan,chelan middle,350,0,0,0,0,0,181,167,2,187,163,210,04129,chelan,98816,2317,2015
chelan,holden village community,18,0,0,0,0,2,0,16,0,11,7,0,04129,chelan,98816,3861,2015
chelan,lake chelan preschool,16,0,0,0,0,0,12,4,0,11,5,16,04129,chelan,98816,1675,2015
chelan,morgen owings elementary,620,0,4,0,4,1,347,264,4,323,297,428,04129,chelan,98816,2689,2015
snohomish,cavelero mid high,1275,11,49,5,54,26,164,933,87,676,599,346,31004,lake stevens,98258,5099,2015
snohomish,glenwood elementary,588,0,7,2,9,4,45,470,60,315,273,146,31004,lake stevens,98258,4391,2015
snohomish,highland elementary,682,3,20,1,21,13,67,520,58,343,339,192,31004,lake stevens,98258,4534,2015
snohomish,hillcrest elementary,807,5,29,1,30,8,155,542,67,424,383,311,31004,lake stevens,98258,2885,2015
snohomish,homelink,151,0,1,0,1,1,11,133,5,69,82,29,31004,lake stevens,98258,1753,2015
snohomish,lake stevens middle,610,4,18,4,22,11,96,422,55,310,300,218,31004,lake stevens,98258,3408,2015
snohomish,lake stevens sr high,1794,16,88,6,94,38,209,1349,88,931,863,373,31004,lake stevens,98258,2426,2015
snohomish,mt. pilchuck elementary,620,7,9,5,14,16,91,445,47,347,273,247,31004,lake stevens,98258,2884,2015
snohomish,north lake middle,652,4,20,5,25,8,70,499,46,338,314,184,31004,lake stevens,98258,4139,2015
snohomish,skyline elementary,506,0,15,0,15,7,84,357,43,253,253,214,31004,lake stevens,98258,4392,2015
snohomish,sunnycrest elementary,747,2,38,0,38,14,104,515,74,396,351,177,31004,lake stevens,98258,3753,2015
king,alcott elementary,593,0,307,0,307,1,22,243,20,305,288,24,17414,redmond,98053,4256,2015
king,audubon elementary,557,1,252,1,253,4,31,238,30,264,293,29,17414,redmond,98052,3548,2015
king,bell elementary,404,1,51,1,52,12,78,234,27,216,188,105,17414,kirkland,98033,3592,2015
king,blackwell elementary,439,0,111,1,112,2,25,268,32,233,206,4,17414,sammamish,98074,4532,2015
king,carson elementary,424,0,96,0,96,5,15,288,20,217,207,7,17414,sammamish,98074,5139,2015
king,community,73,0,7,0,7,0,2,57,7,30,43,3,17414,kirkland,98033,3856,2015
king,contractual schools,21,1,3,0,3,1,4,12,0,14,7,2,17414,redmond,98073,1649,2015
king,dickinson elementary,488,3,109,0,109,5,54,284,33,266,222,58,17414,redmond,98053,4018,2015
king,discovery,73,0,13,0,13,0,3,48,9,35,38,1,17414,kirkland,98034,1658,2015
king,eastlake high,1623,6,176,4,180,15,113,1222,87,822,801,86,17414,sammamish,98074,4439,2015
king,einstein elementary,481,1,93,4,97,24,148,180,31,263,218,207,17414,redmond,98052,4424,2015
king,emerson high,68,2,0,1,1,2,9,48,6,33,35,23,17414,kirkland,98033,3855,2015
king,emerson k-12,116,0,5,0,5,1,5,94,11,57,59,6,17414,kirkland,98033,1688,2015
king,environmental & adventure,144,0,22,0,22,1,3,109,9,80,64,2,17414,kirkland,98034,1800,2015
king,evergreen middle,882,3,241,2,243,12,58,519,47,465,417,55,17414,redmond,98053,4148,2015
king,explorer community,70,0,19,0,19,0,2,45,4,36,34,1,17414,redmond,98052,1687,2015
king,finn hill middle,599,1,52,1,53,19,80,391,55,282,317,123,17414,kirkland,98034,3590,2015
king,franklin elementary,466,0,138,0,138,5,40,240,43,242,224,31,17414,kirkland,98033,3591,2015
king,frost elementary,397,0,34,0,34,11,115,201,36,198,199,154,17414,kirkland,98034,3675,2015
king,futures,59,2,4,0,4,1,11,40,1,34,25,16,17414,kirkland,98034,1804,2015
king,inglewood middle,1160,3,225,0,225,8,67,786,71,622,538,37,17414,sammamish,98074,4386,2015
king,international community,428,1,187,1,188,2,16,194,27,201,227,7,17414,kirkland,98033,1706,2015
king,juanita elementary,351,1,43,0,43,7,56,198,46,193,158,95,17414,kirkland,98034,2796,2015
king,juanita high,1368,5,193,3,196,32,172,879,84,733,635,317,17414,kirkland,98034,3771,2015
king,kamiakin middle,564,1,120,4,124,13,110,274,42,291,273,212,17414,kirkland,98034,3922,2015
king,keller elementary,361,2,46,2,48,12,59,192,48,185,176,107,17414,kirkland,98034,3704,2015
king,kirk elementary,491,2,36,0,36,5,29,393,26,245,246,24,17414,kirkland,98033,3941,2015
king,kirkland middle,574,2,48,2,50,8,40,444,30,310,264,68,17414,kirkland,98033,2308,2015
king,lake washington high,1467,3,164,1,165,28,169,1015,87,747,720,207,17414,kirkland,98033,2739,2015
king,lakeview elementary,514,3,49,4,53,10,47,373,28,272,242,89,17414,kirkland,98033,3041,2015
king,mann elementary,464,1,123,0,123,5,35,278,22,235,229,27,17414,redmond,98052,3529,2015
king,mcauliffe elementary,489,0,137,0,137,6,38,285,23,251,238,18,17414,sammamish,98074,4354,2015
king,mead elementary,590,2,124,0,124,3,46,374,41,309,281,25,17414,sammamish,98074,4096,2015
king,muir elementary,389,0,92,0,92,5,75,194,23,196,193,161,17414,kirkland,98034,3748,2015
king,northstar middle,90,0,27,0,27,0,5,52,6,47,43,3,17414,kirkland,98033,4167,2015
king,ready start preschool,3,0,1,0,1,0,1,1,0,3,0,0,17414,redmond,98052,3549,2015
king,redmond elementary,478,0,145,0,145,17,99,168,49,265,213,139,17414,redmond,98052,2289,2015
king,redmond high,1874,4,303,1,304,33,200,1204,129,906,968,202,17414,redmond,98052,3528,2015
king,redmond middle,1002,4,253,3,256,34,143,489,76,524,478,191,17414,redmond,98052,3232,2015
king,renaissance,95,0,18,0,18,0,5,66,6,28,67,2,17414,sammamish,98074,5057,2015
king,rockwell elementary,672,0,229,2,231,7,37,346,51,360,312,29,17414,redmond,98052,4147,2015
king,rosa parks elementary,597,1,258,0,258,9,36,257,36,282,315,9,17414,redmond,98053,5053,2015
king,rose hill elementary,361,0,56,1,57,12,84,174,34,188,173,129,17414,kirkland,98033,2992,2015
king,rose hill middle,752,1,112,1,113,14,111,445,68,413,339,153,17414,redmond,98052,3706,2015
king,rush elementary,534,1,171,0,171,11,67,256,28,283,251,49,17414,redmond,98052,3703,2015
king,sandburg elementary,502,1,41,0,41,1,38,380,41,273,229,48,17414,kirkland,98034,3747,2015
king,smith elementary,597,0,262,0,262,1,33,268,33,301,296,13,17414,sammamish,98074,4302,2015
king,stella schola,91,0,36,0,36,0,3,47,5,47,44,5,17414,redmond,98052,1975,2015
king,tesla stem high,558,0,216,0,216,1,28,287,26,345,213,15,17414,redmond,98053,5265,2015
king,thoreau elementary,276,0,31,0,31,4,21,187,33,139,137,49,17414,kirkland,98034,3490,2015
king,twain elementary,617,4,91,1,92,7,95,347,72,325,292,135,17414,kirkland,98033,3441,2015
king,wilder elementary,575,2,194,0,194,6,34,309,30,292,283,18,17414,woodinville,98077,4336,2015
snohomish,cougar creek elementary,371,9,5,1,6,4,44,279,29,199,172,134,31306,n. lakewood,98259,4576,2015
snohomish,english crossing elementary,345,3,7,4,11,4,59,242,26,185,160,133,31306,n. lakewood,98259,4477,2015
snohomish,lakewood elementary,382,7,6,1,7,12,72,255,29,199,183,152,31306,n. lakewood,98259,3255,2015
snohomish,lakewood high,737,6,13,2,15,10,75,607,24,383,354,137,31306,n lakewood,98259,4204,2015
snohomish,lakewood middle,531,10,10,3,13,8,79,390,31,273,258,162,31306,n. lakewood,98259,3893,2015
whitman,lamont middle,31,0,0,0,0,0,4,26,1,13,18,16,38264,lamont,99017,3137,2015
spokane,liberty high,121,1,0,0,0,1,1,117,1,66,55,49,32362,spangle,99031,3416,2015
spokane,liberty jr high & elementary,296,2,0,0,0,2,24,258,10,166,130,114,32362,spangle,99031,4226,2015
adams,lind elementary,86,0,1,0,1,0,24,61,0,44,42,49,01158,lind,99341,3421,2015
adams,lind-ritzville high,45,1,0,0,0,0,16,25,3,26,19,21,01158,ritzville,99169,2903,2015
adams,lind-ritzville middle,49,0,3,0,3,0,14,31,1,22,27,31,01158,lind,99341,5293,2015
cowlitz,broadway learning center,73,0,2,0,2,1,13,51,6,57,16,91,08122,longview,98632,2665,2015
cowlitz,cascade middle,486,8,13,3,16,6,96,318,42,218,268,275,08122,longview,98632,3475,2015
cowlitz,columbia heights elementary,349,4,3,0,3,1,38,280,23,182,167,193,08122,longview,98632,3211,2015
cowlitz,columbia valley garden elem,430,3,9,0,9,4,47,343,24,206,224,196,08122,longview,98632,2369,2015
cowlitz,kessler elementary,354,2,3,5,8,3,97,216,28,191,163,337,08122,longview,98632,2319,2015
cowlitz,longview school district special services,45,0,0,0,0,0,8,34,3,26,19,27,08122,longview,98632,3913,2015
cowlitz,mark morris high,920,11,11,4,15,9,136,685,64,480,440,349,08122,longview,98632,3151,2015
cowlitz,mint valley elementary,413,2,1,1,2,3,73,304,29,206,207,321,08122,longview,98632,3658,2015
cowlitz,monticello middle,472,8,15,2,17,3,118,294,32,248,224,341,08122,longview,98632,2831,2015
cowlitz,mt. solo middle,485,9,8,0,8,1,53,381,33,235,250,212,08122,longview,98632,4574,2015
cowlitz,northlake elementary,345,5,4,1,5,5,144,162,24,186,159,291,08122,longview,98632,2914,2015
cowlitz,olympic elementary,352,8,7,1,8,2,81,230,23,179,173,307,08122,longview,98632,2726,2015
cowlitz,on track academy,201,2,1,0,1,4,44,134,16,94,107,138,08122,spokane,99207,5250,2015
cowlitz,r a long high,933,10,28,5,33,17,169,635,69,464,469,487,08122,longview,98632,2416,2015
cowlitz,robert gray elementary,472,5,6,0,6,2,57,373,29,214,258,180,08122,longview,98632,3019,2015
cowlitz,saint helens elementary,373,4,7,0,7,7,138,189,28,200,173,342,08122,longview,98632,2370,2015
stevens,loon lake elementary,101,0,0,0,0,0,9,88,4,50,51,96,33183,loon lake,99148,2480,2015
stevens,loon lake homelink program,107,0,5,0,5,1,10,85,6,52,55,39,33183,loon lake,99148,1922,2015
san juan,cva-lopez island,24,0,0,0,0,1,5,18,0,8,16,0,28144,lopez island,98261,5299,2015
san juan,decatur elementary,1,0,0,0,0,0,0,1,0,1,0,0,28144,anacortes,98221,4178,2015
san juan,lopez elementary,117,3,4,0,4,0,29,80,1,54,63,63,28144,lopez island,98261,4107,2015
san juan,lopez middle high,100,0,8,0,8,2,12,75,3,53,47,36,28144,lopez island,98261,2632,2015
klickitat,dallesport elementary,119,8,0,0,0,0,20,82,9,67,52,80,20406,lyle,98635,3049,2015
klickitat,lyle high,79,9,0,0,0,1,10,57,2,47,32,40,20406,lyle,98635,3111,2015
klickitat,lyle middle,47,6,0,0,0,0,8,30,3,26,21,32,20406,lyle,98635,3643,2015
whatcom,fisher elementary,375,1,5,1,6,6,125,230,7,212,163,200,37504,lynden,98264,3417,2015
whatcom,isom elementary,433,1,11,0,11,7,97,305,12,216,217,161,37504,lynden,98264,4324,2015
whatcom,lynden academy,192,1,0,0,0,1,7,180,3,83,109,6,37504,lynden,98264,1983,2015
whatcom,lynden high,845,3,31,1,32,6,190,592,22,436,409,290,37504,lynden,98264,4201,2015
whatcom,lynden middle,605,1,13,1,14,7,145,410,28,304,301,255,37504,lynden,98264,2219,2015
whatcom,lynden special services,83,1,1,0,1,1,10,69,1,50,33,0,37504,lynden,98264,1914,2015
whatcom,vossbeck elementary,429,1,11,0,11,9,105,290,13,219,210,168,37504,lynden,98264,4517,2015
yakima,artz fox elementary,540,0,0,0,0,0,525,15,0,275,265,456,39120,mabton,98935,3070,2015
yakima,mabton jr. sr. high,407,0,0,0,0,0,395,12,0,199,208,325,39120,mabton,98935,5289,2015
douglas,mansfield elem and high,88,4,3,0,3,1,17,62,1,41,47,64,09207,mansfield,98830,2233,2015
chelan,manson elementary,328,4,1,0,1,3,217,102,1,169,159,254,04019,manson,98831,2196,2015
chelan,manson high,193,0,4,0,4,2,131,55,1,113,80,145,04019,manson,98831,2623,2015
chelan,manson middle,147,2,1,0,1,1,98,45,0,77,70,119,04019,manson,98831,5286,2015
stevens,mary walker high,138,13,2,1,3,1,5,104,12,79,59,67,33207,springdale,99173,3311,2015
stevens,springdale elementary,184,23,0,0,0,4,14,128,15,106,78,129,33207,springdale,99173,2297,2015
stevens,springdale middle,108,16,1,2,3,0,3,78,8,58,50,64,33207,springdale,99173,3894,2015
snohomish,10th street,167,4,3,0,3,0,15,129,16,82,85,24,31025,marysville,98271,1656,2015
snohomish,allen creek elementary,491,15,39,1,40,9,70,318,39,270,221,184,31025,marysville,98270,4454,2015
snohomish,cascade elementary,445,10,34,5,39,6,120,222,48,226,219,256,31025,marysville,98270,3059,2015
snohomish,cedarcrest,906,17,54,4,58,14,231,494,92,435,471,411,31025,marysville,98270,4357,2015
snohomish,grove elementary,526,19,32,4,36,5,89,314,63,278,248,200,31025,marysville,98270,5123,2015
snohomish,heritage,91,59,0,0,0,0,13,6,13,43,48,56,31025,marysville,98271,1657,2015
snohomish,kellogg marsh elementary,540,10,15,9,24,6,98,352,50,294,246,255,31025,marysville,98270,4323,2015
snohomish,liberty elementary,498,28,21,9,30,3,216,183,38,250,248,407,31025,marysville,98270,3964,2015
snohomish,marshall elementary,389,17,7,7,14,3,65,221,69,206,183,228,31025,marysville,98271,4150,2015
snohomish,marysville coop program,289,19,4,0,4,4,37,190,35,151,138,58,31025,marysville,98270,1862,2015
snohomish,marysville middle,825,22,46,9,55,19,198,459,72,426,399,420,31025,marysville,98270,3355,2015
snohomish,marysville pilchuck high,1253,77,46,1,47,25,250,736,118,652,601,446,31025,marysville,98271,5213,2015
snohomish,marysville sd special,82,5,8,0,8,0,13,47,9,48,34,37,31025,marysville,98270,1910,2015
snohomish,pinewood elementary,527,14,14,6,20,4,122,319,48,264,263,246,31025,marysville,98270,3651,2015
snohomish,quil ceda tulalip elementary,540,207,3,2,5,5,119,141,63,270,270,394,31025,tulalip,98271,5350,2015
snohomish,school home partnership program,125,11,0,2,2,1,16,84,11,42,83,56,31025,marysville,98271,1744,2015
snohomish,shoultes elementary,477,6,22,2,24,13,102,273,59,248,229,267,31025,marysville,98271,3187,2015
snohomish,sunnyside elementary,495,6,37,6,43,16,107,287,36,240,255,218,31025,marysville,98270,3537,2015
snohomish,totem middle,574,85,27,4,31,6,110,277,65,275,299,248,31025,marysville,98270,2813,2015
grays harbor,mccleary elem,285,5,1,0,1,8,7,258,6,162,123,115,14065,mccleary,98557,2835,2015
spokane,brentwood elementary,546,0,1,0,1,11,34,462,38,282,264,200,32354,spokane,99218,3693,2015
spokane,colbert elementary,511,2,9,2,11,0,18,464,16,249,262,130,32354,colbert,99005,3562,2015
spokane,evergreen elementary,548,2,7,9,16,9,29,459,33,282,266,246,32354,spokane,99208,3414,2015
spokane,farwell elementary,621,7,14,3,17,8,41,503,45,333,288,244,32354,spokane,99208,3759,2015
spokane,mead alternative high,97,0,0,0,0,1,7,79,10,43,54,62,32354,spokane,99218,1803,2015
spokane,mead education partnership prog,409,0,0,0,0,5,15,361,28,202,207,123,32354,spokane,99208,1858,2015
spokane,mead preschool,44,1,0,0,0,1,0,40,2,26,18,0,32354,mead,99021,5122,2015
spokane,mead senior high,1585,0,0,0,0,18,95,1320,152,807,778,375,32354,spokane,99218,2402,2015
spokane,meadow ridge elementary,585,2,4,0,4,4,32,518,25,299,286,184,32354,mead,99021,4400,2015
spokane,midway elementary,551,1,2,0,2,3,34,477,34,281,270,88,32354,colbert,99005,4133,2015
spokane,mountainside middle,699,5,10,8,18,6,27,604,39,360,339,218,32354,colbert,99005,3191,2015
spokane,mt spokane high,1483,1,7,7,14,17,91,1216,144,727,756,433,32354,mead,99021,4491,2015
spokane,northwood middle,772,6,9,1,10,6,46,633,71,410,362,199,32354,spokane,99208,3851,2015
spokane,prairie view elementary,686,0,1,0,1,11,24,582,68,385,301,94,32354,spokane,99208,5094,2015
spokane,riverpoint academy,130,0,0,0,0,1,7,114,8,74,56,25,32354,spokane,99218,5268,2015
spokane,shiloh hills elementary,545,13,16,34,50,10,56,364,52,268,277,423,32354,spokane,99208,4134,2015
spokane,hallett elementary,466,2,4,1,5,7,30,387,35,235,231,222,32326,medical lake,99022,4483,2015
spokane,medical lake high,531,3,9,2,11,19,45,407,46,305,226,154,32326,medical lake,99022,2890,2015
spokane,medical lake middle,380,0,1,2,3,7,39,294,37,215,165,134,32326,medical lake,99022,3965,2015
spokane,michael anderson elementary,467,0,9,3,12,24,66,310,55,262,205,104,32326,fairchild afb,99011,4577,2015
king,island park elementary,576,0,122,2,124,12,29,346,65,282,294,29,17400,mercer island,98040,3162,2015
king,islander middle,1095,2,201,3,204,10,41,778,60,594,501,46,17400,mercer island,98040,3219,2015
king,lakeridge elementary,643,0,90,1,91,5,36,450,61,353,290,15,17400,mercer island,98040,2981,2015
king,mercer island high,1416,6,291,2,293,24,54,1004,35,726,690,59,17400,mercer island,98040,3029,2015
king,west mercer elementary,708,0,140,1,141,8,33,448,78,390,318,20,17400,mercer island,98040,3433,2015
whatcom,irene reither elementary,587,6,22,0,22,7,139,387,26,297,290,293,37505,everson,98226,2584,2015
whatcom,meridian high,500,7,31,1,32,2,89,350,20,274,226,195,37505,bellingham,98226,2554,2015
whatcom,meridian middle,302,3,16,0,16,5,62,209,7,142,160,148,37505,lynden,98264,3930,2015
whatcom,meridian parent partnership program,347,2,5,0,5,8,20,299,13,184,163,23,37505,bellingham,98226,5047,2015
whatcom,meridian special programs,25,0,0,0,0,0,6,19,0,17,8,0,37505,bellingham,98226,1743,2015
okanogan,alternative,19,0,0,0,0,0,2,16,1,8,11,12,24350,winthrop,98862,1621,2015
okanogan,home school experience,19,0,0,0,0,0,0,16,3,14,5,9,24350,winthrop,98862,1845,2015
okanogan,liberty bell jr sr high,266,0,9,0,9,0,16,236,5,137,129,102,24350,winthrop,98862,2146,2015
okanogan,methow valley elementary,331,2,1,0,1,0,21,299,8,170,161,167,24350,winthrop,98862,4501,2015
skamania,mill a elementary,28,6,0,0,0,0,3,19,0,11,17,11,30031,cook,98605,3406,2015
snohomish,chain lake elementary,577,1,12,0,12,1,60,462,41,282,295,125,31103,snohomish,98290,4362,2015
snohomish,frank wagner elementary,562,3,10,3,13,0,353,167,26,298,264,413,31103,monroe,98272,3060,2015
snohomish,fryelands elementary,515,3,11,0,11,3,126,350,22,261,254,179,31103,monroe,98272,4594,2015
snohomish,hidden river middle,429,1,12,0,12,3,73,315,25,240,189,123,31103,snohomish,98296,4544,2015
snohomish,leaders in learning,95,2,2,0,2,0,25,62,4,49,46,41,31103,monroe,98272,1806,2015
snohomish,maltby elementary,398,3,21,1,22,3,52,310,8,205,193,105,31103,snohomish,98296,2546,2015
snohomish,monroe high,1664,15,52,5,57,11,291,1208,82,830,834,408,31103,monroe,98272,4528,2015
snohomish,monroe special ed preschool,30,0,1,0,1,0,5,24,0,18,12,4,31103,monroe,98272,1570,2015
snohomish,out of district special ed,13,0,0,0,0,0,1,12,0,7,6,0,31103,monroe,98272,1643,2015
snohomish,park place middle,797,8,15,3,18,0,187,556,28,398,399,281,31103,monroe,98272,5040,2015
snohomish,salem woods elementary,464,8,5,1,6,3,40,383,24,235,229,119,31103,monroe,98272,4159,2015
snohomish,shoreline-monroe high,298,2,10,1,11,25,40,199,21,175,123,19,31103,monroe,98272,5154,2015
snohomish,sky valley education center,879,4,16,3,19,10,38,775,33,433,446,61,31103,monroe,98272,1777,2015
snohomish,youth re-engagement,229,6,0,0,0,8,32,182,1,120,109,20,31103,monroe,98272,1883,2015
grays harbor,beacon avenue elementary,380,3,7,1,8,1,31,317,20,192,188,162,14066,montesano,98563,3661,2015
grays harbor,montesano jr-sr high,605,4,7,0,7,0,66,485,42,308,297,186,14066,montesano,98563,2180,2015
grays harbor,simpson avenue elementary,315,10,2,0,2,0,37,250,16,165,150,133,14066,montesano,98563,3374,2015
lewis,morton elementary,168,0,1,0,1,2,20,132,13,97,71,121,21214,morton,98356,2678,2015
lewis,morton junior-senior high,139,2,2,1,3,1,13,114,6,67,72,93,21214,morton,98356,3112,2015
grant,chief moses middle,882,6,9,0,9,2,401,444,20,444,438,520,13161,moses lake,98837,3022,2015
grant,endeavor middle,262,2,0,0,0,6,148,97,9,139,123,237,13161,moses lake,98837,5354,2015
grant,frontier middle,685,2,6,0,6,12,282,367,16,351,334,421,13161,moses lake,98837,2673,2015
grant,garden heights elementary,495,1,8,0,8,3,196,269,18,242,253,236,13161,moses lake,98837,3091,2015
grant,knolls vista elementary,426,1,6,0,6,12,227,165,15,220,206,327,13161,moses lake,98837,2833,2015
grant,lakeview terrace elementary,403,1,2,0,2,5,180,212,3,194,209,243,13161,moses lake,98837,2969,2015
grant,larson heights elementary,331,2,0,1,1,7,158,151,12,175,156,289,13161,moses lake,98837,3021,2015
grant,longview elementary,427,1,4,0,4,5,220,193,4,229,198,308,13161,moses lake,98837,3153,2015
grant,midway elementary,380,2,5,0,5,6,191,161,15,217,163,290,13161,moses lake,98837,2970,2015
grant,moses lake high,2385,26,28,3,31,34,972,1276,46,1186,1199,1198,13161,moses lake,98837,3215,2015
grant,north elementary,272,1,0,0,0,3,148,103,17,142,130,251,13161,moses lake,98837,3779,2015
grant,park orchard elementary,411,5,1,0,1,4,189,203,9,199,212,283,13161,moses lake,98837,5251,2015
grant,peninsula elementary,430,2,4,0,4,6,214,195,9,211,219,302,13161,moses lake,98837,2832,2015
grant,sage point elementary,412,0,4,0,4,5,111,282,10,209,203,137,13161,moses lake,98837,5173,2015
grant,skill source learning center,55,2,0,0,0,4,26,21,2,41,14,36,13161,moses lake,98837,5323,2015
lewis,mossyrock elementary,276,6,1,1,2,0,81,187,0,143,133,178,21206,mossyrock,98564,2572,2015
lewis,mossyrock jr./sr. high,246,4,1,1,2,1,38,199,2,138,108,129,21206,mossyrock,98564,3238,2015
yakima,harrah elementary,576,303,0,0,0,0,210,28,35,287,289,388,39209,harrah,98933,2506,2015
yakima,mount adams middle,135,68,0,0,0,0,50,6,11,69,66,101,39209,white swan,98952,2389,2015
yakima,white swan high,252,135,0,0,0,0,93,8,16,126,126,145,39209,white swan,98952,2532,2015
whatcom,acme elementary,198,25,1,0,1,1,11,137,23,98,100,102,37507,acme,98220,2585,2015
whatcom,educational resource center,30,2,0,0,0,0,4,21,3,24,6,21,37507,deming,98244,1936,2015
whatcom,harmony elementary,371,30,2,0,2,1,28,283,27,194,177,167,37507,bellingham,98226,3365,2015
whatcom,kendall elementary,420,9,7,1,8,4,57,319,23,219,201,314,37507,maple falls,98266,4533,2015
whatcom,mount baker academy,35,0,0,0,0,0,1,33,1,16,19,12,37507,acme,98220,5112,2015
whatcom,mount baker junior high,275,18,2,1,3,0,34,209,11,156,119,158,37507,deming,98244,3003,2015
whatcom,mount baker senior high,561,24,7,1,8,2,64,437,26,281,280,260,37507,deming,98244,2343,2015
skagit,jefferson elementary,475,2,9,3,12,3,259,197,2,241,234,313,29320,mount vernon,98273,3183,2015
skagit,la venture middle,603,5,8,0,8,5,402,173,10,309,294,465,29320,mount vernon,98273,3821,2015
skagit,lincoln elementary,362,3,3,5,8,0,207,130,14,173,189,280,29320,mount vernon,98274,2579,2015
skagit,little mountain elementary,593,5,19,1,20,7,314,227,20,309,284,393,29320,mount vernon,98274,4013,2015
skagit,madison elementary,523,0,9,2,11,8,341,151,12,255,268,347,29320,mount vernon,98273,3001,2015
skagit,mount baker middle,709,4,18,7,25,14,359,276,31,373,336,449,29320,mount vernon,98274,4511,2015
skagit,mount vernon high,1962,13,38,16,54,14,1019,819,43,989,973,1109,29320,mount vernon,98273,2295,2015
skagit,mount vernon special ed,114,0,1,0,1,1,56,56,0,71,43,74,29320,mount vernon,98273,3829,2015
skagit,washington elementary,386,6,4,0,4,3,223,142,8,212,174,318,29320,mount vernon,98273,2880,2015
snohomish,aces high,199,5,4,1,5,9,86,84,10,117,82,119,31006,everett,98204,4247,2015
snohomish,challenger elementary,813,1,67,19,86,50,339,253,84,419,394,621,31006,everett,98204,4303,2015
snohomish,columbia elementary,614,3,80,6,86,18,99,321,87,311,303,200,31006,mukilteo,98275,4342,2015
snohomish,discovery elementary,729,3,69,8,77,39,317,213,80,388,341,553,31006,everett,98208,4304,2015
snohomish,endeavour elementary,509,3,182,2,184,24,67,175,56,263,246,89,31006,mukilteo,98275,4469,2015
snohomish,explorer middle,919,5,145,14,159,46,344,300,65,496,423,589,31006,everett,98204,4231,2015
snohomish,fairmount elementary,734,4,106,5,111,53,231,255,80,376,358,492,31006,everett,98204,2886,2015
snohomish,harbour pointe middle,835,2,204,3,207,22,95,441,68,445,390,190,31006,mukilteo,98275,4430,2015
snohomish,horizon elementary,774,2,29,13,42,33,486,163,48,410,364,670,31006,everett,98204,4344,2015
snohomish,kamiak high,2101,14,445,9,454,55,187,1255,136,1073,1028,350,31006,mukilteo,98275,4433,2015
snohomish,mariner high,2174,13,316,39,355,188,731,739,147,1142,1032,1310,31006,everett,98204,3688,2015
snohomish,mukilteo elementary,651,0,94,1,95,10,37,445,64,333,318,109,31006,mukilteo,98275,4164,2015
snohomish,odyssey elementary,717,1,138,10,148,56,204,248,60,385,332,369,31006,everett,98204,4583,2015
snohomish,olivia park elementary,665,1,63,14,77,40,289,188,70,342,323,467,31006,everett,98204,3121,2015
snohomish,olympic view middle,799,6,106,6,112,40,180,413,48,443,356,392,31006,mukilteo,98275,3120,2015
snohomish,picnic point elementary,566,0,65,5,70,67,103,260,66,287,279,269,31006,edmonds,98026,4165,2015
snohomish,serene lake elementary,437,1,49,1,50,30,75,222,59,242,195,201,31006,edmonds,98026,3687,2015
snohomish,special services,56,0,7,0,7,3,8,35,3,39,17,21,31006,everett,98204,1848,2015
snohomish,voyager middle,827,4,97,17,114,85,302,261,61,400,427,536,31006,everett,98204,4425,2015
yakima,naches valley high,475,6,2,0,2,1,91,364,11,255,220,179,39003,naches,98937,2591,2015
yakima,naches valley middle,397,0,2,0,2,0,76,309,10,199,198,198,39003,naches,98937,2898,2015
lewis,napavine elementary,440,1,1,0,1,3,58,358,19,230,210,209,21014,napavine,98565,3288,2015
lewis,napavine jr sr high,352,6,3,0,3,2,40,293,8,174,178,140,21014,napavine,98565,2273,2015
pacific,naselle elementary,147,1,3,0,3,0,18,124,1,73,74,75,25155,naselle,98638,2868,2015
pacific,naselle jr sr high schools,153,1,1,2,3,0,18,122,9,84,69,91,25155,naselle,98638,3295,2015
okanogan,nespelem elementary,118,110,0,0,0,0,5,0,3,68,50,111,24014,nespelem,99155,2494,2015
pend oreille,newport high,358,0,3,1,4,3,18,315,18,187,171,172,26056,newport,99156,2518,2015
pend oreille,sadie halstead middle,320,0,1,0,1,0,6,287,26,166,154,195,26056,newport,99156,3968,2015
pend oreille,stratton elementary,376,3,1,0,1,0,18,332,22,210,166,274,26056,newport,99156,4478,2015
spokane,lake spokane elementary,419,13,2,1,3,6,28,336,33,232,187,145,32325,nine mile falls,99026,4036,2015
spokane,lakeside high,556,12,1,1,2,0,13,505,24,268,288,123,32325,nine mile falls,99026,4333,2015
spokane,lakeside middle,364,4,2,1,3,6,13,313,25,176,188,103,32325,nine mile falls,99026,4521,2015
spokane,nine mile falls elementary,150,3,0,0,0,3,7,133,4,79,71,34,32325,nine mile falls,99026,2341,2015
whatcom,everson elementary,228,24,2,0,2,0,93,97,12,128,100,148,37506,everson,98247,4428,2015
whatcom,nooksack elementary,335,8,1,1,2,0,109,200,16,168,167,177,37506,everson,98247,4525,2015
whatcom,nooksack valley high,494,18,4,0,4,2,142,295,33,249,245,215,37506,everson,98247,2459,2015
whatcom,nooksack valley middle,335,15,6,0,6,2,91,207,14,161,174,185,37506,everson,98247,2687,2015
whatcom,nooksack valley special services,40,1,0,0,0,0,16,20,3,21,19,20,37506,everson,98247,1823,2015
whatcom,sumas elementary,193,4,1,0,1,2,54,125,7,97,96,119,37506,sumas,98295,2489,2015
grays harbor,north beach junior high,92,7,2,0,2,3,6,69,5,51,41,77,14064,ocean shores,98569,3788,2015
grays harbor,north beach senior high,219,24,1,0,1,4,25,152,13,124,95,121,14064,ocean shores,98569,2728,2015
grays harbor,ocean shores elementary,215,24,4,1,5,11,22,150,3,106,109,175,14064,ocean shores,98569,3787,2015
grays harbor,pacific beach elementary,147,43,2,0,2,1,13,72,16,79,68,113,14064,pacific beach,98571,3155,2015
franklin,basin city elem,436,0,2,0,2,0,373,60,1,240,196,396,11051,connell,99326,3325,2015
franklin,connell elem,525,0,7,1,8,0,388,124,5,267,258,414,11051,connell,99326,2918,2015
franklin,connell high,589,1,13,0,13,0,377,191,7,289,300,382,11051,connell,99326,3272,2015
franklin,connell preschool,30,0,0,0,0,0,26,4,0,20,10,24,11051,connell,99326,1889,2015
franklin,mesa elem,172,0,0,0,0,2,96,74,0,105,67,100,11051,mesa,99343,3086,2015
franklin,north franklin virtual academy,6,0,0,0,0,0,0,6,0,3,3,1,11051,connell,99326,5261,2015
franklin,palouse junction high,32,0,0,0,0,0,22,9,1,23,9,34,11051,connell,99326,1754,2015
franklin,robert l olds junior high,304,0,2,0,2,1,208,87,6,158,146,229,11051,connell,99326,2198,2015
kitsap,david wolfle elementary,347,59,2,5,7,2,58,155,66,183,164,199,18400,kingston,98346,2798,2015
kitsap,hilder pearson elementary,321,1,8,2,10,9,28,238,35,164,157,115,18400,poulsbo,98370,2854,2015
kitsap,kingston high,818,51,22,1,23,4,57,598,85,428,390,246,18400,kingston,98346,5085,2015
kitsap,kingston middle,543,47,6,2,8,2,48,369,69,280,263,213,18400,kingston,98346,4359,2015
kitsap,middle school options,37,0,0,0,0,0,0,31,6,15,22,4,18400,kingston,98346,3126,2015
kitsap,north kitsap high,1150,19,41,4,45,14,138,839,95,597,553,246,18400,poulsbo,98370,3236,2015
kitsap,pal program,51,0,1,0,1,0,3,46,1,23,28,22,18400,kingston,98346,1733,2015
kitsap,poulsbo elementary,557,9,32,2,34,7,95,371,41,282,275,207,18400,poulsbo,98370,2026,2015
kitsap,poulsbo middle,814,8,35,4,39,6,98,578,85,370,444,249,18400,poulsbo,98370,2476,2015
kitsap,richard gordon elementary,439,6,7,0,7,4,34,351,37,205,234,124,18400,kingston,98346,4467,2015
kitsap,special programs,31,1,0,0,0,0,0,28,2,21,10,9,18400,poulsbo,98370,1677,2015
kitsap,suquamish elementary,385,45,7,0,7,1,45,215,72,203,182,206,18400,suquamish,98392,3391,2015
kitsap,vinland elementary,602,5,23,0,23,12,97,395,70,298,304,192,18400,poulsbo,98370,4461,2015
mason,belfair elementary,483,4,4,0,4,3,118,321,33,241,242,288,23403,belfair,98528,2662,2015
mason,hawkins middle,433,5,5,1,6,2,86,311,23,203,230,227,23403,belfair,98528,3174,2015
mason,north mason homelink program,12,0,1,0,1,0,1,10,0,4,8,9,23403,belfair,98528,1861,2015
mason,north mason senior high,739,5,11,7,18,10,72,570,64,392,347,296,23403,belfair,98528,3175,2015
mason,sand hill elementary,441,4,2,3,5,3,108,294,27,225,216,298,23403,belfair,98528,4320,2015
pacific,north river,52,1,0,0,0,4,9,38,0,23,29,36,25200,cosmopolis,98537,2292,2015
thurston,aspire middle,302,1,24,0,24,9,29,196,43,115,187,85,34003,lacey,98513,5168,2015
thurston,chambers prairie elementary,557,2,20,18,38,53,130,251,83,284,273,314,34003,lacey,98513,5167,2015
thurston,chinook middle,993,14,101,11,112,42,179,531,115,534,459,439,34003,lacey,98516,3361,2015
thurston,evergreen forest elementary,500,23,25,11,36,33,73,256,79,238,262,179,34003,lacey,98503,4058,2015
thurston,horizons elementary,691,4,43,16,59,36,113,392,87,352,339,217,34003,lacey,98513,4408,2015
thurston,komachin middle,771,6,39,19,58,55,135,411,106,406,365,318,34003,lacey,98503,4409,2015
thurston,lacey elementary,472,4,25,13,38,13,99,251,67,260,212,292,34003,lacey,98503,3653,2015
thurston,lakes elementary,725,3,39,16,55,31,121,399,116,378,347,297,34003,lacey,98503,3539,2015
thurston,lydia hawk elementary,399,10,41,16,57,8,135,138,51,211,188,298,34003,lacey,98503,3262,2015
thurston,meadows elementary,405,9,25,4,29,25,96,178,68,218,187,247,34003,lacey,98513,4255,2015
thurston,mountain view elementary,630,6,56,24,80,26,130,306,82,315,315,350,34003,lacey,98503,3130,2015
thurston,nisqually middle,803,17,50,24,74,45,190,353,124,432,371,419,34003,lacey,98503,3611,2015
thurston,north thurston high,1476,22,164,21,185,73,238,840,118,775,701,491,34003,lacey,98506,3010,2015
thurston,olympic view elementary,703,4,59,13,72,30,113,394,90,367,336,205,34003,lacey,98516,3709,2015
thurston,pleasant glade elementary,471,4,71,2,73,20,105,193,76,236,235,325,34003,lacey,98516,4271,2015
thurston,river ridge high,1064,19,84,26,110,86,209,495,145,558,506,431,34003,lacey,98513,4427,2015
thurston,seven oaks elementary,575,2,27,12,39,31,101,311,91,293,282,261,34003,lacey,98503,4368,2015
thurston,south bay elementary,619,5,28,6,34,19,78,410,73,313,306,213,34003,lacey,98506,2754,2015
thurston,south sound high,201,6,7,3,10,11,39,103,32,105,96,116,34003,lacey,98516,4314,2015
thurston,timberline high,1735,24,112,47,159,133,288,884,247,933,802,591,34003,lacey,98503,3710,2015
thurston,woodland elementary,570,7,23,12,35,24,87,343,74,290,280,223,34003,lacey,98503,4122,2015
stevens,northport elementary,94,0,0,0,0,0,9,83,2,48,46,74,33211,northport,99157,2062,2015
stevens,northport high,70,2,6,0,6,0,7,52,3,38,32,59,33211,northport,99157,2958,2015
stevens,northport homelink program,71,0,2,0,2,0,8,59,2,36,35,37,33211,northport,99157,5252,2015
king,arrowhead elementary,387,0,40,1,41,11,36,268,31,202,185,67,17417,kenmore,98028,3107,2015
king,bear creek elementary,499,0,85,2,87,3,38,340,31,272,227,12,17417,woodinville,98077,4305,2015
king,bothell high,1617,14,199,7,206,38,181,1064,114,842,775,264,17417,bothell,98011,3106,2015
king,c o sorenson,55,2,5,0,5,2,12,31,3,40,15,10,17417,bothell,98011,2493,2015
king,canyon creek elementary,798,4,200,0,200,16,92,402,84,400,398,157,17417,bothell,98021,4017,2015
king,cottage lake elementary,354,2,15,1,16,7,44,262,23,205,149,44,17417,woodinville,98077,3234,2015
king,crystal springs elementary,622,2,121,7,128,21,125,276,70,300,322,142,17417,bothell,98021,3105,2015
king,east ridge elementary,355,0,22,0,22,3,18,285,27,185,170,14,17417,woodinville,98077,4379,2015
king,fernwood elementary,838,3,254,1,255,9,70,437,64,440,398,81,17417,bothell,98012,4306,2015
king,frank love elementary,689,1,75,1,76,6,84,458,64,304,385,163,17417,bothell,98021,4355,2015
king,hollywood hill elementary,363,2,24,1,25,0,42,268,26,198,165,43,17417,woodinville,98072,4124,2015
king,inglemoor hs,1596,9,257,5,262,38,174,1030,83,776,820,234,17417,kenmore,98028,3492,2015
king,kenmore elementary,478,1,42,3,45,8,130,245,49,258,220,197,17417,kenmore,98028,2993,2015
king,kokanee elementary,725,4,216,6,222,10,58,379,52,428,297,95,17417,woodinville,98072,4455,2015
king,lockwood elementary,552,2,89,0,89,7,59,343,52,266,286,63,17417,bothell,98021,3390,2015
king,maywood hills elementary,613,2,62,0,62,9,90,397,53,312,301,131,17417,bothell,98011,3344,2015
king,moorlands elementary,665,1,86,2,88,9,49,474,44,342,323,63,17417,kenmore,98028,3442,2015
king,northshore networks,166,2,9,0,9,2,18,126,9,67,99,14,17417,bothell,98021,1814,2015
king,northshore online,18,0,3,0,3,1,1,13,0,13,5,5,17417,bothell,98021,5331,2015
king,northshore special services,102,1,15,0,15,2,20,54,10,65,37,1,17417,bothell,98021,1815,2015
king,secondary academy for success,129,4,0,4,4,5,19,85,12,69,60,49,17417,bothell,98021,3811,2015
king,shelton view elementary,530,2,159,2,161,5,45,269,48,274,256,61,17417,bothell,98021,3679,2015
king,sunrise elementary,271,0,35,0,35,5,14,201,16,137,134,15,17417,redmond,98052,4187,2015
king,wellington elementary,528,0,54,0,54,5,44,381,44,269,259,48,17417,woodinville,98072,4069,2015
king,westhill elementary,518,0,49,3,52,21,62,314,69,253,265,115,17417,bothell,98011,3287,2015
king,woodin elementary,601,0,58,3,61,5,221,274,40,304,297,218,17417,bothell,98011,3749,2015
king,woodinville hs,1451,0,98,5,103,23,123,1121,81,769,682,127,17417,woodinville,98072,4208,2015
king,woodmoor elementary,848,5,103,2,105,7,194,439,98,417,431,221,17417,bothell,98011,4377,2015
island,broadview elementary,502,1,28,7,35,26,57,306,77,257,245,192,15201,oak harbor,98277,3477,2015
island,crescent harbor elem,493,1,17,4,21,25,94,304,48,263,230,274,15201,oak harbor,98277,3377,2015
island,hillcrest elementary,632,4,43,8,51,23,82,403,69,342,290,215,15201,oak harbor,98277,4328,2015
island,homeconnection,278,0,4,0,4,8,16,239,11,135,143,51,15201,oak harbor,98277,1758,2015
island,igrad academy,22,0,1,1,2,2,4,13,1,10,12,16,15201,oak harbor,98277,5343,2015
island,north whidbey middle,507,3,39,5,44,18,85,316,41,266,241,254,15201,oak harbor,98277,3939,2015
island,oak harbor elementary,462,3,27,7,34,19,84,255,67,237,225,205,15201,oak harbor,98277,2696,2015
island,oak harbor high,1590,11,205,10,215,102,183,999,80,818,772,542,15201,oak harbor,98277,2974,2015
island,olympic view elem,466,1,30,5,35,28,95,247,60,251,215,258,15201,oak harbor,98277,3566,2015
island,special education,114,0,2,1,3,5,19,72,15,74,40,28,15201,oak harbor,98277,3662,2015
whitman,oakesdale elementary,80,0,0,0,0,0,3,77,0,42,38,30,38324,oakesdale,99158,3205,2015
whitman,oakesdale high,37,0,0,0,0,0,2,35,0,19,18,12,38324,oakesdale,99158,2432,2015
grays harbor,oakville elementary,126,38,1,0,1,0,14,70,3,63,63,65,14400,oakville,98568,2922,2015
grays harbor,oakville high,106,42,0,2,2,5,12,45,0,48,58,55,14400,oakville,98568,2283,2015
pacific,ilwaco high,283,7,4,0,4,0,43,212,17,153,130,152,25101,ilwaco,98624,4220,2015
pacific,long beach elementary,277,5,2,0,2,0,47,206,17,144,133,192,25101,long beach,98631,3531,2015
pacific,ocean beach early childhood center,16,0,0,0,0,0,0,16,0,10,6,17,25101,long beach,98631,5179,2015
pacific,ocean park elementary,189,1,1,0,1,0,41,133,13,92,97,142,25101,ocean park,98640,4039,2015
grays harbor,ocosta elementary,335,11,3,0,3,3,86,202,30,178,157,244,14172,westport,98595,3025,2015
grays harbor,ocosta junior - senior high,301,15,4,0,4,0,43,207,32,150,151,190,14172,westport,98595,3024,2015
lincoln,odessa high,96,1,0,0,0,0,6,88,1,55,41,32,22105,odessa,99159,2443,2015
lincoln,p c jantz elementary,127,3,0,0,0,1,16,107,0,73,54,64,22105,odessa,99159,2769,2015
okanogan,grainger elementary,466,38,1,0,1,0,127,263,37,248,218,288,24105,okanogan,98840,2539,2015
okanogan,okanogan alternative high,25,4,0,0,0,0,11,10,0,12,13,15,24105,omak,98841,1980,2015
okanogan,okanogan high,272,26,2,0,2,1,54,180,9,129,143,124,24105,okanogan,98840,2246,2015
okanogan,okanogan middle,255,21,0,0,0,0,55,161,18,126,129,133,24105,okanogan,98840,2245,2015
okanogan,okanogan outreach alternative,53,18,0,0,0,0,6,27,2,28,25,46,24105,okanogan,98840,5151,2015
thurston,avanti high,156,1,0,2,2,1,18,115,19,64,92,47,34111,olympia,98501,1768,2015
thurston,boston harbor elementary,151,0,3,0,3,1,14,123,10,76,75,36,34111,olympia,98506,2487,2015
thurston,capital high,1403,8,106,6,112,29,127,1011,116,737,666,390,34111,olympia,98502,3960,2015
thurston,centennial elementary olympia,530,1,71,0,71,9,54,334,61,260,270,99,34111,olympia,98501,4367,2015
thurston,garfield elementary,321,2,31,0,31,7,63,167,51,153,168,194,34111,olympia,98502,2448,2015
thurston,jefferson middle,414,0,39,3,42,9,51,271,41,210,204,149,34111,olympia,98502,3133,2015
thurston,julia butler hansen elementary,471,5,46,1,47,22,78,250,69,242,229,220,34111,olympia,98502,4472,2015
thurston,leland p brown elementary,319,1,9,1,10,6,44,231,27,174,145,195,34111,olympia,98502,3540,2015
thurston,lincoln elementary,292,1,4,0,4,3,28,234,22,140,152,79,34111,olympia,98501,2342,2015
thurston,madison elementary,264,1,16,2,18,6,45,163,31,147,117,121,34111,olympia,98501,3066,2015
thurston,mckenny elementary,383,1,27,2,29,5,45,251,52,222,161,121,34111,olympia,98501,4458,2015
thurston,mclane elementary,341,1,19,0,19,10,30,259,22,184,157,126,34111,olympia,98502,2621,2015
thurston,olympia high,1783,5,172,7,179,29,153,1267,150,906,877,310,34111,olympia,98501,3132,2015
thurston,olympia regional learning academy,304,1,3,0,3,4,11,255,30,161,143,109,34111,olympia,98501,5078,2015
thurston,pioneer elementary,493,0,27,2,29,5,38,394,27,275,218,111,34111,olympia,98501,3697,2015
thurston,reeves middle,403,4,19,3,22,5,43,299,30,216,187,144,34111,olympia,98506,3696,2015
thurston,roosevelt elementary,420,2,11,0,11,5,68,291,43,228,192,187,34111,olympia,98506,2778,2015
thurston,thurgood marshall middle,383,3,28,0,28,15,51,248,38,204,179,154,34111,olympia,98502,4473,2015
thurston,washington middle,758,4,83,2,85,11,58,521,79,402,356,141,34111,olympia,98501,3711,2015
okanogan,e omak elementary,336,71,1,0,1,0,76,150,38,171,165,244,24019,omak,98841,3051,2015
okanogan,highlands high,28,10,0,0,0,0,2,14,2,9,19,23,24019,omak,98841,4279,2015
okanogan,n omak elementary,420,65,3,0,3,2,116,201,33,223,197,333,24019,omak,98841,2999,2015
okanogan,omak high,404,107,7,0,7,2,86,189,13,193,211,197,24019,omak,98841,2031,2015
okanogan,omak middle,302,85,0,0,0,2,63,141,11,157,145,200,24019,omak,98841,4237,2015
okanogan,washington virtual academy omak elementary,1530,33,112,19,131,101,110,1119,36,756,774,405,24019,omak,98841,5195,2015
okanogan,washington virtual academy omak high,815,9,26,10,36,43,67,642,18,352,463,142,24019,omak,98841,5197,2015
okanogan,washington virtual academy omak middle,1298,24,48,11,59,61,93,1039,22,627,671,314,24019,omak,98841,5196,2015
lewis,onalaska elementary,319,3,0,0,0,0,37,263,16,173,146,212,21300,onalaska,98570,3239,2015
lewis,onalaska high,241,4,1,0,1,1,29,203,3,125,116,109,21300,onalaska,98570,2331,2015
lewis,onalaska middle,145,0,2,0,2,0,13,125,5,79,66,88,21300,onalaska,98570,4335,2015
stevens,onion creek elementary,33,0,0,0,0,0,1,31,1,18,15,30,33030,colville,99114,2049,2015
san juan,oasis k-12,471,1,10,0,10,13,11,415,21,219,252,40,28137,eastsound,98245,1892,2015
san juan,orcas island elementary,220,1,3,1,4,3,38,161,13,127,93,98,28137,eastsound,98245,2749,2015
san juan,orcas island high,135,0,5,1,6,2,14,113,0,69,66,52,28137,eastsound,98245,2750,2015
san juan,orcas island middle,57,1,4,1,5,0,6,42,3,23,34,21,28137,eastsound,98245,4558,2015
san juan,waldron island,6,0,0,0,0,0,0,6,0,4,2,3,28137,waldron island,98297,3808,2015
spokane,orchard prairie elementary,71,0,0,0,0,0,4,67,0,35,36,8,32123,spokane,99217,3723,2015
ferry,orient elem,32,0,1,0,1,0,0,31,0,18,14,24,10065,orient,99160,2136,2015
douglas,orondo elementary and middle,190,0,0,0,0,0,173,17,0,94,96,149,09013,orondo,98843,2666,2015
okanogan,oroville elementary,318,8,5,1,6,1,126,172,5,158,160,222,24410,oroville,98844,2422,2015
okanogan,oroville middle-high,253,6,1,1,2,2,85,155,3,135,118,157,24410,oroville,98844,2706,2015
pierce,orting high,740,3,6,3,9,10,73,602,43,374,366,226,27344,orting,98360,2942,2015
pierce,orting middle,563,3,7,3,10,4,79,424,43,277,286,206,27344,orting,98360,4262,2015
pierce,orting primary,430,5,1,0,1,6,60,319,39,224,206,164,27344,orting,98360,2360,2015
pierce,orting special education,13,1,0,0,0,0,3,9,0,9,4,5,27344,orting,98360,5011,2015
pierce,ptarmigan ridge elementary,684,1,11,2,13,7,100,506,57,339,345,254,27344,orting,98360,4547,2015
adams,desert oasis high,72,0,0,0,0,0,66,6,0,35,37,59,01147,othello,99344,5367,2015
adams,hiawatha elementary,526,0,0,0,0,0,459,66,1,261,265,478,01147,othello,99344,2961,2015
adams,lutacaga elementary,553,0,1,0,1,1,516,34,1,276,277,453,01147,othello,99344,2902,2015
adams,mcfarland middle,875,0,5,0,5,2,765,101,2,463,412,710,01147,othello,99344,3471,2015
adams,othello high,1035,0,1,0,1,1,879,142,12,528,507,725,01147,othello,99344,3015,2015
adams,scootney springs elementary,542,0,1,0,1,0,475,62,4,305,237,449,01147,othello,99344,3730,2015
adams,wahitis elementary,488,0,0,0,0,0,441,46,1,266,222,402,01147,othello,99344,5285,2015
douglas,palisades elementary,29,0,0,0,0,0,20,9,0,14,15,25,09102,palisades,98845,2502,2015
whitman,palouse at garfield middle,36,1,0,0,0,0,5,28,2,19,17,12,38301,palouse,99161,1961,2015
whitman,palouse elementary,84,0,0,0,0,1,9,68,6,40,44,24,38301,palouse,99161,2622,2015
whitman,palouse high,58,0,0,0,0,0,6,49,3,38,20,16,38301,palouse,99161,2634,2015
franklin,chiawana high,2392,4,45,10,55,66,1547,675,45,1267,1125,1510,11001,pasco,99301,5164,2015
franklin,edwin markham elementary,290,0,0,0,0,0,99,182,9,155,135,155,11001,pasco,99301,3425,2015
franklin,emerson elementary,550,0,1,1,2,4,500,42,2,274,276,518,11001,pasco,99301,2967,2015
franklin,james mcgee elementary,770,0,14,3,17,10,364,337,42,401,369,418,11001,pasco,99301,4155,2015
franklin,mark twain elementary,670,0,3,0,3,6,408,227,26,353,317,460,11001,pasco,99301,3085,2015
franklin,maya angelou elementary,854,0,24,4,28,12,386,393,35,436,418,403,11001,pasco,99301,4595,2015
franklin,mcloughlin middle,1790,3,48,3,51,41,834,791,70,932,858,873,11001,pasco,99301,2267,2015
franklin,new horizons high,256,0,0,1,1,6,217,29,3,156,100,244,11001,pasco,99301,3912,2015
franklin,pasco early childhood,45,0,0,0,0,0,33,12,0,26,19,33,11001,pasco,99301,1970,2015
franklin,pasco senior high,1996,4,13,2,15,36,1562,345,34,1025,971,1372,11001,pasco,99301,2917,2015
franklin,robert frost elementary,595,0,1,0,1,4,484,97,9,290,305,552,11001,pasco,99301,3515,2015
franklin,rosalind franklin stem elementary,817,0,16,1,17,6,346,420,28,440,377,379,11001,pasco,99301,5345,2015
franklin,ruth livingston elementary,731,6,13,0,13,37,217,418,40,382,349,272,11001,pasco,99301,4041,2015
franklin,stevens middle,992,0,4,1,5,12,878,81,16,510,482,926,11001,pasco,99301,3324,2015
franklin,virgie robinson elementary,878,0,4,1,5,6,809,53,5,441,437,836,11001,pasco,99301,5020,2015
okanogan,pateros elementary,151,0,0,0,0,0,94,55,2,75,76,107,24122,pateros,98846,2396,2015
okanogan,pateros high,143,0,0,0,0,0,67,65,11,65,78,95,24122,pateros,98846,2397,2015
lewis,pe ell,259,2,1,0,1,1,12,231,12,134,125,152,21301,pe ell,98572,2858,2015
pierce,artondale elementary,416,1,3,1,4,2,36,336,37,209,207,76,27401,gig harbor,98335,3299,2015
pierce,discovery elementary,450,5,4,1,5,5,40,349,46,231,219,106,27401,gig harbor,98335,4080,2015
pierce,evergreen elementary,243,4,0,0,0,3,21,199,16,123,120,143,27401,lakebay,98349,3055,2015
pierce,gig harbor high,1742,8,43,2,45,14,108,1449,118,903,839,198,27401,gig harbor,98335,4081,2015
pierce,goodman middle,544,5,11,3,14,5,53,404,63,282,262,106,27401,gig harbor,98335,2294,2015
pierce,harbor heights elementary,604,1,11,0,11,5,73,458,56,313,291,151,27401,gig harbor,98335,2944,2015
pierce,harbor ridge middle,570,2,13,2,15,1,35,468,49,271,299,122,27401,gig harbor,98332,4387,2015
pierce,henderson bay alt high,140,0,0,0,0,2,12,110,16,70,70,58,27401,gig harbor,98332,1516,2015
pierce,key peninsula middle,376,4,2,1,3,3,23,307,36,208,168,196,27401,lakebay,98349,4156,2015
pierce,kopachuck middle,558,1,14,0,14,4,36,472,31,276,282,73,27401,gig harbor,98335,4219,2015
pierce,minter creek elementary,385,2,3,0,3,2,22,313,43,195,190,133,27401,gig harbor,98329,4189,2015
pierce,peninsula high,1414,5,23,6,29,9,79,1159,133,735,679,368,27401,gig harbor,98332,2681,2015
pierce,purdy elementary,689,2,25,2,27,4,53,545,58,344,345,123,27401,gig harbor,98332,3685,2015
pierce,vaughn elementary,367,1,2,0,2,1,28,306,29,203,164,169,27401,vaughn,98394,3056,2015
pierce,voyager elementary,468,3,8,0,8,7,39,384,27,246,222,77,27401,gig harbor,98335,4307,2015
garfield,pomeroy elementary,156,1,2,0,2,0,9,140,4,82,74,77,12110,pomeroy,99347,3087,2015
garfield,pomeroy jr sr high,161,0,1,0,1,0,9,148,3,80,81,66,12110,pomeroy,99347,2241,2015
clallam,dry creek elementary,365,68,2,0,2,0,23,218,54,186,179,244,05121,port angeles,98363,4494,2015
clallam,franklin elementary,393,14,13,0,13,8,39,279,40,220,173,233,05121,port angeles,98362,2909,2015
clallam,hamilton elementary,342,12,5,1,6,1,39,243,41,170,172,196,05121,port angeles,98363,3079,2015
clallam,jefferson elementary,329,11,6,1,7,2,36,235,38,168,161,217,05121,port angeles,98362,2368,2015
clallam,lincoln high,90,6,1,0,1,0,8,61,14,45,45,70,05121,port angeles,98363,4003,2015
clallam,parents as partners,11,0,1,0,1,0,0,9,1,7,4,10,05121,port angeles,98362,1715,2015
clallam,port angeles high,1150,41,17,0,17,12,78,902,100,583,567,461,05121,port angeles,98362,2908,2015
clallam,roosevelt elementary,505,3,7,0,7,1,26,407,61,265,240,244,05121,port angeles,98362,5115,2015
clallam,special education,34,5,2,0,2,0,0,24,3,24,10,20,05121,port angeles,98362,1897,2015
clallam,stevens middle,571,24,9,2,11,5,43,417,71,291,280,289,05121,port angeles,98363,3318,2015
jefferson,blue heron middle,392,3,9,3,12,6,25,327,19,199,193,218,16050,port townsend,98368,4475,2015
jefferson,ocean,78,1,3,0,3,0,0,71,3,39,39,24,16050,port townsend,98368,1798,2015
jefferson,port townsend high,417,0,8,1,9,3,28,348,29,207,210,148,16050,port townsend,98368,2503,2015
walla walla,prescott elementary,98,0,0,0,0,0,83,15,0,53,45,97,36402,prescott,99348,3574,2015
walla walla,prescott jr sr high,146,2,0,0,0,4,122,18,0,82,64,119,36402,prescott,99348,3575,2015
benton,housel middle,648,0,11,1,12,6,386,235,9,332,316,434,03116,prosser,99350,2906,2015
benton,keene-riverview elementary,518,1,6,0,6,0,334,169,8,262,256,386,03116,prosser,99350,2195,2015
benton,prosser heights elementary,460,2,3,0,3,1,266,179,9,223,237,320,03116,prosser,99350,3316,2015
benton,prosser high,897,3,12,0,12,4,542,321,15,456,441,522,03116,prosser,99350,2508,2015
benton,whitstran elementary,270,0,0,0,0,1,199,66,4,128,142,221,03116,prosser,99350,2905,2015
whitman,franklin elementary,425,3,54,1,55,15,33,293,26,231,194,177,38267,pullman,99163,2587,2015
whitman,jefferson elementary,451,2,42,1,43,22,51,293,40,245,206,138,38267,pullman,99163,3203,2015
whitman,lincoln middle,615,3,58,2,60,15,59,446,32,310,305,188,38267,pullman,99163,3419,2015
whitman,pullman high,733,6,55,0,55,11,75,541,45,366,367,161,38267,pullman,99163,2499,2015
whitman,sunnyside elementary,452,1,46,4,50,7,56,307,31,246,206,167,38267,pullman,99163,3614,2015
pierce,aylen jr high,649,10,18,3,21,17,104,448,49,363,286,251,27003,puyallup,98371,3447,2015
pierce,ballou jr high,736,5,43,11,54,37,97,445,98,378,358,267,27003,puyallup,98373,3750,2015
pierce,brouillet elementary,689,6,30,15,45,26,97,393,122,353,336,213,27003,puyallup,98375,4361,2015
pierce,carson elementary,968,4,73,24,97,63,156,505,143,495,473,345,27003,puyallup,98375,5088,2015
pierce,edgemont jr high,387,1,26,6,32,20,36,257,41,202,185,136,27003,edgewood,98372,2575,2015
pierce,edgerton elementary,789,3,27,10,37,37,111,496,105,406,383,187,27003,puyallup,98374,5093,2015
pierce,emerald ridge high,1585,15,75,23,98,58,200,1044,170,801,784,354,27003,puyallup,98374,4540,2015
pierce,ferrucci jr high,669,8,18,9,27,21,80,449,84,352,317,275,27003,puyallup,98374,4183,2015
pierce,firgrove elementary,545,3,34,11,45,23,192,223,59,304,241,361,27003,puyallup,98373,2496,2015
pierce,fruitland elementary,566,2,29,8,37,14,57,389,67,311,255,152,27003,puyallup,98371,3557,2015
pierce,glacier view junior high,856,7,37,7,44,37,119,543,106,444,412,221,27003,puyallup,98374,5142,2015
pierce,kalles junior high,895,8,55,7,62,23,104,620,78,432,463,264,27003,puyallup,98372,3052,2015
pierce,karshner elementary,335,3,6,7,13,8,136,150,25,177,158,209,27003,puyallup,98371,2870,2015
pierce,maplewood elementary,410,1,12,1,13,4,40,299,53,200,210,131,27003,puyallup,98371,2498,2015
pierce,meeker elementary,423,5,13,0,13,7,54,298,46,229,194,138,27003,puyallup,98371,2334,2015
pierce,mt view elementary,306,2,7,1,8,5,45,216,30,147,159,115,27003,edgewood,98372,3572,2015
pierce,northwood elementary,365,2,32,13,45,18,44,226,30,187,178,138,27003,edgewood,98371,3927,2015
pierce,pope elementary,554,8,9,0,9,15,95,366,61,260,294,202,27003,puyallup,98374,4146,2015
pierce,psd special services,118,1,2,2,4,4,20,73,16,85,33,1,27003,puyallup,98371,3951,2015
pierce,puyallup high,1664,22,82,11,93,35,201,1147,166,875,789,452,27003,puyallup,98371,2125,2015
pierce,puyallup parent partnership program,4,1,0,0,0,0,0,1,2,2,2,1,27003,puyallup,98373,5322,2015
pierce,ridgecrest elementary,517,5,8,1,9,12,69,375,47,277,240,200,27003,puyallup,98374,4121,2015
pierce,rogers high,1759,10,108,30,138,95,258,1069,189,909,850,486,27003,puyallup,98373,3645,2015
pierce,shaw road elementary,597,5,48,3,51,5,65,407,64,312,285,121,27003,puyallup,98372,4414,2015
pierce,spinning elementary,314,3,9,2,11,12,64,184,40,173,141,189,27003,puyallup,98372,2497,2015
pierce,stahl junior high,835,11,40,31,71,46,139,445,123,401,434,309,27003,puyallup,98375,4443,2015
pierce,stewart elementary,326,5,15,3,18,12,68,199,24,160,166,225,27003,puyallup,98372,2311,2015
pierce,sunrise elementary,532,4,15,4,19,21,90,311,87,289,243,277,27003,puyallup,98374,3896,2015
pierce,walker high,132,3,0,1,1,2,17,95,14,68,64,66,27003,puyallup,98372,3972,2015
pierce,waller road elementary,293,4,6,2,8,6,45,197,33,164,129,161,27003,tacoma,98443,2495,2015
pierce,wildwood elementary,484,5,13,9,22,10,116,273,58,262,222,298,27003,puyallup,98374,3558,2015
pierce,woodland elementary,696,5,21,16,37,27,99,444,84,336,360,330,27003,puyallup,98373,2519,2015
pierce,zeiger elementary,824,3,73,6,79,32,130,477,103,429,395,274,27003,puyallup,98373,4496,2015
jefferson,crossroads community,10,0,0,0,0,0,1,9,0,4,6,3,16048,quilcene,98376,5081,2015
jefferson,pearl,119,0,6,0,6,0,4,106,3,60,59,0,16048,quilcene,98376,5236,2015
jefferson,quilcene high and elementary,201,4,2,0,2,0,8,169,18,112,89,97,16048,quilcene,98376,2474,2015
clallam,district run home,14,0,0,0,0,0,1,12,1,8,6,0,05402,forks,98331,1671,2015
clallam,forks alternative,27,3,0,0,0,0,10,9,5,19,8,0,05402,forks,98331,1500,2015
clallam,forks elementary,350,31,1,0,1,1,117,166,34,186,164,0,05402,forks,98331,3737,2015
clallam,forks intermediate,250,18,2,0,2,4,76,130,20,140,110,0,05402,forks,98331,5363,2015
clallam,forks junior-senior high,463,41,6,0,6,2,137,237,40,242,221,0,05402,forks,98331,2349,2015
clallam,insight school of washington,3364,50,57,20,77,192,408,2406,231,1399,1965,0,05402,forks,98331,5071,2015
grant,monument elementary,567,0,0,0,0,1,503,62,1,276,291,479,13144,quincy,98848,4536,2015
grant,mountain view elementary,447,0,0,0,0,1,401,43,2,223,224,380,13144,quincy,98848,3020,2015
grant,pioneer elementary,423,0,1,0,1,0,378,42,2,204,219,362,13144,quincy,98848,2919,2015
grant,quincy high,832,0,1,0,1,0,676,154,1,420,412,586,13144,quincy,98848,3088,2015
grant,quincy junior high,411,0,0,0,0,2,358,50,1,209,202,361,13144,quincy,98848,2510,2015
thurston,rainier elementary,371,5,3,1,4,1,42,294,25,184,187,210,34307,rainier,98576,4486,2015
thurston,rainier middle,187,1,2,0,2,0,12,159,13,87,100,93,34307,rainier,98576,2158,2015
thurston,rainier senior high,272,4,2,0,2,4,20,237,5,151,121,110,34307,rainier,98576,2468,2015
pacific,raymond elementary,276,6,17,2,19,1,76,164,10,139,137,198,25116,raymond,98577,2803,2015
pacific,raymond jr sr high,264,11,14,0,14,2,53,180,4,153,111,148,25116,raymond,98577,2357,2015
lincoln,reardan elementary,295,12,0,0,0,0,10,254,19,153,142,144,22009,reardan,99029,2864,2015
lincoln,reardan middle-senior high,301,19,1,0,1,3,13,250,15,153,148,105,22009,reardan,99029,2478,2015
king,benson hill elementary,542,4,156,6,162,81,85,146,64,296,246,283,17403,renton,98058,3587,2015
king,bryn mawr elementary,426,5,103,2,105,125,80,57,54,206,220,308,17403,seattle,98178,2439,2015
king,campbell hill elementary,510,3,133,13,146,203,91,30,37,272,238,401,17403,seattle,98178,3034,2015
king,cascade elementary,575,4,108,7,115,85,154,141,76,276,299,415,17403,renton,98058,3337,2015
king,dimmitt middle,944,6,274,17,291,267,198,123,59,459,485,670,17403,seattle,98178,3280,2015
king,griffin home,4,1,0,0,0,0,1,1,1,4,0,2,17403,renton,98056,1534,2015
king,hazelwood elementary,574,3,154,0,154,34,56,272,55,288,286,128,17403,newcastle,98056,3485,2015
king,hazen senior high,1548,9,451,5,456,111,312,611,49,824,724,520,17403,renton,98059,3630,2015
king,highlands elementary,540,0,97,4,101,45,260,91,43,277,263,405,17403,renton,98056,2640,2015
king,honey dew elementary,545,1,89,2,91,43,283,97,30,280,265,379,17403,renton,98058,5229,2015
king,kennydale elementary,620,2,180,3,183,35,114,243,43,331,289,211,17403,renton,98056,2597,2015
king,lakeridge elementary,418,2,54,10,64,254,48,25,25,192,226,372,17403,seattle,98178,2929,2015
king,lindbergh senior high,1243,13,309,11,320,228,205,430,47,641,602,587,17403,renton,98058,3741,2015
king,maplewood heights elementary,611,1,183,1,184,20,131,237,38,313,298,222,17403,renton,98059,3586,2015
king,mcknight middle,1205,7,355,10,365,84,279,419,51,631,574,489,17403,renton,98056,3035,2015
king,meadow crest early childhood education center,167,0,43,1,44,23,42,39,19,112,55,108,17403,renton,98056,5313,2015
king,nelsen middle,1026,7,262,14,276,188,191,313,51,533,493,607,17403,renton,98055,3434,2015
king,open door youth reengagement renton,86,1,5,0,5,35,18,18,9,52,34,78,17403,renton,98055,5335,2015
king,out of district facility,24,0,0,0,0,7,6,9,2,16,8,10,17403,renton,98055,1648,2015
king,renton academy,43,1,1,0,1,17,8,14,2,36,7,30,17403,renton,98055,5070,2015
king,renton park elementary,471,1,71,14,85,104,94,136,51,260,211,325,17403,renton,98058,3521,2015
king,renton senior high,1340,12,395,10,405,460,252,156,55,680,660,858,17403,renton,98055,2475,2015
king,sierra heights elementary,652,1,151,2,153,35,183,210,70,343,309,296,17403,renton,98059,3668,2015
king,talbot hill elementary,473,5,134,6,140,79,83,108,58,242,231,247,17403,renton,98055,3740,2015
king,tiffany park elementary,471,0,87,4,91,70,94,169,47,247,224,283,17403,renton,98058,3702,2015
ferry,republic elementary,162,2,4,0,4,0,7,129,20,91,71,126,10309,republic,99166,2789,2015
ferry,republic junior high,43,0,0,0,0,0,1,38,4,19,24,28,10309,republic,99166,3559,2015
ferry,republic parent partner,7,0,0,0,0,0,2,5,0,3,4,7,10309,republic,99166,1898,2015
ferry,republic senior high,97,3,2,0,2,0,7,79,6,46,51,50,10309,republic,99166,3579,2015
benton,badger mountain elementary,737,0,33,0,33,13,140,518,33,375,362,246,03400,richland,99352,4060,2015
benton,carmichael middle,934,5,32,1,33,24,141,698,33,475,459,343,03400,richland,99352,2721,2015
benton,chief joseph middle,725,7,22,4,26,23,137,515,17,365,360,387,03400,richland,99352,2785,2015
benton,enterprise middle,1048,7,47,1,48,16,97,856,24,527,521,205,03400,west richland,99353,3926,2015
benton,hanford high,1719,15,87,0,87,50,208,1316,43,897,822,411,03400,richland,99352,3833,2015
benton,jason lee elementary,584,2,15,1,16,7,112,411,36,294,290,332,03400,richland,99352,2786,2015
benton,jefferson elementary,413,2,5,7,12,20,124,243,12,206,207,285,03400,richland,99352,2642,2015
benton,lewis & clark elementary,555,3,38,1,39,6,143,330,34,269,286,260,03400,richland,99352,2657,2015
benton,marcus whitman elementary,477,1,10,0,10,11,106,328,21,254,223,264,03400,richland,99352,2656,2015
benton,richland high,2045,12,80,6,86,44,261,1616,26,1045,1000,516,03400,richland,99352,3511,2015
benton,rivers edge high,207,2,3,1,4,4,32,158,7,112,95,132,03400,richland,99352,4295,2015
benton,sacajawea elementary,514,0,20,5,25,15,102,344,28,257,257,250,03400,richland,99352,3732,2015
benton,special programs,149,1,2,0,2,2,28,104,12,97,52,37,03400,richland,99352,2001,2015
benton,tapteal elementary,681,4,10,0,10,6,149,468,44,342,339,275,03400,west richland,99353,4059,2015
benton,three rivers home link,475,1,14,0,14,10,42,395,13,251,224,75,03400,richland,99352,5165,2015
benton,white bluffs elementary,780,3,42,1,43,2,51,645,36,394,386,115,03400,richland,99352,5092,2015
clark,ridgefield high,682,1,20,0,20,7,53,568,33,345,337,173,06122,ridgefield,98642,2390,2015
clark,south ridge elementary,561,1,6,1,7,5,93,422,33,296,265,154,06122,ridgefield,98642,3321,2015
clark,union ridge elementary,724,3,5,1,6,2,63,624,26,335,389,238,06122,ridgefield,98642,3786,2015
clark,view ridge middle,365,1,3,1,4,2,37,302,19,184,181,110,06122,ridgefield,98642,3891,2015
adams,lind ritzville middle,70,2,1,1,2,1,4,60,1,33,37,29,01160,lind,99341,5303,2015
adams,ritzville grade,160,1,1,0,1,5,15,137,1,91,69,87,01160,ritzville,99169,2719,2015
adams,ritzville high,134,3,3,0,3,0,7,121,0,72,62,33,01160,ritzville,99169,2132,2015
spokane,chattaroy elementary,248,5,1,1,2,0,13,218,10,138,110,165,32416,chattaroy,99003,2525,2015
spokane,independent scholar,80,0,0,0,0,0,4,76,0,41,39,56,32416,chattaroy,99003,1919,2015
spokane,riverside elementary,338,12,2,1,3,2,14,303,4,191,147,188,32416,chattaroy,99003,4033,2015
spokane,riverside high,472,14,1,1,2,3,14,435,4,238,234,197,32416,chattaroy,99003,4228,2015
spokane,riverside middle,360,15,3,1,4,3,17,317,4,188,172,183,32416,chattaroy,99003,3466,2015
king,carnation elementary,399,2,14,2,16,3,60,297,21,199,200,87,17407,carnation,98014,2485,2015
king,cedarcrest high,968,10,24,3,27,6,105,787,33,449,519,144,17407,duvall,98019,3524,2015
king,cherry valley elementary,502,0,16,0,16,4,65,387,30,257,245,80,17407,duvall,98019,3101,2015
king,choice,9,0,0,0,0,0,2,7,0,5,4,7,17407,carnation,98014,5244,2015
king,clip,31,0,1,0,1,0,5,24,1,19,12,14,17407,carnation,98014,1756,2015
king,eagle rock multiage,77,0,0,0,0,0,4,70,3,34,43,6,17407,duvall,98019,3006,2015
king,parade,105,0,0,0,0,0,9,91,5,49,56,11,17407,carnation,98014,1854,2015
king,stillwater elementary,446,1,7,0,7,2,63,347,26,240,206,71,17407,carnation,98014,4332,2015
king,tolt middle,732,6,19,3,22,1,88,585,30,342,390,125,17407,carnation,98014,4318,2015
thurston,grand mound elementary,502,20,2,0,2,2,104,326,48,261,241,273,34401,rochester,98579,3801,2015
thurston,h.e.a.r.t. high,20,1,0,0,0,1,3,13,2,12,8,15,34401,rochester,98579,1735,2015
thurston,rochester high,649,19,1,0,1,3,118,477,31,341,308,280,34401,rochester,98579,4326,2015
thurston,rochester middle,528,20,2,1,3,5,104,370,26,279,249,258,34401,rochester,98579,3067,2015
thurston,rochester primary,552,20,2,0,2,4,130,359,37,294,258,324,34401,rochester,98579,2527,2015
klickitat,roosevelt elementary,27,0,0,0,0,0,26,1,0,13,14,0,20403,roosevelt,99356,3530,2015
whitman,rosalia elementary & secondary,203,4,3,0,3,3,8,180,5,101,102,127,38320,rosalia,99170,3204,2015
grant,red rock elementary,856,0,1,0,1,0,711,142,2,424,432,652,13160,royal city,99357,3090,2015
grant,royal high,451,0,1,0,1,1,356,93,0,231,220,284,13160,royal city,99357,3516,2015
grant,royal middle,372,0,0,0,0,0,308,64,0,185,187,263,13160,royal city,99357,3620,2015
san juan,friday harbor elementary,371,2,3,0,3,1,74,273,18,174,197,192,28149,friday harbor,98250,2520,2015
san juan,friday harbor high,277,2,9,1,10,3,32,212,18,141,136,98,28149,friday harbor,98250,2879,2015
san juan,friday harbor middle,136,0,1,0,1,1,23,110,1,82,54,53,28149,friday harbor,98250,3011,2015
san juan,griffin bay,15,0,0,0,0,0,1,14,0,5,10,7,28149,friday harbor,98250,1963,2015
grays harbor,satsop elementary,60,0,2,0,2,0,9,47,2,27,33,25,14104,satsop,98583,2010,2015
king,adams elementary,536,2,22,1,23,24,66,367,54,285,251,99,17001,seattle,98107,2138,2015
king,aki kurose middle,728,6,289,10,299,250,105,32,36,385,343,578,17001,seattle,98118,3774,2015
king,alki elementary,411,5,11,0,11,43,31,285,36,223,188,82,17001,seattle,98116,2181,2015
king,arbor heights elementary,354,3,19,2,21,40,40,208,42,190,164,122,17001,seattle,98146,2730,2015
king,b f day elementary,324,0,39,2,41,27,31,187,38,179,145,105,17001,seattle,98103,3717,2015
king,bailey gatzert elementary,347,1,62,0,62,192,62,13,17,190,157,314,17001,seattle,98122,2307,2015
king,ballard high,1671,18,117,6,123,76,173,1199,82,857,814,252,17001,seattle,98117,2220,2015
king,beacon hill international,481,3,138,1,139,36,186,73,44,258,223,283,17001,seattle,98144,2070,2015
king,birth to 3 contracts,366,2,36,1,37,52,53,167,55,241,125,17,17001,seattle,98124,5048,2015
king,broadview-thomson k-8,683,7,74,2,76,156,156,222,66,353,330,399,17001,seattle,98133,2209,2015
king,bryant elementary,588,1,42,1,43,6,35,440,63,264,324,35,17001,seattle,98115,2372,2015
king,cascade parent partnership program,186,1,13,1,14,10,18,112,31,104,82,32,17001,seattle,98119,1751,2015
king,catharine blaine k-8,679,2,34,2,36,15,36,501,89,339,340,52,17001,seattle,98199,2838,2015
king,chief sealth international high,1227,20,218,22,240,258,321,319,69,636,591,737,17001,seattle,98126,3096,2015
king,concord international,410,5,37,4,41,46,258,45,15,217,193,334,17001,seattle,98108,2199,2015
king,daniel bagley elementary,426,0,39,0,39,19,31,290,47,225,201,76,17001,seattle,98103,2450,2015
king,david t. denny international middle,914,9,144,14,158,193,262,245,47,458,456,619,17001,seattle,98126,2839,2015
king,dearborn park international,368,3,171,0,171,112,31,24,27,192,176,300,17001,seattle,98108,3803,2015
king,dunlap elementary,408,2,94,4,98,194,86,11,17,196,212,348,17001,seattle,98118,2321,2015
king,eckstein middle,882,4,99,2,101,47,63,594,73,430,452,142,17001,seattle,98115,2729,2015
king,emerson elementary,277,1,70,2,72,121,33,20,30,149,128,219,17001,seattle,98118,2118,2015
king,fairmount park elementary,378,1,18,0,18,23,31,255,50,201,177,50,17001,seattle,98126,3518,2015
king,franklin high,1350,9,719,3,722,372,127,81,39,731,619,904,17001,seattle,98144,2182,2015
king,frantz coe elementary,502,1,34,2,36,15,62,360,28,253,249,76,17001,seattle,98119,2090,2015
king,garfield high,1620,10,299,2,301,455,132,621,101,767,853,565,17001,seattle,98122,2306,2015
king,gatewood elementary,405,1,13,1,14,59,49,251,31,211,194,137,17001,seattle,98136,2139,2015
king,graham hill elementary,382,2,91,0,91,130,57,67,35,202,180,241,17001,seattle,98118,3378,2015
king,green lake elementary,301,1,13,0,13,8,18,234,27,165,136,47,17001,seattle,98103,2061,2015
king,greenwood elementary,390,2,25,2,27,27,42,260,32,196,194,82,17001,seattle,98117,2123,2015
king,hamilton international middle,937,3,85,0,85,20,57,703,69,524,413,75,17001,seattle,98103,2371,2015
king,hawthorne elementary school - seattle,365,1,69,0,69,121,70,69,35,188,177,257,17001,seattle,98118,4248,2015
king,hazel wolf k-8,713,10,49,5,54,68,86,439,56,351,362,181,17001,seattle,98125,5175,2015
king,highland park elementary,367,11,83,5,88,55,117,49,47,188,179,297,17001,seattle,98106,2269,2015
king,ingraham high,1236,9,206,2,208,113,142,687,77,618,618,331,17001,seattle,98133,3276,2015
king,interagency programs,369,11,29,7,36,166,70,63,23,225,144,409,17001,seattle,98124,1635,2015
king,jane addams middle,728,7,108,3,111,91,82,369,68,371,357,217,17001,seattle,98125,5351,2015
king,john hay elementary,521,0,73,0,73,20,49,315,64,276,245,68,17001,seattle,98109,2063,2015
king,john muir elementary,437,3,65,3,68,195,42,78,51,209,228,281,17001,seattle,98144,2143,2015
king,john rogers elementary,352,0,30,2,32,42,52,184,42,182,170,145,17001,seattle,98125,2975,2015
king,john stanford international,469,4,51,0,51,4,62,267,81,241,228,37,17001,seattle,98105,2081,2015
king,kimball elementary,427,0,164,6,170,96,41,80,40,205,222,242,17001,seattle,98144,3478,2015
king,lafayette elementary,505,2,36,2,38,43,42,328,52,266,239,118,17001,seattle,98116,2733,2015
king,laurelhurst elementary,423,0,48,0,48,16,18,303,38,240,183,81,17001,seattle,98105,2437,2015
king,lawton elementary,420,1,24,1,25,8,29,303,54,202,218,48,17001,seattle,98199,2183,2015
king,leschi elementary,384,2,19,1,20,182,22,113,45,188,196,206,17001,seattle,98122,2121,2015
king,licton springs k-8,116,9,7,2,9,12,14,54,18,60,56,69,17001,seattle,98115,3874,2015
king,loyal heights elementary,450,0,7,0,7,11,21,368,43,223,227,32,17001,seattle,98115,2462,2015
king,madison middle,766,7,89,4,93,85,90,436,55,372,394,241,17001,seattle,98116,2435,2015
king,madrona k-8,300,5,3,0,3,149,27,77,39,152,148,179,17001,lynnwood,98036,3463,2015
king,maple elementary,468,2,236,0,236,47,95,52,36,238,230,321,17001,seattle,98108,2353,2015
king,martin luther king jr. elementary,369,0,123,11,134,145,62,11,17,184,185,306,17001,seattle,98118,2089,2015
king,mcclure middle,537,6,51,1,52,29,56,358,36,269,268,99,17001,seattle,98119,3517,2015
king,mcdonald international,408,0,19,0,19,2,48,277,62,217,191,22,17001,seattle,98105,5203,2015
king,mcgilvra elementary,286,0,31,0,31,28,15,179,33,155,131,30,17001,seattle,98112,2201,2015
king,mercer international middle,1077,4,472,4,476,257,184,99,57,540,537,742,17001,seattle,98108,3095,2015
king,middle college high,197,10,22,3,25,53,28,73,8,98,99,82,17001,seattle,98125,1547,2015
king,montlake elementary,251,1,22,1,23,18,12,168,29,133,118,18,17001,seattle,98112,2322,2015
king,nathan hale high,1166,16,155,4,159,151,134,627,79,609,557,322,17001,seattle,98125,3479,2015
king,north beach elementary,301,1,14,2,16,7,21,212,44,144,157,27,17001,seattle,98117,3218,2015
king,northgate elementary,207,1,15,5,20,46,74,40,26,107,100,157,17001,seattle,98125,3027,2015
king,nova high,341,6,27,0,27,25,26,228,29,148,193,83,17001,seattle,98122,3868,2015
king,olympic hills elementary,298,2,44,7,51,76,76,65,28,151,147,210,17001,seattle,98125,2976,2015
king,olympic view elementary,457,3,61,3,64,56,48,234,52,239,218,174,17001,seattle,98115,2256,2015
king,orca k-8,477,2,30,0,30,100,38,244,63,243,234,134,17001,seattle,98118,4065,2015
king,pathfinder k-8,506,5,32,0,32,26,55,333,55,264,242,115,17001,seattle,98106,1620,2015
king,private school services,132,0,13,1,14,13,19,80,6,86,46,0,17001,seattle,98124,5046,2015
king,queen anne elementary,399,0,25,1,26,8,32,279,54,204,195,31,17001,seattle,98109,5204,2015
king,rainier beach high,600,5,149,16,165,310,78,18,24,296,304,419,17001,seattle,98118,3327,2015
king,rainier view elementary,195,2,53,2,55,68,33,14,23,96,99,135,17001,seattle,98178,3380,2015
king,residential consortium,38,3,1,0,1,11,2,19,2,15,23,0,17001,seattle,98119,4263,2015
king,roosevelt high,1723,12,211,1,212,78,164,1149,108,888,835,225,17001,seattle,98115,2285,2015
king,roxhill elementary,374,4,47,4,51,99,146,47,27,179,195,293,17001,seattle,98126,3157,2015
king,sacajawea elementary,266,0,25,0,25,24,30,161,26,136,130,84,17001,seattle,98115,3028,2015
king,salmon bay k-8,673,4,30,0,30,9,51,520,59,362,311,55,17001,seattle,98117,1796,2015
king,sand point elementary,271,0,49,0,49,45,35,98,44,146,125,122,17001,seattle,98115,5205,2015
king,sanislo elementary,281,4,66,7,73,63,52,49,40,150,131,198,17001,seattle,98106,3665,2015
king,seattle world,251,0,79,0,79,84,76,9,3,149,102,248,17001,seattle,98122,1596,2015
king,south lake high,102,1,11,0,11,43,35,4,8,48,54,116,17001,seattle,98118,3778,2015
king,stevens elementary,365,3,20,0,20,76,34,193,39,190,175,138,17001,seattle,98112,2080,2015
king,the center,276,3,16,0,16,15,23,202,17,115,161,41,17001,seattle,98109,1856,2015
king,thornton creek elementary,402,1,17,0,17,7,26,296,55,207,195,29,17001,seattle,98115,3974,2015
king,thurgood marshall elementary,511,2,91,1,92,97,34,228,58,280,231,141,17001,seattle,98144,2141,2015
king,tops k-8,502,3,102,1,103,84,34,241,37,248,254,156,17001,seattle,98102,1579,2015
king,van asselt elementary,522,4,219,4,223,188,61,17,29,277,245,440,17001,seattle,98108,2120,2015
king,view ridge elementary,584,3,61,1,62,8,38,404,69,266,318,46,17001,seattle,98115,2667,2015
king,viewlands elementary,364,5,33,0,33,38,78,169,41,202,162,196,17001,seattle,98177,2977,2015
king,washington middle,1138,9,215,5,220,339,98,383,89,584,554,519,17001,seattle,98144,4064,2015
king,wedgwood elementary,457,0,74,0,74,8,37,273,65,220,237,36,17001,seattle,98115,3026,2015
king,west seattle elementary,444,4,38,10,48,252,64,62,14,243,201,370,17001,seattle,98126,2645,2015
king,west seattle high,1015,15,151,7,158,139,137,490,76,491,524,326,17001,seattle,98116,2234,2015
king,west woodland elementary,520,0,30,0,30,11,33,398,48,273,247,48,17001,seattle,98107,2142,2015
king,whitman middle,906,12,68,2,70,81,113,551,79,474,432,234,17001,seattle,98117,3277,2015
king,whittier elementary,467,0,28,0,28,12,20,365,42,241,226,46,17001,seattle,98117,2092,2015
king,wing luke elementary,349,2,139,4,143,144,22,8,30,173,176,276,17001,seattle,98118,3581,2015
skagit,big lake elementary,321,1,7,0,7,2,41,255,15,156,165,62,29101,mount vernon,98274,2521,2015
skagit,cascade middle,612,16,9,1,10,6,126,434,20,319,293,340,29101,sedro-woolley,98284,3181,2015
skagit,central elementary,416,5,4,0,4,1,109,284,13,201,215,285,29101,sedro-woolley,98284,2380,2015
skagit,clear lake elementary,248,2,1,0,1,1,26,212,6,118,130,115,29101,clear lake,98235,3403,2015
skagit,evergreen elementary,503,29,4,1,5,2,156,298,13,268,235,318,29101,sedro-woolley,98284,3942,2015
skagit,good beginnings center,49,4,1,0,1,2,8,29,5,35,14,43,29101,sedro-woolley,98273,5058,2015
skagit,lyman elementary,169,3,0,0,0,1,11,147,7,68,101,100,29101,lyman,98263,2620,2015
skagit,mary purcell elementary,406,4,1,0,1,4,126,259,12,206,200,282,29101,sedro-woolley,98284,2774,2015
skagit,samish elementary,182,2,0,0,0,1,19,153,7,90,92,88,29101,sedro-woolley,98284,3402,2015
skagit,sedro woolley senior high,1189,26,9,1,10,4,193,912,44,610,579,483,29101,sedro-woolley,98284,2150,2015
skagit,state street high,270,5,1,9,10,15,51,180,9,152,118,141,29101,sedro-woolley,98284,1537,2015
yakima,selah academy,90,2,0,0,0,2,14,71,1,47,43,31,39119,selah,98942,4272,2015
yakima,selah high,1030,3,3,0,3,5,227,774,18,553,477,376,39119,selah,98942,2388,2015
yakima,selah homelink,25,0,0,0,0,0,3,22,0,11,14,3,39119,selah,98942,5231,2015
pend oreille,selkirk elementary,103,0,0,0,0,0,12,88,3,55,48,48,26070,metaline falls,99153,5075,2015
pend oreille,selkirk high,81,0,1,0,1,1,10,65,4,44,37,29,26070,ione,99139,5226,2015
pend oreille,selkirk middle,64,1,1,0,1,0,3,57,2,29,35,22,26070,ione,99139,5225,2015
clallam,greywolf elementary,530,7,5,2,7,1,40,434,41,261,269,235,05323,sequim,98382,4378,2015
clallam,helen haller elementary,595,5,3,0,3,3,82,462,40,296,299,330,05323,sequim,98382,2722,2015
clallam,sequim community,133,7,0,0,0,1,14,108,3,71,62,65,05323,sequim,98382,1708,2015
clallam,sequim middle,601,21,14,1,15,4,61,455,45,299,302,255,05323,sequim,98382,4519,2015
clallam,sequim senior high,1052,16,21,1,22,6,100,816,92,542,510,328,05323,sequim,98382,2471,2015
san juan,shaw island elementary,14,0,0,0,0,1,0,13,0,7,7,5,28010,shaw island,98286,3725,2015
mason,bordeaux elementary,541,25,1,1,2,3,59,406,46,299,242,363,23309,shelton,98584,3291,2015
mason,evergreen elementary,554,3,3,4,7,0,447,88,9,282,272,507,23309,shelton,98584,2745,2015
mason,mountain view elementary,672,15,1,4,5,2,112,487,51,351,321,462,23309,shelton,98584,3292,2015
mason,oakland bay junior high,676,23,4,3,7,3,140,452,51,369,307,434,23309,shelton,98584,4363,2015
mason,olympic middle,505,17,5,1,6,1,150,303,28,264,241,345,23309,shelton,98584,4586,2015
mason,shelton high,1058,47,7,2,9,8,199,712,83,539,519,543,23309,shelton,98584,3241,2015
king,albert einstein middle,734,1,119,4,123,53,102,372,83,399,335,221,17412,shoreline,98177,3674,2015
king,briarcrest elementary,443,1,60,1,61,56,78,202,45,213,230,190,17412,shoreline,98155,2990,2015
king,brookside elementary,457,2,35,1,36,16,40,290,73,253,204,74,17412,lake forest park,98155,3230,2015
king,cascade k-8 community,198,1,16,0,16,6,28,128,19,103,95,34,17412,shoreline,98155,1942,2015
king,early childhood education,30,0,1,1,2,4,5,19,0,25,5,8,17412,shoreline,98155,5287,2015
king,echo lake elementary,489,2,77,5,82,27,91,224,63,256,233,184,17412,shoreline,98133,3104,2015
king,handicapped contractual services,81,0,5,1,6,5,6,55,9,54,27,22,17412,shoreline,98155,1667,2015
king,highland terrace elementary,501,5,57,1,58,22,40,311,65,247,254,73,17412,shoreline,98133,3231,2015
king,home education exchange,111,1,3,0,3,3,11,91,2,59,52,7,17412,shoreline,98155,1771,2015
king,kellogg middle,618,1,81,2,83,53,68,338,75,296,322,201,17412,shoreline,98155,3387,2015
king,lake forest park elementary,569,4,57,2,59,50,73,323,60,276,293,184,17412,lake forest park,98155,2185,2015
king,melvin g syre elementary,530,3,34,0,34,15,45,375,58,288,242,74,17412,shoreline,98177,3527,2015
king,meridian park elementary,546,3,109,1,110,43,75,253,62,275,271,182,17412,shoreline,98133,3958,2015
king,parkwood elementary,465,4,87,8,95,40,83,200,43,256,209,189,17412,shoreline,98133,3489,2015
king,ridgecrest elementary,552,1,80,3,83,36,70,273,89,298,254,150,17412,shoreline,98155,2703,2015
king,shorecrest high,1296,1,185,4,189,91,146,749,120,693,603,332,17412,shoreline,98155,3343,2015
king,shorewood high,1551,6,269,8,277,112,184,813,159,801,750,397,17412,shoreline,98133,3921,2015
skamania,skamania elementary,77,1,0,0,0,0,3,71,2,35,42,51,30002,skamania,98648,3405,2015
king,skykomish elementary,29,0,0,0,0,0,4,25,0,15,14,19,17404,skykomish,98288,2512,2015
king,skykomish high,17,0,0,0,0,0,3,14,0,7,10,13,17404,skykomish,98288,2513,2015
snohomish,aim high,142,1,1,0,1,2,15,116,7,67,75,67,31201,snohomish,98290,4265,2015
snohomish,cascade view elementary,437,3,10,1,11,2,36,364,21,225,212,117,31201,snohomish,98290,4366,2015
snohomish,cathcart elementary,395,2,8,1,9,8,50,319,7,203,192,80,31201,snohomish,98296,3305,2015
snohomish,centennial middle,770,9,13,2,15,7,76,632,31,392,378,224,31201,snohomish,98290,4395,2015
snohomish,central elementary,267,4,2,1,3,1,62,184,13,148,119,137,31201,snohomish,98290,2446,2015
snohomish,dutch hill elementary,542,3,6,1,7,0,39,458,35,283,259,105,31201,snohomish,98290,4241,2015
snohomish,emerson elementary,341,1,3,1,4,2,65,245,24,153,188,151,31201,snohomish,98290,3005,2015
snohomish,glacier peak high,1757,13,112,3,115,32,141,1351,105,879,878,188,31201,snohomish,98296,5128,2015
snohomish,high school re entry,8,0,0,0,0,0,1,7,0,5,3,17,31201,snohomish,98290,3981,2015
snohomish,little cedars elementary,766,4,80,2,82,19,57,542,62,407,359,82,31201,snohomish,98290,5100,2015
snohomish,machias elementary,460,3,7,1,8,1,32,388,28,267,193,150,31201,snohomish,98290,2073,2015
snohomish,riverview elementary,502,2,8,0,8,2,71,399,20,254,248,160,31201,snohomish,98290,3561,2015
snohomish,seattle hill elementary,631,3,46,2,48,9,76,436,59,302,329,142,31201,everett,98208,4184,2015
snohomish,snohomish center,29,1,1,0,1,0,1,26,0,18,11,13,31201,snohomish,98290,1730,2015
snohomish,snohomish high,1802,12,20,0,20,14,163,1500,93,921,881,364,31201,snohomish,98290,2428,2015
snohomish,totem falls,433,4,28,1,29,4,27,359,10,231,202,30,31201,snohomish,98296,4383,2015
snohomish,valley view middle,739,3,40,2,42,10,68,573,43,395,344,101,31201,snohomish,98296,4145,2015
king,cascade view elementary,700,0,42,1,43,3,27,592,35,356,344,33,17410,snoqualmie,98065,5015,2015
king,chief kanim middle,728,3,44,2,46,3,42,605,29,393,335,73,17410,fall city,98024,4397,2015
king,edwin r opstad elementary,637,6,9,0,9,9,62,513,38,341,296,133,17410,north bend,98045,4308,2015
king,fall city elementary,622,1,47,1,48,3,36,499,35,317,305,58,17410,fall city,98024,2222,2015
king,mount si high,1767,10,61,5,66,21,78,1552,40,916,851,200,17410,snoqualmie,98065,2850,2015
king,north bend elementary,555,1,38,1,39,1,60,430,24,271,284,84,17410,north bend,98045,2287,2015
king,snoqualmie access,53,1,3,0,3,2,6,34,7,31,22,18,17410,snoqualmie,98065,5181,2015
king,snoqualmie elementary,698,6,58,0,58,7,53,538,36,382,316,93,17410,snoqualmie,98065,2288,2015
king,snoqualmie parent partnership program,37,0,0,0,0,0,4,32,1,18,19,1,17410,north bend,98045,5296,2015
king,twin falls middle,743,4,19,2,21,6,53,637,22,400,343,99,17410,north bend,98045,5135,2015
king,two rivers,120,3,1,0,1,0,11,101,4,61,59,36,17410,north bend,98045,1502,2015
grant,smokiam alternative high,35,0,0,0,0,0,8,27,0,21,14,32,13156,soap lake,98851,1518,2015
grant,soap lake elementary,191,0,1,1,2,0,60,127,2,93,98,182,13156,soap lake,98851,2694,2015
grant,soap lake middle & high,218,1,0,0,0,4,63,150,0,120,98,152,13156,soap lake,98851,3089,2015
pacific,chauncey davis elementary,326,5,15,1,16,0,139,133,33,183,143,225,25118,south bend,98586,2804,2015
pacific,south bend high,211,10,5,2,7,1,80,81,32,106,105,122,25118,south bend,98586,2214,2015
kitsap,burley glenwood elementary,435,5,2,3,5,6,33,353,33,218,217,223,18402,port orchard,98367,4029,2015
kitsap,discovery,217,3,2,1,3,2,27,159,23,124,93,126,18402,port orchard,98366,3899,2015
kitsap,east port orchard elementary,523,4,15,21,36,9,60,347,67,280,243,293,18402,port orchard,98366,2641,2015
kitsap,explorer academy,174,2,0,0,0,2,10,144,15,85,89,48,18402,port orchard,98366,1718,2015
kitsap,hidden creek elementary,554,6,21,7,28,1,75,378,66,290,264,204,18402,port orchard,98367,4348,2015
kitsap,madrona heights preschool program,49,0,0,0,0,1,3,42,3,39,10,31,18402,port orchard,98366,5072,2015
kitsap,manchester elementary,375,4,4,2,6,5,47,269,44,202,173,175,18402,port orchard,98366,4079,2015
kitsap,mullenix ridge elementary,543,2,11,1,12,5,55,410,59,282,261,157,18402,port orchard,98367,4350,2015
kitsap,olalla elementary,318,7,0,2,2,3,30,244,32,171,147,129,18402,port orchard,98359,2995,2015
kitsap,orchard heights elementary,568,5,6,10,16,16,71,380,80,301,267,358,18402,port orchard,98366,2650,2015
kitsap,sidney glen elementary,673,6,25,16,41,11,84,440,91,335,338,394,18402,port orchard,98366,4349,2015
kitsap,south colby elementary,401,4,5,3,8,2,30,324,33,197,204,97,18402,port orchard,98366,3110,2015
kitsap,south kitsap high,2024,20,75,33,108,39,189,1429,239,1095,929,610,18402,port orchard,98366,2272,2015
kitsap,sunnyslope elementary,573,4,33,6,39,8,67,387,68,283,290,210,18402,port orchard,98367,4141,2015
island,south whidbey academy,109,2,2,0,2,1,8,95,1,55,54,61,15206,langley,98260,1682,2015
island,south whidbey elementary,528,1,12,4,16,5,48,434,24,264,264,195,15206,langley,98260,4321,2015
island,south whidbey high,516,7,16,0,16,5,17,463,8,261,255,120,15206,langley,98260,4149,2015
island,south whidbey special services,11,1,0,0,0,0,0,10,0,10,1,1,15206,langley,98260,1683,2015
mason,southside elementary,193,3,4,0,4,2,22,137,25,92,101,71,23042,shelton,98584,2744,2015
spokane,adams elementary,326,4,9,0,9,11,41,199,62,143,183,226,32081,spokane,99223,2156,2015
spokane,alternative northeast community center preschool,18,0,1,0,1,0,3,12,2,14,4,20,32081,spokane,99207,1566,2015
spokane,arlington elementary,597,9,19,11,30,11,94,385,68,291,306,438,32081,spokane,99217,2381,2015
spokane,audubon elementary,463,11,4,2,6,18,49,320,59,234,229,377,32081,spokane,99205,2128,2015
spokane,balboa elementary,350,3,4,2,6,6,36,263,36,187,163,180,32081,spokane,99208,3357,2015
spokane,bemiss elementary,541,20,6,38,44,15,88,301,73,268,273,491,32081,spokane,99207,2155,2015
spokane,browne elementary,416,3,0,0,0,5,41,313,54,221,195,279,32081,spokane,99205,2218,2015
spokane,bryant center,621,3,13,1,14,8,66,475,55,320,301,214,32081,spokane,99201,3008,2015
spokane,chase middle,757,11,30,4,34,22,74,542,74,412,345,376,32081,spokane,99223,4457,2015
spokane,cooper elementary,542,12,30,19,49,20,56,328,77,274,268,431,32081,spokane,99217,2129,2015
spokane,daybreak alternative,6,0,0,0,0,0,0,6,0,5,1,0,32081,spokane,99202,1603,2015
spokane,eagle peak at pratt,66,2,0,1,1,2,9,36,16,57,9,90,32081,spokane valley,99212,1567,2015
spokane,ferris high,1795,0,73,11,84,51,159,1336,165,953,842,668,32081,spokane,99223,3412,2015
spokane,finch elementary,522,2,3,0,3,8,39,410,60,288,234,283,32081,spokane,99205,2312,2015
spokane,franklin elementary,402,2,16,0,16,6,46,271,61,204,198,183,32081,spokane,99223,2127,2015
spokane,garfield elementary,518,17,15,17,32,17,64,309,79,273,245,388,32081,spokane,99205,3727,2015
spokane,garry middle,607,18,18,15,33,24,77,354,101,300,307,498,32081,spokane,99207,3758,2015
spokane,glover middle,658,18,9,3,12,22,62,460,84,337,321,453,32081,spokane,99205,3258,2015
spokane,grant elementary,336,6,15,5,20,38,25,154,93,185,151,264,32081,spokane,99202,3729,2015
spokane,hamblen elementary,539,6,7,1,8,6,52,400,67,272,267,234,32081,spokane,99203,3007,2015
spokane,holmes elementary,410,11,5,3,8,9,56,264,62,223,187,351,32081,spokane,99201,2056,2015
spokane,hutton elementary,516,0,9,0,9,9,30,421,47,238,278,118,32081,spokane,99203,2258,2015
spokane,indian trail elementary,314,2,3,0,3,1,30,251,27,143,171,144,32081,spokane,99208,3506,2015
spokane,jefferson elementary,484,2,5,0,5,11,47,361,58,256,228,185,32081,spokane,99203,2111,2015
spokane,lewis & clark high,1896,17,75,31,106,73,136,1358,206,919,977,626,32081,spokane,99204,2172,2015
spokane,libby center,312,1,23,1,24,3,14,248,22,170,142,56,32081,spokane,99202,2401,2015
spokane,lidgerwood elementary,378,4,9,11,20,13,57,202,82,189,189,336,32081,spokane,99208,2952,2015
spokane,lincoln heights elementary,534,4,15,0,15,9,58,391,57,276,258,322,32081,spokane,99223,2951,2015
spokane,linwood elementary,437,3,0,9,9,10,53,284,78,199,238,313,32081,spokane,99208,3190,2015
spokane,logan elementary,485,16,7,21,28,31,70,247,93,262,223,436,32081,spokane,99207,3719,2015
spokane,longfellow elementary,566,14,7,8,15,11,67,364,95,288,278,462,32081,spokane,99207,3718,2015
spokane,madison elementary,359,3,6,2,8,5,29,273,41,180,179,273,32081,spokane,99205,2708,2015
spokane,moran prairie elementary,533,0,16,0,16,7,24,450,36,292,241,109,32081,spokane,99223,4389,2015
spokane,mullan road elementary,594,1,12,0,12,14,37,485,45,316,278,152,32081,spokane,99223,4035,2015
spokane,north central high,1279,31,25,28,53,39,121,883,152,644,635,627,32081,spokane,99205,2106,2015
spokane,on track academy,276,9,2,0,2,6,32,184,43,149,127,260,32081,spokane,99207,5250,2015
spokane,open doors youth re-engagement spokane,118,3,0,2,2,6,16,77,14,64,54,78,32081,spokane,99201,5344,2015
spokane,regal elementary,485,16,7,8,15,12,59,314,69,265,220,431,32081,spokane,99207,2096,2015
spokane,ridgeview elementary,357,4,5,1,6,3,44,245,55,180,177,231,32081,spokane,99205,2950,2015
spokane,rogers high,1582,49,60,58,118,68,181,960,206,842,740,1120,32081,spokane,99207,2479,2015
spokane,roosevelt elementary,523,6,17,7,24,29,63,334,67,258,265,336,32081,spokane,99204,2086,2015
spokane,sacajawea middle,783,10,19,5,24,25,55,588,81,395,388,291,32081,spokane,99203,3356,2015
spokane,salk middle,749,9,6,3,9,11,55,593,72,404,345,364,32081,spokane,99208,3413,2015
spokane,sccp images,56,2,3,0,3,4,2,42,3,39,17,25,32081,spokane,99217,1698,2015
spokane,shadle park high,1441,21,18,10,28,14,94,1131,153,708,733,640,32081,spokane,99205,3189,2015
spokane,shaw middle,601,14,35,26,61,28,71,346,81,311,290,517,32081,spokane,99207,3257,2015
spokane,sheridan elementary,471,15,30,1,31,12,83,268,62,264,207,409,32081,spokane,99202,2110,2015
spokane,spokane public montessori,356,6,7,1,8,3,23,265,51,187,169,113,32081,spokane,99205,5361,2015
spokane,spokane regional health district,163,5,2,3,5,1,5,141,6,103,60,0,32081,spokane,99201,5113,2015
spokane,stevens elementary,548,10,17,42,59,26,57,297,99,272,276,464,32081,spokane,99202,2108,2015
spokane,the community,100,1,0,0,0,1,9,73,16,40,60,60,32081,spokane,99205,5301,2015
spokane,westview elementary,455,1,3,5,8,1,51,323,71,235,220,311,32081,spokane,99205,3063,2015
spokane,whitman elementary,572,8,3,20,23,24,62,364,91,312,260,509,32081,spokane,99207,2191,2015
spokane,willard elementary,555,16,3,4,7,25,63,351,93,280,275,452,32081,spokane,99205,2109,2015
spokane,wilson elementary,384,2,4,0,4,5,22,308,43,178,206,72,32081,spokane,99203,2296,2015
spokane,woodridge elementary,453,4,13,3,16,3,41,349,40,232,221,116,32081,spokane,99208,4192,2015
lincoln,sprague elementary,40,2,0,0,0,2,1,35,0,18,22,31,22008,sprague,99032,3050,2015
lincoln,sprague high,29,1,0,0,0,0,2,26,0,17,12,14,22008,sprague,99032,2186,2015
whitman,st john elementary,74,0,0,0,0,1,9,59,5,41,33,31,38322,saint john,99171,3069,2015
whitman,st john/endicott high,76,0,5,1,6,0,1,68,1,40,36,21,38322,saint john,99171,3068,2015
snohomish,cedarhome elementary,527,3,5,0,5,5,43,443,28,279,248,113,31401,stanwood,98292,4513,2015
snohomish,elger bay elementary,299,1,3,1,4,3,26,249,16,161,138,110,31401,camano island,98282,4553,2015
snohomish,lincoln academy,15,1,0,0,0,0,1,13,0,12,3,8,31401,stanwood,98292,5108,2015
snohomish,lincoln hill high,129,0,0,2,2,1,17,104,5,69,60,53,31401,stanwood,98292,1707,2015
snohomish,port susan middle,524,6,9,0,9,5,42,438,24,258,266,163,31401,stanwood,98292,4512,2015
snohomish,saratoga,116,0,3,1,4,2,6,101,3,54,62,9,31401,stanwood,98292,5004,2015
snohomish,stanwood elementary,395,1,7,0,7,3,33,333,18,202,193,149,31401,stanwood,98292,3125,2015
snohomish,stanwood high,1420,10,23,5,28,15,103,1203,61,740,680,252,31401,stanwood,98292,2581,2015
snohomish,stanwood middle,510,9,5,0,5,4,50,414,28,248,262,127,31401,stanwood,98292,2400,2015
snohomish,twin city elementary,329,3,12,0,12,0,57,246,11,178,151,123,31401,stanwood,98292,4364,2015
snohomish,utsalady elementary,280,3,4,0,4,5,18,244,6,151,129,77,31401,camano island,98282,4551,2015
franklin,star elem,5,0,0,0,0,0,1,4,0,1,4,0,11054,richland,99352,2007,2015
columbia,starbuck,25,0,0,0,0,0,1,24,0,9,16,0,07035,starbuck,99359,2135,2015
chelan,stehekin elementary,5,0,0,0,0,0,0,5,0,1,4,0,04069,stehekin,98852,2265,2015
pierce,anderson island elementary,38,0,0,0,0,0,7,29,2,13,25,22,27001,steilacoom,98388,2040,2015
pierce,cherrydale elementary,319,2,9,7,16,13,49,183,56,151,168,117,27001,steilacoom,98388,3446,2015
pierce,chloe clark elementary,567,1,50,6,56,48,83,293,86,293,274,65,27001,dupont,98327,4562,2015
pierce,pioneer middle,743,5,67,22,89,46,98,389,116,396,347,169,27001,dupont,98327,2237,2015
pierce,saltars point elementary,433,4,34,13,47,29,66,235,52,208,225,93,27001,steilacoom,98388,3827,2015
pierce,steilacoom high,908,3,94,17,111,74,137,457,126,462,446,186,27001,steilacoom,98388,4131,2015
whitman,steptoe elementary,35,2,0,0,0,0,0,33,0,18,17,12,38304,steptoe,99174,2115,2015
skamania,carson elementary,256,3,0,0,0,6,42,192,13,137,119,147,30303,stevenson,98648,2882,2015
skamania,preschool,20,0,0,0,0,0,3,17,0,13,7,15,30303,stevenson,98648,1765,2015
skamania,stevenson elementary,216,6,1,1,2,4,28,167,9,115,101,111,30303,stevenson,98648,2682,2015
skamania,stevenson high,302,7,3,1,4,6,45,231,9,162,140,148,30303,stevenson,98648,3119,2015
skamania,wind river middle,142,0,1,0,1,0,23,109,9,77,65,66,30303,stevenson,98648,3800,2015
snohomish,gold bar elementary,299,4,0,0,0,1,64,224,2,168,131,216,31311,gold bar,98251,4399,2015
snohomish,open doors youth reengagement sultan,10,1,0,0,0,1,1,6,1,6,4,4,31311,sultan,98296,5329,2015
snohomish,student services,24,0,0,0,0,0,3,21,0,17,7,14,31311,sultan,98294,1670,2015
snohomish,sultan elementary,540,5,11,1,12,5,100,396,21,280,260,303,31311,sultan,98294,2229,2015
snohomish,sultan middle,428,12,7,0,7,1,67,333,5,215,213,231,31311,sultan,98294,2105,2015
snohomish,sultan senior high,557,10,8,1,9,6,85,434,10,301,256,229,31311,sultan,98294,4274,2015
stevens,summit valley,75,0,0,0,0,0,3,67,5,36,39,51,33202,addy,99101,4394,2015
yakima,chief kamiakin elementary,785,0,0,0,0,0,718,57,10,421,364,706,39201,sunnyside,98944,4000,2015
yakima,harrison middle,782,0,1,0,1,2,722,52,5,402,380,645,39201,sunnyside,98944,3313,2015
yakima,outlook elementary,589,0,0,0,0,1,560,25,3,307,282,540,39201,sunnyside,98944,2469,2015
yakima,pioneer elementary,730,0,0,0,0,1,677,43,9,371,359,645,39201,sunnyside,98944,4497,2015
yakima,sierra vista middle,694,0,0,0,0,0,648,40,6,344,350,553,39201,sunnyside,98944,5049,2015
yakima,sun valley elementary,558,2,1,0,1,1,504,49,1,294,264,487,39201,sunnyside,98944,5137,2015
yakima,sunnyside high,1860,0,0,0,0,3,1680,162,13,984,876,1289,39201,sunnyside,98944,2959,2015
yakima,washington elementary,670,1,0,0,0,0,620,44,5,351,319,564,39201,sunnyside,98944,2717,2015
pierce,angelo giaudrone middle,641,10,74,10,84,180,116,230,21,318,323,503,27010,tacoma,98408,4575,2015
pierce,arlington,266,1,15,19,34,64,61,84,22,138,128,233,27010,tacoma,98409,2940,2015
pierce,baker,697,8,135,37,172,118,187,178,34,347,350,558,27010,tacoma,98408,3054,2015
pierce,birney,443,1,28,18,46,101,137,126,32,239,204,366,27010,tacoma,98408,3449,2015
pierce,blix elementary,494,8,59,16,75,92,162,136,21,255,239,440,27010,tacoma,98404,2094,2015
pierce,boze,376,5,75,16,91,71,125,68,16,188,188,330,27010,tacoma,98404,3646,2015
pierce,browns point,460,2,47,4,51,31,41,296,39,249,211,88,27010,tacoma,98422,2872,2015
pierce,bryant,429,6,16,2,18,73,35,251,46,231,198,221,27010,tacoma,98405,3397,2015
pierce,comm based trans program,53,1,5,1,6,11,5,28,2,28,25,39,27010,tacoma,98405,1585,2015
pierce,crescent heights,498,3,44,18,62,38,68,292,35,255,243,197,27010,tacoma,98422,4537,2015
pierce,day reporting,18,1,0,0,0,8,4,5,0,8,10,24,27010,tacoma,98406,1797,2015
pierce,delong,547,9,42,9,51,157,86,231,13,270,277,385,27010,tacoma,98405,2939,2015
pierce,downing,276,3,15,1,16,42,31,162,22,136,140,141,27010,tacoma,98406,2747,2015
pierce,edison,510,2,43,13,56,100,148,156,48,271,239,437,27010,tacoma,98409,2871,2015
pierce,fawcett,460,6,59,13,72,52,101,187,42,242,218,332,27010,tacoma,98404,2772,2015
pierce,fern hill,362,0,40,22,62,36,113,113,38,172,190,261,27010,tacoma,98444,2167,2015
pierce,first creek middle,786,17,154,36,190,182,229,138,30,412,374,708,27010,tacoma,98404,5170,2015
pierce,foss,889,11,114,22,136,228,152,291,71,452,437,578,27010,tacoma,98405,3880,2015
pierce,franklin,287,5,10,7,17,65,59,89,52,149,138,229,27010,tacoma,98405,2148,2015
pierce,fresh start,193,7,14,0,14,49,31,81,11,79,114,56,27010,tacoma,98405,5307,2015
pierce,geiger,415,3,25,5,30,36,69,229,48,201,214,187,27010,tacoma,98465,2746,2015
pierce,grant,345,5,6,3,9,40,35,239,17,167,178,135,27010,tacoma,98406,3053,2015
pierce,gray,619,5,71,33,104,150,139,199,22,320,299,493,27010,tacoma,98409,2377,2015
pierce,helen b. stafford elementary,520,2,137,31,168,51,141,92,66,269,251,419,27010,tacoma,98444,5066,2015
pierce,jason lee,597,13,25,15,40,199,60,267,18,282,315,413,27010,tacoma,98403,2338,2015
pierce,jefferson,309,2,9,1,10,56,46,171,24,148,161,193,27010,tacoma,98406,2103,2015
pierce,larchmont,421,5,64,14,78,84,94,132,28,215,206,364,27010,tacoma,98445,2036,2015
pierce,lincoln,1410,19,188,55,243,388,330,348,82,773,637,1057,27010,tacoma,98418,2215,2015
pierce,lister,535,5,78,29,107,149,99,126,49,270,265,475,27010,tacoma,98404,2771,2015
pierce,lowell,440,2,17,4,21,34,38,318,27,220,220,75,27010,tacoma,98403,2805,2015
pierce,lyon,342,4,39,11,50,54,108,104,22,188,154,288,27010,tacoma,98404,2336,2015
pierce,manitou park,620,8,38,26,64,164,172,130,82,314,306,530,27010,tacoma,98409,2252,2015
pierce,mann,492,10,37,22,59,93,96,173,61,267,225,359,27010,tacoma,98408,2941,2015
pierce,mason,829,8,40,10,50,92,66,594,19,440,389,287,27010,tacoma,98407,2376,2015
pierce,meeker,657,10,86,7,93,73,64,387,30,316,341,220,27010,tacoma,98422,3244,2015
pierce,mt tahoma,1532,22,259,57,316,314,351,467,62,796,736,1086,27010,tacoma,98409,3398,2015
pierce,northeast tacoma,383,5,36,11,47,44,83,157,47,220,163,218,27010,tacoma,98422,2247,2015
pierce,oakland high,235,4,12,11,23,75,40,83,10,109,126,194,27010,tacoma,98409,4109,2015
pierce,pearl street center,11,0,1,2,3,0,1,7,0,5,6,7,27010,tacoma,98465,4283,2015
pierce,point defiance,428,7,27,3,30,47,46,288,10,209,219,211,27010,tacoma,98407,2169,2015
pierce,reed,468,2,34,18,52,105,163,96,50,233,235,384,27010,tacoma,98418,2806,2015
pierce,roosevelt,264,8,16,11,27,56,77,64,32,135,129,240,27010,tacoma,98404,2275,2015
pierce,science and math institute,459,4,37,6,43,47,37,325,3,264,195,166,27010,tacoma,98407,5169,2015
pierce,sheridan,607,4,78,20,98,126,244,91,44,300,307,528,27010,tacoma,98404,2168,2015
pierce,sherman,408,4,7,0,7,25,34,314,24,209,199,128,27010,tacoma,98407,2938,2015
pierce,skyline,388,1,15,3,18,58,50,223,38,192,196,235,27010,tacoma,98406,3498,2015
pierce,special services,67,2,1,0,1,15,2,44,3,50,17,38,27010,tacoma,98405,5192,2015
pierce,stadium,1680,26,179,17,196,246,188,967,57,831,849,546,27010,tacoma,98403,2084,2015
pierce,stanley,291,5,6,12,18,110,45,83,30,147,144,249,27010,tacoma,98405,2358,2015
pierce,stewart,407,12,33,9,42,109,72,165,7,215,192,333,27010,tacoma,98465,2359,2015
pierce,tacoma school of the arts,522,7,36,3,39,77,69,327,3,158,364,179,27010,tacoma,98402,1860,2015
pierce,truman,761,8,85,10,95,124,85,440,9,370,391,444,27010,tacoma,98407,3448,2015
pierce,whitman,427,6,60,20,80,91,72,143,35,213,214,356,27010,tacoma,98408,2874,2015
pierce,whittier,498,0,24,3,27,85,59,267,60,237,261,235,27010,tacoma,98466,3452,2015
pierce,wilson,1269,15,92,10,102,238,110,758,46,667,602,519,27010,tacoma,98406,3246,2015
grays harbor,taholah elementary & middle,135,97,0,0,0,0,19,0,19,73,62,98,14077,taholah,98587,5032,2015
grays harbor,taholah high,53,35,0,0,0,0,5,2,11,32,21,51,14077,taholah,98587,3580,2015
king,glacier park elementary,973,1,38,8,46,13,86,719,108,503,470,84,17409,maple valley,98038,4453,2015
king,lake wilderness elementary,1109,3,49,11,60,14,101,808,123,591,518,178,17409,maple valley,98038,3286,2015
king,rock creek elementary,945,1,27,5,32,13,81,747,71,487,458,144,17409,maple valley,98038,4415,2015
king,shadow lake elementary,612,5,24,6,30,6,84,436,51,324,288,142,17409,maple valley,98038,3589,2015
king,tahoma senior high,1820,15,71,8,79,43,155,1404,124,944,876,197,17409,maple valley,98038,2849,2015
whitman,tekoa elementary,118,9,0,0,0,1,12,95,1,56,62,60,38265,tekoa,99033,2052,2015
whitman,tekoa high,89,10,0,0,0,0,4,75,0,48,41,41,38265,tekoa,99033,3418,2015
thurston,parkside elementary,299,0,1,0,1,1,29,247,21,169,130,160,34402,tenino,98589,2457,2015
thurston,tenino elementary,300,3,2,1,3,3,17,260,14,173,127,147,34402,tenino,98589,4238,2015
thurston,tenino high,358,3,2,1,3,7,27,316,2,184,174,146,34402,tenino,98589,3509,2015
thurston,tenino middle,264,4,1,2,3,3,12,240,2,136,128,118,34402,tenino,98589,3795,2015
kittitas,thorp elem & jr sr high,96,0,0,0,0,1,8,86,1,48,48,62,19400,thorp,98946,2514,2015
lewis,cowlitz prairie academy,38,0,1,0,1,2,2,31,2,18,20,23,21237,toledo,98591,5190,2015
lewis,toledo elementary,282,5,3,0,3,1,27,238,8,142,140,174,21237,toledo,98591,2998,2015
lewis,toledo high,257,5,1,0,1,2,31,201,17,136,121,106,21237,toledo,98591,2616,2015
lewis,toledo middle,158,2,1,1,2,1,11,128,14,76,82,88,21237,toledo,98591,3977,2015
okanogan,tonasket elementary,538,3,0,0,0,1,236,279,19,268,270,391,24404,tonasket,98855,3176,2015
okanogan,tonasket high,311,2,1,0,1,4,97,200,7,178,133,167,24404,tonasket,98855,2679,2015
okanogan,tonasket middle,244,1,2,0,2,0,91,142,8,140,104,166,24404,tonasket,98855,4196,2015
yakima,garfield elementary,402,43,1,0,1,0,346,6,6,190,212,375,39202,toppenish,98948,2608,2015
yakima,kirkwood elementary,695,172,1,0,1,2,486,16,18,351,344,624,39202,toppenish,98948,4106,2015
yakima,lincoln elementary,402,42,0,0,0,1,343,9,7,198,204,366,39202,toppenish,98948,2635,2015
yakima,nw allprep,400,2,18,1,19,10,37,329,3,196,204,118,39202,vancouver,98684,5262,2015
yakima,toppenish high,898,88,2,0,2,1,778,26,3,432,466,719,39202,toppenish,98948,2900,2015
yakima,toppenish middle,855,121,0,0,0,0,715,14,5,458,397,741,39202,toppenish,98948,2264,2015
yakima,toppenish pre,51,6,0,0,0,1,41,3,0,30,21,52,39202,toppenish,98948,1831,2015
yakima,valley view elementary,378,7,1,0,1,0,364,6,0,202,176,358,39202,toppenish,98948,4588,2015
walla walla,touchet elem & high,237,4,0,0,0,0,103,123,7,129,108,137,36300,touchet,99360,2160,2015
cowlitz,toutle lake elementary,317,5,2,0,2,2,23,275,10,169,148,133,08130,toutle,98649,4264,2015
cowlitz,toutle lake high,301,8,5,0,5,3,22,257,6,155,146,121,08130,toutle,98649,2560,2015
klickitat,trout lake elementary,86,3,0,0,0,0,8,70,5,44,42,0,20400,trout lake,98650,3062,2015
klickitat,trout lake,134,3,4,0,4,0,23,95,9,66,68,0,20400,trout lake,98650,2676,2015
king,cascade view elementary,500,1,147,18,165,81,170,57,26,253,247,440,17406,tukwila,98168,3226,2015
king,foster senior high,918,9,271,38,309,201,228,130,41,465,453,629,17406,tukwila,98168,2848,2015
king,showalter middle,687,6,212,19,231,150,174,89,37,358,329,540,17406,tukwila,98168,2564,2015
king,thorndyke elementary,417,6,65,18,83,130,118,49,31,227,190,348,17406,tukwila,98168,3635,2015
king,tukwila elementary,548,2,120,12,132,105,149,86,74,262,286,407,17406,tukwila,98168,3488,2015
thurston,a g west black hills high,874,4,35,4,39,24,73,654,80,433,441,215,34033,tumwater,98512,4500,2015
thurston,black lake elementary,496,1,16,1,17,1,45,382,50,245,251,150,34033,olympia,98512,4205,2015
thurston,east olympia elementary,495,3,8,0,8,3,51,400,30,259,236,143,34033,olympia,98501,4365,2015
thurston,george washington bush middle,536,3,7,5,12,7,71,404,39,273,263,168,34033,tumwater,98512,4452,2015
thurston,littlerock elementary,334,3,4,1,5,3,24,266,33,178,156,124,34033,olympia,98512,2816,2015
thurston,michael t simmons elementary,680,7,19,2,21,22,77,480,73,389,291,279,34033,tumwater,98512,2552,2015
thurston,new market high,71,2,1,1,2,5,5,50,7,41,30,24,34033,tumwater,98501,5014,2015
thurston,peter g schmidt elementary,559,2,7,6,13,15,68,399,62,277,282,245,34033,tumwater,98501,3199,2015
thurston,secondary options,100,1,0,0,0,2,9,83,5,49,51,44,34033,olympia,98512,1713,2015
thurston,tumwater high,1174,12,16,5,21,16,112,923,90,595,579,252,34033,tumwater,98501,3362,2015
thurston,tumwater hill elementary,458,2,38,5,43,4,60,293,56,224,234,136,34033,tumwater,98512,4373,2015
thurston,tumwater middle,455,4,14,1,15,12,39,342,43,231,224,130,34033,tumwater,98512,3612,2015
yakima,union gap,630,13,5,0,5,0,484,118,10,315,315,547,39002,union gap,98903,2714,2015
pierce,chambers elementary,422,2,28,6,34,49,61,222,54,219,203,194,27083,university pla,98467,3792,2015
pierce,curtis junior high,1003,7,94,13,107,92,117,521,159,517,486,374,27083,university place,98466,3179,2015
pierce,curtis senior high,1445,11,178,12,190,145,146,774,179,695,750,447,27083,university place,98466,3600,2015
pierce,drum intermediate,603,0,48,4,52,49,90,308,104,282,321,227,27083,university pla,98467,4325,2015
pierce,evergreen primary,495,0,39,6,45,42,75,223,110,253,242,219,27083,university place,98466,4447,2015
pierce,narrows view intermediate,682,4,73,4,77,57,82,351,111,369,313,279,27083,university pla,98466,3296,2015
pierce,sunset primary,429,2,27,7,34,42,60,220,71,249,180,170,27083,university place,98466,3601,2015
pierce,university place primary,527,6,19,3,22,48,81,260,110,260,267,251,27083,university pla,98466,2223,2015
stevens,columbia virtual academy,460,5,15,3,18,11,38,353,35,234,226,5,33070,valley,99181,1932,2015
stevens,paideia high,29,0,0,0,0,0,2,24,3,17,12,22,33070,valley,99181,5223,2015
stevens,valley early learning center,5,0,0,0,0,0,0,5,0,2,3,0,33070,valley,99181,5357,2015
stevens,valley,193,6,0,2,2,2,10,154,19,111,82,157,33070,valley,99181,2405,2015
clark,alki middle,734,2,38,5,43,12,70,562,45,390,344,181,06037,vancouver,98685,4406,2015
clark,benjamin franklin elementary,391,1,36,0,36,5,67,228,54,200,191,106,06037,vancouver,98663,3080,2015
clark,chinook elementary,724,2,31,4,35,2,71,562,52,357,367,160,06037,vancouver,98685,4405,2015
clark,columbia river high,1267,11,51,6,57,26,131,977,65,637,630,268,06037,vancouver,98665,3423,2015
clark,discovery middle,693,4,10,17,27,34,236,346,46,359,334,494,06037,vancouver,98663,4503,2015
clark,dwight d eisenhower elementary,568,4,25,7,32,9,89,386,48,277,291,265,06037,vancouver,98665,3733,2015
clark,early childhood education center,180,0,5,0,5,5,40,116,14,122,58,145,06037,vancouver,98668,2636,2015
clark,felida elementary,647,2,19,3,22,10,45,524,44,307,340,82,06037,vancouver,98685,4075,2015
clark,fir grove childrens center,67,3,0,0,0,2,10,49,3,62,5,46,06037,vancouver,98661,1574,2015
clark,fort vancouver high,1499,15,56,71,127,65,501,718,73,750,749,989,06037,vancouver,98661,2179,2015
clark,fruit valley elementary,244,3,2,12,14,11,91,108,17,113,131,210,06037,vancouver,98680,2637,2015
clark,gaiser middle,876,2,30,17,47,48,216,498,65,433,443,518,06037,vancouver,98665,3902,2015
clark,gate program,30,1,4,0,4,1,4,19,1,18,12,15,06037,vancouver,98661,1738,2015
clark,george c marshall elementary,405,4,12,28,40,7,111,211,32,213,192,273,06037,vancouver,98661,3424,2015
clark,harney elementary,644,2,4,16,20,12,265,306,39,303,341,414,06037,vancouver,98661,2643,2015
clark,harry s truman elementary,569,1,22,13,35,17,113,345,58,287,282,326,06037,vancouver,98661,3735,2015
clark,hazel dell elementary,471,3,19,0,19,14,143,252,40,248,223,339,06037,vancouver,98665,2690,2015
clark,hough elementary,294,1,4,2,6,6,66,189,26,139,155,164,06037,vancouver,98660,2610,2015
clark,hudson's bay high,1376,14,29,33,62,57,380,795,68,729,647,769,06037,vancouver,98663,3081,2015
clark,jason lee middle,563,3,23,2,25,13,111,379,32,297,266,278,06037,vancouver,98665,3543,2015
clark,jefferson middle,768,4,23,4,27,15,80,583,59,398,370,242,06037,vancouver,98685,4591,2015
clark,lake shore elementary,414,3,16,1,17,5,43,321,25,224,190,120,06037,vancouver,98665,3017,2015
clark,lewis and clark high,108,0,2,1,3,5,20,71,9,53,55,53,06037,vancouver,98661,3932,2015
clark,lincoln elementary,383,5,5,5,10,8,86,240,34,194,189,254,06037,vancouver,98660,2318,2015
clark,martin luther king elementary,505,3,10,25,35,26,254,143,44,246,259,437,06037,vancouver,98661,3734,2015
clark,mcloughlin middle,913,5,33,57,90,33,417,326,42,470,443,732,06037,vancouver,98661,3146,2015
clark,minnehaha elementary,544,0,23,6,29,11,111,365,28,296,248,341,06037,vancouver,98663,2723,2015
clark,open doors vancouver,45,1,0,0,0,2,10,25,7,26,19,36,06037,vancouver,98668,5342,2015
clark,peter s ogden elementary,559,5,24,13,37,17,234,220,46,292,267,454,06037,vancouver,98662,2644,2015
clark,roosevelt elementary,695,0,24,38,62,11,324,265,33,346,349,587,06037,vancouver,98661,4410,2015
clark,sacajawea elementary,403,0,4,1,5,9,85,273,31,208,195,222,06037,vancouver,98685,4034,2015
clark,salmon creek elementary,530,1,22,3,25,10,49,400,45,286,244,170,06037,vancouver,98685,2964,2015
clark,sarah j anderson elementary,793,2,18,9,27,17,309,390,48,404,389,478,06037,vancouver,98686,3016,2015
clark,skyview high,2034,8,105,20,125,55,232,1491,123,1101,933,526,06037,vancouver,98685,4504,2015
clark,vancouver contracted programs,23,0,0,0,0,3,2,17,1,14,9,0,06037,vancouver,98668,5258,2015
clark,vancouver home connection,272,0,1,0,1,2,19,233,17,141,131,113,06037,vancouver,98668,3556,2015
clark,vancouver itech preparatory,339,3,11,6,17,9,40,249,21,231,108,93,06037,vancouver,98668,5271,2015
clark,vancouver school of arts and academics,590,5,13,3,16,11,59,460,39,172,418,121,06037,vancouver,98663,1689,2015
clark,vancouver virtual learning academy,155,3,1,1,2,5,23,115,7,72,83,228,06037,vancouver,98668,5149,2015
clark,walnut grove elementary,772,6,29,13,42,33,168,471,52,377,395,497,06037,vancouver,98661,2828,2015
clark,washington elementary,374,1,5,7,12,13,159,152,37,191,183,325,06037,vancouver,98663,3565,2015
king,chautauqua elementary,540,0,4,0,4,2,74,407,53,299,241,140,17402,vashon,98070,4468,2015
king,family link,51,0,5,0,5,0,2,34,10,31,20,21,17402,vashon,98070,1822,2015
king,mcmurray middle,379,2,11,0,11,5,41,303,17,200,179,84,17402,vashon,98070,3667,2015
king,student link,24,0,1,0,1,0,5,17,1,12,12,4,17402,vashon,98070,1938,2015
king,vashon island high,577,7,25,0,25,4,48,446,47,288,289,107,17402,vashon,98070,2419,2015
wahkiakum,julius a wendt elementary/john c thomas middle,305,3,0,2,2,1,19,268,12,157,148,204,35200,cathlamet,98612,2893,2015
wahkiakum,wahkiakum high,141,0,2,0,2,2,14,121,2,64,77,65,35200,cathlamet,98612,3467,2015
grant,developmental pre-school,18,0,0,0,0,0,18,0,0,16,2,23,13073,mattawa,99349,1981,2015
grant,mattawa elementary,464,7,0,0,0,0,447,9,1,229,235,321,13073,mattawa,99349,3152,2015
grant,mattawa elementary pre-school,3,0,0,0,0,0,3,0,0,3,0,1,13073,mattawa,99349,5120,2015
grant,morris schott elementary,306,0,0,0,0,0,302,4,0,161,145,215,13073,mattawa,99349,4222,2015
grant,saddle mountain elementary,482,0,0,0,0,0,461,21,0,262,220,328,13073,mattawa,99349,4490,2015
grant,sentinel tech alt,27,0,0,0,0,0,25,2,0,16,11,7,13073,mattawa,99349,1835,2015
grant,wahluke high,555,6,0,0,0,0,516,30,3,266,289,300,13073,mattawa,99349,4254,2015
grant,wahluke junior high,470,1,0,0,0,0,451,17,1,214,256,329,13073,mattawa,99349,5144,2015
walla walla,preston hall middle,67,0,1,0,1,0,6,59,1,41,26,39,36401,waitsburg,99361,2174,2015
walla walla,waitsburg elementary,125,1,1,0,1,0,15,104,4,67,58,77,36401,waitsburg,99361,2712,2015
walla walla,waitsburg high,104,0,0,0,0,0,10,87,7,56,48,34,36401,waitsburg,99361,2386,2015
walla walla,alternative education program,114,0,2,0,2,1,32,76,3,69,45,26,36140,walla walla,99362,2407,2015
walla walla,berney elementary,436,0,7,1,8,2,86,314,26,231,205,206,36140,walla walla,99362,2074,2015
walla walla,blue ridge elementary,382,0,2,1,3,3,285,80,11,197,185,353,36140,walla walla,99362,4193,2015
walla walla,edison elementary school - walla walla,464,0,6,0,6,3,263,182,10,241,223,333,36140,walla walla,99362,2528,2015
walla walla,garrison middle,603,2,5,0,5,6,256,313,21,297,306,343,36140,walla walla,99362,3510,2015
walla walla,green park elementary,440,1,4,0,4,4,184,229,18,208,232,298,36140,walla walla,99362,2078,2015
walla walla,head start/eceap preschool,14,0,0,0,0,0,7,5,2,6,8,22,36140,walla walla,99362,5187,2015
walla walla,lincoln high,177,0,0,0,0,2,35,136,4,91,86,154,36140,walla walla,99362,4071,2015
walla walla,pioneer middle,662,5,13,0,13,10,240,370,24,328,334,398,36140,walla walla,99362,2780,2015
walla walla,prospect point elementary,451,2,7,1,8,2,80,341,18,229,222,154,36140,walla walla,99362,2159,2015
walla walla,sharpstein elementary,461,1,3,0,3,3,208,232,14,233,228,266,36140,walla walla,99362,3728,2015
walla walla,walla walla high,1871,8,31,1,32,18,610,1161,42,913,958,822,36140,walla walla,99362,3468,2015
yakima,adams elementary,309,67,6,0,6,0,227,6,3,172,137,314,39207,wapato,98951,4518,2015
yakima,camas elementary,668,157,13,1,14,0,466,11,20,348,320,629,39207,wapato,98951,5544,2015
yakima,pace alternative high,76,30,1,0,1,0,36,3,6,41,35,54,39207,wapato,98951,4022,2015
yakima,satus elementary,695,130,3,0,3,0,524,14,24,375,320,647,39207,wapato,98951,2757,2015
yakima,wapato high,795,117,13,1,14,1,610,33,20,375,420,634,39207,wapato,98951,3141,2015
yakima,wapato middle,794,201,11,1,12,0,526,34,21,408,386,716,39207,wapato,98951,2131,2015
grant,warden elementary,472,0,0,0,0,0,388,80,4,210,262,339,13146,warden,98857,2792,2015
grant,warden high,323,0,3,0,3,2,259,54,5,169,154,164,13146,warden,98857,3273,2015
grant,warden middle,206,0,1,0,1,0,156,45,4,108,98,117,13146,warden,98857,3909,2015
adams,washtucna elementary/high,47,0,0,0,0,0,5,41,1,28,19,24,01109,washtucna,99371,3075,2015
douglas,waterville elementary,89,4,1,0,1,1,8,72,3,39,50,68,09209,waterville,98858,2161,2015
douglas,waterville high,177,3,1,0,1,0,51,116,6,93,84,95,09209,waterville,98858,2162,2015
stevens,wellpinit elementary,197,156,0,0,0,1,8,3,29,112,85,166,33049,wellpinit,99040,2549,2015
stevens,wellpinit high,84,63,0,0,0,0,10,5,6,42,42,45,33049,wellpinit,99040,2550,2015
stevens,wellpinit middle,75,52,0,0,0,0,9,4,10,42,33,56,33049,wellpinit,99040,4232,2015
chelan,abraham lincoln elementary,514,1,0,0,0,3,374,133,3,238,276,426,04246,wenatchee,98801,3209,2015
chelan,columbia elementary,461,1,1,1,2,2,324,124,8,242,219,403,04246,wenatchee,98801,2301,2015
chelan,foothills middle,608,1,12,0,12,4,227,340,24,301,307,324,04246,wenatchee,98801,4432,2015
chelan,john newbery elementary,512,2,8,0,8,2,201,279,20,254,258,305,04246,wenatchee,98801,4423,2015
chelan,lewis and clark elementary,481,2,3,0,3,1,347,120,8,257,224,391,04246,wenatchee,98801,2279,2015
chelan,mission view elementary,542,0,2,0,2,2,406,129,3,306,236,451,04246,wenatchee,98801,2347,2015
chelan,orchard middle,416,3,1,0,1,2,260,141,9,220,196,306,04246,wenatchee,98801,3370,2015
chelan,pioneer middle,705,5,2,0,2,2,336,337,23,362,343,456,04246,wenatchee,98801,3210,2015
chelan,skill source,1,0,0,0,0,0,1,0,0,1,0,4,04246,wenatchee,98801,1612,2015
chelan,sunnyslope elementary,303,0,7,1,8,0,57,228,10,159,144,94,04246,wenatchee,98801,3208,2015
chelan,valley academy of learning,188,0,2,0,2,3,8,166,9,98,90,32,04246,wenatchee,98801,1742,2015
chelan,washington elementary,615,1,8,0,8,2,176,403,25,335,280,289,04246,wenatchee,98801,2907,2015
chelan,wenatchee high,2182,4,21,4,25,10,976,1124,43,1086,1096,1153,04246,wenatchee,98801,2134,2015
chelan,westside high,242,6,1,1,2,0,104,126,4,133,109,175,04246,wenatchee,98801,1613,2015
spokane,centennial middle,650,2,13,0,13,14,51,522,48,343,307,351,32363,spokane,99212,3538,2015
spokane,dishman hills high,318,7,0,3,3,6,26,264,12,161,157,237,32363,spokane,99206,1628,2015
spokane,ness elementary,367,2,3,2,5,8,33,296,23,215,152,254,32363,spokane,99206,3196,2015
spokane,orchard center elementary,319,5,2,0,2,10,23,252,27,163,156,224,32363,spokane,99212,3129,2015
spokane,pasadena park elementary,383,1,10,1,11,4,20,337,10,202,181,144,32363,spokane,99212,3194,2015
spokane,seth woodard elementary,365,2,4,2,6,2,38,290,27,195,170,209,32363,spokane,99212,2956,2015
spokane,spokane valley high,107,0,0,0,0,0,8,91,8,53,54,47,32363,spokane,99212,1838,2015
spokane,spokane valley transition,186,3,0,0,0,2,10,153,18,98,88,139,32363,spokane,99212,1842,2015
spokane,west valley city,225,1,0,0,0,3,8,198,15,95,130,71,32363,spokane,99212,1755,2015
spokane,west valley high,904,13,21,2,23,16,64,716,72,451,453,345,32363,spokane,99212,3195,2015
yakima,ahtanum valley elementary,253,6,0,0,0,0,88,147,12,129,124,142,39208,yakima,98908,2822,2015
yakima,apple valley elementary,336,2,11,0,11,5,92,221,5,167,169,116,39208,yakima,98908,3699,2015
yakima,children's village,22,2,0,0,0,0,4,15,1,13,9,0,39208,yakima,98902,5096,2015
yakima,cottonwood elementary,420,3,16,1,17,5,87,300,8,212,208,142,39208,yakima,98908,4448,2015
yakima,mountainview elementary,196,1,0,0,0,2,53,125,15,104,92,112,39208,yakima,98908,2758,2015
yakima,summitview elementary,301,0,4,0,4,1,129,152,15,149,152,178,39208,yakima,98908,3207,2015
yakima,west valley high,1039,9,25,2,27,8,189,784,22,541,498,306,39208,yakima,98908,3074,2015
yakima,west valley high school freshman campus,388,4,13,1,14,2,87,269,12,203,185,151,39208,yakima,98908,5221,2015
yakima,west valley jr high,843,6,15,1,16,12,248,538,23,450,393,374,39208,yakima,98908,4040,2015
yakima,west valley middle,813,11,19,0,19,9,223,532,19,405,408,371,39208,yakima,98908,4506,2015
yakima,west valley preschool,42,1,0,0,0,1,12,27,1,29,13,5,39208,yakima,98903,5008,2015
yakima,wide hollow elementary,369,2,23,2,25,1,137,193,11,189,180,230,39208,yakima,98908,2505,2015
lewis,white pass elementary,202,2,0,0,0,1,13,184,2,106,96,138,21303,randle,98377,3555,2015
lewis,white pass jr. sr. high,227,3,3,0,3,2,5,210,4,113,114,138,21303,randle,98377,2859,2015
pierce,elk ridge elementary,336,1,1,0,1,2,20,294,18,182,154,118,27416,buckley,98321,2190,2015
pierce,foothills elementary,515,3,2,2,4,8,71,413,16,255,260,222,27416,buckley,98321,4309,2015
pierce,glacier middle,801,12,9,1,10,4,77,660,38,444,357,266,27416,buckley,98321,3458,2015
pierce,mountain meadow elementary,514,4,6,1,7,3,55,410,35,273,241,151,27416,buckley,98321,4471,2015
pierce,white river high,1218,15,9,5,14,4,92,1013,80,625,593,296,27416,buckley,98321,4569,2015
pierce,white river reengagement program,9,0,0,0,0,0,0,8,1,5,4,6,27416,buckley,98321,5338,2015
pierce,white river special ed services,8,0,0,0,0,0,0,8,0,5,3,2,27416,buckley,98321,5045,2015
pierce,wilkeson elementary,233,2,2,0,2,1,14,197,17,122,111,72,27416,wilkeson,98396,4170,2015
pacific,willapa elementary,171,0,2,0,2,0,24,137,8,78,93,85,25160,menlo,98561,3444,2015
pacific,willapa valley middle-high,165,5,0,0,0,0,25,124,11,84,81,82,25160,menlo,98561,2542,2015
grant,wilson creek elementary,77,1,0,0,0,0,13,62,1,39,38,42,13167,wilson creek,98860,2472,2015
grant,wilson creek high,76,1,2,0,2,1,10,62,0,35,41,37,13167,wilson creek,98860,2473,2015
lewis,winlock middle,141,2,0,0,0,1,39,97,2,86,55,131,21232,winlock,98596,4369,2015
lewis,winlock miller elementary,301,0,1,0,1,1,83,195,21,169,132,272,21232,winlock,98596,2290,2015
lewis,winlock senior high,182,2,3,0,3,2,37,131,7,99,83,133,21232,winlock,98596,3597,2015
grays harbor,wishkah valley elementary/high,148,2,0,0,0,2,2,142,0,70,78,66,14117,aberdeen,98520,3375,2015
klickitat,wishram high and elementary,86,12,0,0,0,0,18,48,8,58,28,81,20094,wishram,98673,2605,2015
cowlitz,lewis river academy,60,0,0,0,0,0,10,50,0,28,32,22,08404,woodland,98674,5246,2015
cowlitz,team high,78,0,0,0,0,1,11,61,5,38,40,44,08404,woodland,98674,1795,2015
cowlitz,woodland high,650,7,2,0,2,6,84,521,30,337,313,225,08404,woodland,98674,3546,2015
cowlitz,yale elementary,47,0,0,0,0,0,0,44,3,30,17,19,08404,ariel,98603,3513,2015
yakima,davis high,2097,10,12,0,12,32,1741,236,66,1045,1052,1566,39007,yakima,98902,2116,2015
yakima,discovery lab,203,3,2,0,2,2,92,92,12,108,95,102,39007,yakima,98902,3023,2015
yakima,early childhood center,124,0,0,0,0,1,83,40,0,72,52,94,39007,yakima,98902,5019,2015
yakima,eisenhower high,2030,22,26,3,29,20,1298,592,69,1009,1021,1280,39007,yakima,98908,3206,2015
yakima,franklin middle,869,8,3,0,3,6,646,175,31,442,427,713,39007,yakima,98902,2410,2015
yakima,gilbert elementary,560,11,3,0,3,2,355,169,20,270,290,405,39007,yakima,98908,2818,2015
yakima,hoover elementary,730,7,3,3,6,6,602,99,10,398,332,703,39007,yakima,98902,2715,2015
yakima,lewis & clark middle,839,8,5,2,7,8,695,105,16,418,421,742,39007,yakima,98902,3615,2015
yakima,martin luther king jr elementary,604,3,0,0,0,2,553,42,4,310,294,559,39007,yakima,98903,3817,2015
yakima,mcclure elementary school yakima,608,0,4,1,5,2,430,158,13,300,308,524,39007,yakima,98902,2899,2015
yakima,mckinley elementary,443,1,1,0,1,2,346,75,18,222,221,380,39007,yakima,98902,2177,2015
yakima,nob hill elementary,507,2,2,0,2,3,242,241,17,254,253,336,39007,yakima,98902,2819,2015
yakima,ridgeview elementary,646,3,0,0,0,5,501,124,13,316,330,569,39007,yakima,98903,2433,2015
yakima,robertson elementary,519,9,1,0,1,1,377,119,12,250,269,471,39007,yakima,98902,3264,2015
yakima,roosevelt elementary,545,11,2,0,2,9,423,85,15,286,259,471,39007,yakima,98902,2529,2015
yakima,washington middle,761,3,0,0,0,5,719,26,8,373,388,686,39007,yakima,98901,2314,2015
yakima,whitney elementary yakima,548,5,5,0,5,8,349,161,20,265,283,411,39007,yakima,98908,3312,2015
yakima,wilson middle,825,2,8,0,8,8,561,212,34,419,406,656,39007,yakima,98908,3368,2015
yakima,yakima online,121,1,1,0,1,1,56,56,6,47,74,74,39007,yakima,98902,5153,2015
yakima,yakima open doors,8,1,0,0,0,0,6,0,1,2,6,35,39007,yakima,98901,5355,2015
yakima,yakima satellite alternative programs,100,2,2,0,2,1,56,36,3,39,61,83,39007,yakima,98902,5224,2015
thurston,fort stevens elementary,564,3,12,2,14,7,76,386,78,307,257,325,34002,yelm,98597,4346,2015
thurston,lackamas elementary,323,1,4,2,6,2,46,236,32,176,147,151,34002,yelm,98597,5018,2015
thurston,mckenna elementary,475,2,3,1,4,0,60,372,37,228,247,228,34002,yelm,98597,2260,2015
thurston,mill pond elementary,522,6,7,4,11,11,69,367,58,289,233,243,34002,yelm,98597,4451,2015
thurston,ridgeline middle,598,4,9,5,14,6,73,453,48,295,303,241,34002,yelm,98597,5052,2015
thurston,southworth elementary,565,27,13,7,20,16,111,319,72,317,248,238,34002,yelm,98597,3848,2015
thurston,yelm extension,124,2,0,0,0,2,14,95,11,60,64,70,34002,yelm,98597,1627,2015
thurston,yelm high school 12,1291,14,19,9,28,22,143,995,89,677,614,441,34002,yelm,98597,2633,2015
thurston,yelm middle,652,6,13,6,19,19,80,461,67,308,344,315,34002,yelm,98597,2481,2015
thurston,yelm prairie elementary,525,8,3,0,3,0,74,398,42,284,241,228,34002,yelm,98597,4224,2015
yakima,hilton elementary,386,14,2,0,2,1,213,141,15,208,178,239,39205,zillah,98953,2783,2015
yakima,zillah high,443,17,2,1,3,2,194,218,9,219,224,200,39205,zillah,98953,2240,2015
yakima,zillah intermediate,319,14,1,0,1,0,165,132,7,188,131,189,39205,zillah,98953,4221,2015
yakima,zillah middle,195,9,1,0,1,0,90,89,6,115,80,116,39205,zillah,98953,4481,2015
grays harbor,a j west elementary,395,13,8,0,8,3,168,187,16,203,192,284,14005,aberdeen,98520,2834,2016
grays harbor,central park elementary,158,2,3,0,3,2,28,109,14,79,79,73,14005,aberdeen,98520,3216,2016
grays harbor,harbor high,113,6,1,1,2,4,26,67,8,62,51,91,14005,aberdeen,98520,3857,2016
grays harbor,hopkins elementary,36,0,0,0,0,1,8,22,5,18,18,55,14005,aberdeen,98520,3154,2016
grays harbor,j m weatherwax high,916,35,31,6,37,8,254,546,36,475,441,477,14005,aberdeen,98520,3476,2016
grays harbor,mcdermoth elementary,366,5,4,0,4,3,112,213,29,180,186,238,14005,aberdeen,98520,2449,2016
grays harbor,miller junior high,457,31,14,2,16,6,118,268,18,218,239,316,14005,aberdeen,98520,2305,2016
grays harbor,robert gray elementary,332,10,1,1,2,2,121,173,24,154,178,233,14005,aberdeen,98520,2763,2016
grays harbor,stevens elementary,477,24,16,0,16,9,167,229,32,254,223,340,14005,aberdeen,98520,2971,2016
lewis,adna elementary,251,3,2,0,2,2,20,221,3,141,110,79,21226,adna,98522,2227,2016
lewis,adna middle/high,381,1,2,0,2,0,21,344,13,200,181,100,21226,adna,98522,2441,2016
lincoln,almira elementary,109,0,0,0,0,0,9,96,4,53,56,38,22017,almira,99103,2860,2016
skagit,anacortes high,796,9,31,0,31,11,77,657,11,411,385,166,29103,anacortes,98221,2467,2016
skagit,anacortes middle,452,3,22,1,23,11,37,365,13,235,217,128,29103,anacortes,98221,2707,2016
skagit,cap sante high,60,2,1,0,1,0,7,48,2,31,29,37,29103,anacortes,98221,5176,2016
skagit,fidalgo elementary,443,2,14,3,17,3,53,356,12,232,211,124,29103,anacortes,98221,3182,2016
skagit,island view elementary,456,2,11,0,11,4,54,377,8,229,227,150,29103,anacortes,98221,3252,2016
skagit,mount erie elementary,480,4,15,1,16,6,48,391,15,239,241,139,29103,anacortes,98221,3057,2016
skagit,whitney elementary anacortes,124,0,3,0,3,0,15,102,4,68,56,24,29103,anacortes,98221,3404,2016
snohomish,arlington high,1665,26,32,14,46,23,185,1340,45,873,792,384,31016,arlington,98223,2523,2016
snohomish,arlington special educ,34,0,0,0,0,0,4,30,0,20,14,20,31016,arlington,98223,2277,2016
snohomish,eagle creek elementary,581,6,4,0,4,1,129,410,31,301,280,266,31016,arlington,98223,4327,2016
snohomish,haller middle,667,10,17,5,22,9,88,506,32,341,326,199,31016,arlington,98223,5010,2016
snohomish,kent prairie elementary,632,4,8,1,9,3,66,489,61,333,299,238,31016,arlington,98223,4436,2016
snohomish,pioneer elementary,583,1,7,2,9,8,69,439,57,279,304,171,31016,arlington,98223,4573,2016
snohomish,post middle,595,7,12,2,14,7,69,477,21,317,278,222,31016,arlington,98223,3124,2016
snohomish,presidents elementary,542,7,5,0,5,0,66,412,52,299,243,195,31016,arlington,98223,4154,2016
snohomish,weston high,117,1,1,0,1,2,20,91,2,67,50,53,31016,arlington,98223,4287,2016
asotin,asotin elementary,276,1,3,0,3,1,11,246,14,135,141,101,02420,asotin,99402,2507,2016
asotin,asotin jr sr high,377,3,2,0,2,0,28,324,20,185,192,101,02420,asotin,99402,2434,2016
king,alpac elementary,580,1,55,18,73,14,166,266,60,288,292,346,17408,pacific,98047,3825,2016
king,arthur jacobsen elementary,650,0,89,3,92,54,135,310,59,307,343,292,17408,auburn,98092,5082,2016
king,auburn mountainview high,1487,8,140,16,156,136,239,844,104,738,749,521,17408,auburn,98092,5037,2016
king,auburn riverside high,1594,11,166,34,200,86,404,785,108,780,814,517,17408,auburn,98092,4474,2016
king,auburn senior high,1640,47,105,64,169,123,463,690,148,874,766,890,17408,auburn,98002,2795,2016
king,cascade middle,751,4,55,37,92,78,177,344,56,381,370,457,17408,auburn,98002,2394,2016
king,chinook elementary,471,60,18,20,38,19,193,99,62,255,216,327,17408,auburn,98092,3439,2016
king,dick scobee elementary,546,0,27,32,59,44,171,201,71,285,261,406,17408,auburn,98002,2932,2016
king,evergreen heights elementary,496,0,79,17,96,47,103,186,64,243,253,233,17408,auburn,98001,3745,2016
king,gildo rey elementary,591,2,26,36,62,26,315,131,55,307,284,484,17408,auburn,98002,3669,2016
king,hazelwood elementary,558,9,45,18,63,5,152,292,37,289,269,256,17408,auburn,98092,4347,2016
king,ilalko elementary,595,6,52,19,71,24,182,230,82,288,307,327,17408,auburn,98092,4417,2016
king,lake view elementary,388,2,8,3,11,3,52,283,37,211,177,175,17408,auburn,98092,4120,2016
king,lakeland hills elementary,678,5,73,2,75,30,130,357,81,342,336,146,17408,auburn,98092,5051,2016
king,lea hill elementary,419,2,32,13,45,85,61,162,64,229,190,268,17408,auburn,98092,3525,2016
king,mt baker middle,949,4,83,35,118,53,298,400,76,492,457,469,17408,auburn,98002,4462,2016
king,olympic middle,742,36,42,39,81,53,256,248,68,392,350,525,17408,auburn,98002,3169,2016
king,pioneer elementary,492,1,15,33,48,11,314,87,31,250,242,436,17408,auburn,98002,3227,2016
king,rainier middle,903,2,90,13,103,88,177,478,55,471,432,396,17408,auburn,98092,4385,2016
king,special ed,121,4,3,2,5,6,36,54,16,79,42,46,17408,auburn,98002,1915,2016
king,terminal park elementary,443,1,26,34,60,45,102,173,62,230,213,323,17408,auburn,98002,2659,2016
king,washington elementary,489,2,17,35,52,45,164,148,78,227,262,378,17408,auburn,98002,2326,2016
king,west auburn senior high,242,5,7,14,21,17,61,105,33,111,131,140,17408,auburn,98001,2702,2016
kitsap,bainbridge high,1259,7,51,2,53,9,75,1011,104,614,645,79,18303,bainbridge island,98110,2395,2016
kitsap,bainbridge special education services,38,1,3,0,3,0,2,31,1,28,10,1,18303,bainbridge island,98110,1939,2016
kitsap,capt johnston blakely elem,352,5,7,0,7,1,14,299,26,190,162,20,18303,bainbridge island,98110,3552,2016
kitsap,capt. charles wilkes elem,392,0,9,0,9,0,23,325,35,216,176,25,18303,bainbridge island,98110,3043,2016
kitsap,eagle harbor high,132,0,5,0,5,1,9,110,7,76,56,6,18303,bainbridge island,98110,1935,2016
kitsap,mosaic home education partnership,63,0,3,0,3,0,5,46,9,34,29,8,18303,bainbridge island,98110,1841,2016
kitsap,odyssey multiage program,122,0,4,2,6,2,3,106,5,64,58,5,18303,bainbridge island,98110,1699,2016
kitsap,ordway elementary,401,2,14,0,14,5,38,300,42,200,201,45,18303,bainbridge island,98110,4062,2016
kitsap,sakai intermediate,584,4,22,1,23,3,45,459,50,293,291,54,18303,bainbridge island,98110,4542,2016
kitsap,woodward middle,566,2,21,0,21,1,47,439,56,303,263,37,18303,bainbridge island,98110,4505,2016
clark,amboy middle,584,1,6,0,6,0,17,548,12,301,283,213,06119,battle ground,98604,2671,2016
clark,battle ground high,2148,5,18,14,32,10,161,1849,91,1145,1003,590,06119,battle ground,98604,2415,2016
clark,cam academy,575,0,11,0,11,0,22,520,22,279,296,82,06119,battle ground,98604,1836,2016
clark,captain strong,720,1,7,0,7,3,72,604,33,399,321,293,06119,battle ground,98604,4352,2016
clark,chief umtuch middle,575,1,9,0,9,3,61,475,26,323,252,224,06119,battle ground,98604,5133,2016
clark,daybreak middle,494,1,4,2,6,4,42,416,25,247,247,195,06119,battle ground,98604,5089,2016
clark,daybreak primary,546,1,4,2,6,6,48,462,23,304,242,251,06119,battle ground,98604,5090,2016
clark,glenwood heights primary,716,0,39,5,44,9,67,571,25,359,357,275,06119,vancouver,98662,3018,2016
clark,homelink river,965,4,13,0,13,10,49,830,59,446,519,227,06119,battle ground,98604,1875,2016
clark,laurin middle,629,2,32,2,34,5,70,483,35,307,322,233,06119,battle ground,98604,3545,2016
clark,maple grove k-8,484,1,12,6,18,2,56,386,21,248,236,254,06119,battle ground,98604,5291,2016
clark,open doors battle ground,3,0,0,0,0,0,0,3,0,0,3,0,06119,battle ground,98604,5360,2016
clark,pleasant valley middle,507,2,23,3,26,5,76,359,39,268,239,170,06119,vancouver,98686,3997,2016
clark,pleasant valley primary,586,2,30,9,39,9,66,425,45,294,292,201,06119,battle ground,98604,3996,2016
clark,prairie high,1567,5,61,2,63,9,198,1200,92,799,768,408,06119,battle ground,98604,4104,2016
clark,preschool infant other,17,0,1,0,1,0,1,15,0,11,6,7,06119,battle ground,98604,4108,2016
clark,summit view high,416,2,2,3,5,1,22,371,15,198,218,156,06119,battle ground,98604,4450,2016
clark,tukes valley middle,524,0,2,0,2,3,35,463,21,240,284,172,06119,battle ground,98604,5131,2016
clark,tukes valley primary,641,0,2,0,2,2,54,549,34,338,303,216,06119,battle ground,98642,5132,2016
clark,yacolt primary,781,1,0,0,0,0,13,749,18,425,356,330,06119,yacolt,98675,2910,2016
king,ardmore elementary,391,0,117,0,117,26,114,114,20,202,189,176,17405,bellevue,98008,3633,2016
king,bellevue big picture,345,0,70,0,70,16,22,207,30,193,152,52,17405,bellevue,98007,5240,2016
king,bellevue high,1635,1,445,5,450,46,120,852,166,904,731,188,17405,bellevue,98004,2701,2016
king,bennett elementary,439,0,147,0,147,7,29,226,30,233,206,21,17405,bellevue,98008,3705,2016
king,central educational services,106,0,24,0,24,4,21,46,11,74,32,11,17405,bellevue,98009,5281,2016
king,cherry crest elementary,581,0,290,0,290,3,17,227,44,311,270,21,17405,bellevue,98005,3742,2016
king,chinook middle,1022,0,304,3,307,19,76,517,103,513,509,123,17405,bellevue,98006,3338,2016
king,clyde hill elementary,632,1,256,1,257,6,42,268,58,323,309,35,17405,bellevue,98007,2847,2016
king,eastgate elementary,442,2,142,0,142,12,30,206,50,245,197,57,17405,bellevue,98006,3036,2016
king,enatai elementary,525,0,146,3,149,19,61,235,61,275,250,96,17405,bellevue,98007,2846,2016
king,grad alliance program,10,0,2,0,2,1,2,5,0,8,2,5,17405,bellevue,98005,5325,2016
king,highland middle,565,0,100,2,102,30,163,220,50,297,268,224,17405,bellevue,98006,3166,2016
king,interlake senior high,1595,2,531,2,533,47,260,624,129,825,770,385,17405,bellevue,98008,3588,2016
king,international,575,1,208,0,208,4,14,289,59,272,303,25,17405,bellevue,98005,3522,2016
king,jing mei elementary,257,0,151,0,151,2,9,39,56,115,142,7,17405,bellevue,98006,5308,2016
king,lake hills elementary,511,2,102,5,107,19,205,142,36,259,252,270,17405,bellevue,98007,3225,2016
king,medina elementary,571,0,253,0,253,2,22,255,39,305,266,11,17405,medina,98039,3436,2016
king,newport heights elementary,638,2,233,3,236,21,51,259,69,353,285,140,17405,bellevue,98006,3437,2016
king,newport senior high,1794,3,815,2,817,37,96,696,145,920,874,216,17405,bellevue,98006,3486,2016
king,odle middle,877,2,478,0,478,23,112,192,70,475,402,210,17405,bellevue,98007,3631,2016
king,phantom lake elementary,398,1,90,1,91,11,72,177,46,239,159,123,17405,bellevue,98008,3168,2016
king,puesta del sol elementary,580,0,72,1,73,5,123,312,67,281,299,37,17405,bellevue,98006,3224,2016
king,sammamish senior high,1002,7,209,2,211,56,178,463,87,517,485,354,17405,bellevue,98005,3282,2016
king,sherwood forest elementary,423,0,95,2,97,32,132,119,43,219,204,189,17405,bellevue,98008,3339,2016
king,somerset elementary,731,0,506,1,507,7,18,138,61,356,375,34,17405,bellevue,98006,3789,2016
king,spiritridge elementary,654,0,319,1,320,7,37,232,58,339,315,54,17405,bellevue,98008,3634,2016
king,stevenson elementary,495,0,252,1,253,18,159,47,18,257,238,249,17405,bellevue,98007,3100,2016
king,tillicum middle,668,0,120,2,122,21,71,387,67,323,345,106,17405,bellevue,98008,3435,2016
king,tyee middle,972,0,490,3,493,12,55,318,94,506,466,132,17405,bellevue,98006,3283,2016
king,woodridge elementary,620,1,256,7,263,22,61,230,43,328,292,123,17405,bellevue,98005,3167,2016
whatcom,alderwood elementary,241,4,16,0,16,4,109,100,8,133,108,221,37501,bellingham,98225,3200,2016
whatcom,bellingham family partnership program,74,0,1,1,2,0,3,60,9,36,38,16,37501,bellingham,98225,5366,2016
whatcom,bellingham high,1046,12,26,2,28,14,159,761,72,527,519,301,37501,bellingham,98225,2553,2016
whatcom,bellingham re-engagement program,44,3,2,0,2,2,9,24,4,20,24,41,37501,bellingham,98225,5340,2016
whatcom,birchwood elementary,337,2,12,10,22,7,128,153,25,181,156,223,37501,bellingham,98225,2431,2016
whatcom,carl cozier elementary,261,7,9,1,10,2,35,188,19,120,141,169,37501,bellingham,98229,2817,2016
whatcom,columbia elementary,285,0,5,0,5,5,22,238,15,151,134,60,37501,bellingham,98225,2365,2016
whatcom,cordata elementary,407,1,72,3,75,13,99,185,34,222,185,271,37501,bellingham,98226,5239,2016
whatcom,fairhaven middle,587,5,37,2,39,4,45,449,45,300,287,108,37501,bellingham,98225,2066,2016
whatcom,geneva elementary,446,6,3,0,3,7,35,370,25,248,198,127,37501,bellingham,98229,2262,2016
whatcom,happy valley elementary,429,3,20,2,22,8,58,305,33,220,209,136,37501,bellingham,98225,3134,2016
whatcom,kulshan middle,556,7,21,0,21,10,103,373,42,282,274,232,37501,bellingham,98229,4442,2016
whatcom,lowell elementary,295,2,10,0,10,8,31,231,13,144,151,65,37501,bellingham,98225,2225,2016
whatcom,northern heights elementary,399,4,33,2,35,12,51,252,45,199,200,131,37501,bellingham,98226,4571,2016
whatcom,options high,111,1,0,0,0,3,19,70,18,41,70,66,37501,bellingham,98225,1647,2016
whatcom,parkview elementary,302,4,3,0,3,5,38,218,34,156,146,117,37501,bellingham,98225,3202,2016
whatcom,roosevelt elementary,417,6,10,0,10,5,115,253,28,216,201,241,37501,bellingham,98226,2067,2016
whatcom,sehome high,1187,10,69,2,71,15,115,899,77,633,554,278,37501,bellingham,98225,3576,2016
whatcom,shuksan middle,608,13,71,4,75,10,161,298,51,314,294,382,37501,bellingham,98225,3201,2016
whatcom,silver beach elementary,454,4,17,0,17,3,38,347,45,232,222,82,37501,bellingham,98226,2175,2016
whatcom,squalicum high,1390,22,134,10,144,17,273,840,94,708,682,542,37501,bellingham,98226,4515,2016
whatcom,sunnyland elementary,319,6,20,2,22,3,55,204,29,169,150,171,37501,bellingham,98225,2387,2016
whatcom,visions (seamar youth center),27,0,0,1,1,3,4,17,2,0,27,15,37501,bellingham,98225,1799,2016
whatcom,wade king elementary,430,1,14,1,15,7,39,336,32,225,205,83,37501,bellingham,98229,5125,2016
whatcom,whatcom middle,623,4,28,0,28,4,50,495,42,348,275,164,37501,bellingham,98225,2075,2016
adams,benge elementary,13,0,0,0,0,0,0,13,0,6,7,0,01122,benge,99105,3142,2016
pierce,acceleration academy,138,3,3,2,5,24,19,78,9,75,63,78,27403,spanaway,98387,5372,2016
pierce,bethel high,1682,31,90,48,138,146,224,1061,82,886,796,765,27403,spanaway,98387,2807,2016
pierce,bethel middle,630,8,29,24,53,71,91,352,55,325,305,352,27403,spanaway,98387,3250,2016
pierce,camas prairie elementary,592,6,38,33,71,66,87,291,71,329,263,339,27403,spanaway,98387,4296,2016
pierce,cedarcrest middle,639,7,54,34,88,91,114,277,62,334,305,373,27403,spanaway,98387,4186,2016
pierce,centennial elementary bethel,437,1,7,10,17,14,56,306,43,236,201,271,27403,graham,98338,4331,2016
pierce,challenger high,298,8,15,10,25,27,36,181,21,154,144,173,27403,spanaway,98387,1510,2016
pierce,chester h thompson elementary,554,2,11,53,64,57,150,194,87,259,295,399,27403,tacoma,98445,3649,2016
pierce,clover creek elementary,670,4,28,33,61,56,106,346,97,362,308,341,27403,tacoma,98446,2576,2016
pierce,cougar mountain middle,578,13,28,5,33,19,56,430,27,311,267,282,27403,graham,98338,4578,2016
pierce,elk plain school of choice,544,4,19,2,21,44,79,329,67,264,280,179,27403,spanaway,98397,2877,2016
pierce,evergreen elementary,497,5,38,47,85,36,121,192,58,258,239,329,27403,spanaway,98387,4099,2016
pierce,frederickson elementary,599,5,16,16,32,42,163,292,65,298,301,304,27403,puyallup,98375,5159,2016
pierce,frontier middle,720,14,24,6,30,26,83,529,38,388,332,280,27403,graham,98338,4407,2016
pierce,graham elementary,719,4,19,9,28,27,79,481,100,370,349,247,27403,graham,98338,4297,2016
pierce,graham kapowsin high,1950,29,82,23,105,139,259,1302,116,992,958,646,27403,graham,98338,5033,2016
pierce,kapowsin elementary,405,3,3,3,6,5,26,319,46,221,184,185,27403,graham,98338,2748,2016
pierce,liberty middle,700,7,40,17,57,58,101,425,52,391,309,329,27403,spanaway,98387,5206,2016
pierce,naches trail elementary,543,10,23,22,45,34,62,295,97,278,265,262,27403,tacoma,98446,4102,2016
pierce,nelson elementary,574,7,7,11,18,12,98,372,67,276,298,229,27403,graham,98338,5160,2016
pierce,north star elementary,475,3,11,9,20,24,62,292,74,244,231,217,27403,graham,98338,4538,2016
pierce,pioneer valley elementary,459,4,14,20,34,28,58,271,64,254,205,221,27403,spanaway,98387,4381,2016
pierce,rocky ridge elementary,486,5,6,6,12,10,87,335,37,237,249,290,27403,graham,98338,4227,2016
pierce,roy elementary,288,1,2,0,2,2,27,221,35,146,142,162,27403,roy,98580,2543,2016
pierce,shining mountain elementary,680,3,25,33,58,25,175,304,115,362,318,418,27403,spanaway,98387,4103,2016
pierce,spanaway elementary,337,5,8,5,13,33,56,162,68,173,164,214,27403,spanaway,98387,2399,2016
pierce,spanaway lake high,1699,32,153,89,242,270,318,716,121,876,823,851,27403,spanaway,98387,4158,2016
pierce,spanaway middle,698,17,46,43,89,87,143,278,84,369,329,448,27403,tacoma,98445,3751,2016
pierce,thompson preschool,228,3,5,6,11,11,34,147,22,153,75,108,27403,tacoma,98445,1560,2016
klickitat,bickleton elementary & high,86,0,1,0,1,0,28,55,2,48,38,13,20203,bickleton,99322,3392,2016
whatcom,blaine elementary,485,3,19,2,21,10,68,352,31,245,240,233,37503,blaine,98230,2713,2016
whatcom,blaine high,663,6,16,7,23,9,91,499,35,359,304,246,37503,blaine,98230,3136,2016
whatcom,blaine home connections,61,0,0,0,0,0,3,57,1,31,30,3,37503,blaine,98230,5021,2016
whatcom,blaine middle,482,5,14,8,22,11,64,358,22,247,235,245,37503,blaine,98230,3796,2016
whatcom,blaine primary,492,4,24,2,26,6,50,378,28,254,238,233,37503,blaine,98230,4476,2016
whatcom,point roberts primary,15,0,0,0,0,0,1,12,2,3,12,1,37503,point roberts,98281,4459,2016
lewis,boistfort elem,93,1,0,0,0,0,15,75,2,58,35,54,21234,curtis,98538,2516,2016
kitsap,armin jahr elementary,441,8,17,11,28,21,104,218,62,219,222,336,18100,bremerton,98310,3641,2016
kitsap,bremerton high,1247,15,72,27,99,76,212,641,204,680,567,653,18100,bremerton,98337,3109,2016
kitsap,bremerton home link program,30,1,0,0,0,1,2,24,2,17,13,17,18100,bremerton,98312,1749,2016
kitsap,career & academic re-engagement center,17,0,0,0,0,1,2,13,1,10,7,42,18100,bremerton,98312,5395,2016
kitsap,crownhill elementary,453,2,8,8,16,28,80,247,80,254,199,245,18100,bremerton,98312,3108,2016
kitsap,kitsap lake elementary,435,4,14,4,18,17,59,273,64,202,233,206,18100,bremerton,98312,4421,2016
kitsap,mountain view middle,880,9,31,22,53,56,156,462,144,457,423,519,18100,bremerton,98310,4441,2016
kitsap,naval avenue elementary,377,2,6,11,17,23,97,187,51,191,186,246,18100,bremerton,98312,3171,2016
kitsap,renaissance alternative high,146,6,1,0,1,6,26,82,25,78,68,104,18100,bremerton,98312,1737,2016
kitsap,special services,62,0,2,0,2,5,11,37,7,42,20,30,18100,bremerton,98312,5161,2016
kitsap,west hills s.t.e.m. academy,608,7,23,15,38,42,117,305,99,341,267,406,18100,bremerton,98312,2613,2016
okanogan,brewster alternative,21,1,0,0,0,0,18,2,0,16,5,15,24111,brewster,98812,5272,2016
okanogan,brewster elementary,500,2,2,0,2,1,464,29,2,273,227,453,24111,brewster,98812,3293,2016
okanogan,brewster high,247,2,0,0,0,0,212,31,2,135,112,199,24111,brewster,98812,2800,2016
okanogan,brewster middle,215,2,0,0,0,0,191,21,1,115,100,185,24111,brewster,98812,4223,2016
douglas,bridgeport aurora high,21,0,0,0,0,0,17,4,0,12,9,13,09075,bridgeport,98813,1900,2016
douglas,bridgeport elementary,395,0,1,1,2,0,366,25,2,197,198,353,09075,bridgeport,98813,2562,2016
douglas,bridgeport high,230,0,1,0,1,1,193,34,1,129,101,188,09075,bridgeport,98813,2788,2016
douglas,bridgeport middle,245,1,1,0,1,0,228,13,2,117,128,229,09075,bridgeport,98813,4213,2016
jefferson,brinnon elementary,54,2,0,1,1,2,3,40,6,30,24,44,16046,brinnon,98320,2836,2016
skagit,allen elementary,435,5,5,1,6,6,259,142,17,228,207,331,29100,bow,98232,3603,2016
skagit,bay view elementary,531,3,13,1,14,5,135,357,17,290,241,172,29100,burlington,98233,4412,2016
skagit,becc,34,0,3,0,3,2,22,6,1,22,12,26,29100,burlington,98233,1650,2016
skagit,burlington edison high,1101,10,24,2,26,15,368,654,27,573,528,407,29100,burlington,98233,2362,2016
skagit,burlington-edison alternative,51,1,0,0,0,0,23,27,0,19,32,36,29100,burlington,98233,1928,2016
skagit,edison elementary - burlington/edison,444,4,4,2,6,3,55,356,20,239,205,117,29100,edison,98232,2379,2016
skagit,lucille umbarger elementary,695,7,8,1,9,0,356,301,22,358,337,449,29100,burlington,98233,3251,2016
skagit,west view elementary,391,1,3,2,5,1,281,93,10,186,205,279,29100,burlington,98233,2946,2016
clark,camas high,2114,8,145,9,154,18,157,1627,150,1070,1044,266,06117,camas,98607,4567,2016
clark,dorothy fox,462,2,34,2,36,1,34,338,51,240,222,51,06117,camas,98607,4182,2016
clark,grass valley elementary,539,2,48,3,51,6,38,393,49,275,264,49,06117,camas,98607,5158,2016
clark,hayes freedom high,137,0,2,0,2,2,9,119,5,60,77,57,06117,camas,98607,5104,2016
clark,helen baller elem,585,3,15,4,19,3,58,452,50,292,293,108,06117,camas,98607,2725,2016
clark,liberty middle,763,0,25,1,26,9,61,622,45,411,352,156,06117,camas,98607,5054,2016
clark,papermaker preschool,63,0,6,0,6,0,6,48,3,44,19,11,06117,camas,98607,5055,2016
clark,prune hill elem,515,3,63,2,65,1,45,362,39,255,260,63,06117,camas,98607,4563,2016
clark,skyridge middle,936,4,79,8,87,9,74,683,79,457,479,90,06117,camas,98607,4508,2016
clark,woodburn elementary,434,0,20,0,20,2,43,334,35,222,212,117,06117,camas,98607,5309,2016
clallam,cape flattery preschool,9,5,0,0,0,0,2,1,1,7,2,1,05401,sekiu,98381,1787,2016
clallam,clallam bay high & elementary,115,12,0,0,0,0,30,53,20,54,61,72,05401,clallam bay,98326,3422,2016
clallam,neah bay elementary,166,106,0,0,0,0,28,6,26,82,84,127,05401,neah bay,98357,2594,2016
clallam,neah bay junior/ senior high,185,105,0,0,0,0,32,8,40,91,94,111,05401,neah bay,98357,3145,2016
thurston,gravity high,374,40,7,2,9,13,36,276,0,214,160,0,34801,tumwater,98512,5305,2016
pierce,carbonado historical school 19,179,0,1,0,1,0,9,163,6,93,86,49,27019,carbonado,98323,2466,2016
chelan,beaver valley,32,0,0,0,0,0,1,31,0,14,18,6,04228,leavenworth,98826,4566,2016
chelan,cascade high,443,5,7,1,8,1,125,302,1,227,216,159,04228,leavenworth,98826,3564,2016
chelan,cascade home-link,19,0,0,0,0,1,2,16,0,8,11,5,04228,leavenworth,98826,5418,2016
chelan,icicle river middle,295,3,2,0,2,0,88,195,7,147,148,148,04228,leavenworth,98826,4403,2016
chelan,cashmere high,473,3,3,0,3,2,172,287,6,235,238,189,04222,cashmere,98815,3268,2016
chelan,cashmere middle,457,3,3,0,3,5,165,268,13,228,229,207,04222,cashmere,98815,2315,2016
chelan,vale elementary,604,0,5,0,5,3,252,328,16,316,288,311,04222,cashmere,98815,2787,2016
cowlitz,castle rock elementary,582,5,4,2,6,1,55,477,38,300,282,302,08401,castle rock,98611,2762,2016
cowlitz,castle rock high,390,5,1,3,4,2,34,326,19,216,174,175,08401,castle rock,98611,2281,2016
cowlitz,castle rock middle,258,2,0,2,2,1,22,216,15,133,125,132,08401,castle rock,98611,3969,2016
klickitat,centerville elementary,84,0,0,1,1,0,5,78,0,42,42,32,20215,centerville,98613,2251,2016
kitsap,brownsville elementary,463,0,17,6,23,8,45,305,82,251,212,124,18401,bremerton,98311,2994,2016
kitsap,central kitsap high,1444,5,117,15,132,35,169,883,220,710,734,306,18401,silverdale,98383,2615,2016
kitsap,central kitsap middle,489,3,36,3,39,22,51,305,69,233,256,149,18401,silverdale,98383,3237,2016
kitsap,clear creek elementary,558,0,18,5,23,19,112,336,68,315,243,247,18401,silverdale,98383,4016,2016
kitsap,cottonwood elementary,404,3,25,12,37,7,52,228,77,215,189,163,18401,bremerton,98311,4014,2016
kitsap,cougar valley elementary,545,7,9,1,10,23,58,385,62,268,277,149,18401,silverdale,98383,4341,2016
kitsap,emerald heights elementary,593,2,37,6,43,13,74,364,97,307,286,136,18401,silverdale,98383,4444,2016
kitsap,esquire hills elementary,373,2,24,17,41,13,43,194,80,199,174,195,18401,bremerton,98311,4015,2016
kitsap,fairview middle,482,0,33,7,40,25,71,246,100,248,234,217,18401,bremerton,98310,3791,2016
kitsap,green mountain elementary,412,0,0,1,1,10,30,320,51,205,207,144,18401,bremerton,98312,4393,2016
kitsap,klahowya secondary,939,5,22,4,26,7,81,736,84,489,450,248,18401,silverdale,98383,4509,2016
kitsap,olympic high,1179,9,95,33,128,46,157,592,247,654,525,410,18401,bremerton,98311,4100,2016
kitsap,pinecrest elementary,448,0,19,4,23,20,79,232,94,232,216,197,18401,bremerton,98311,4527,2016
kitsap,ridgetop middle,436,3,36,6,42,16,64,235,76,205,231,138,18401,silverdale,98383,4249,2016
kitsap,silver ridge elementary,410,3,18,4,22,6,65,227,87,201,209,126,18401,silverdale,98383,4372,2016
kitsap,silverdale elementary,428,1,20,9,29,13,50,266,69,224,204,142,18401,silverdale,98383,4101,2016
kitsap,woodlands elementary,445,1,31,14,45,18,79,217,85,235,210,238,18401,bremerton,98311,4135,2016
spokane,adams elementary,474,1,17,6,23,8,41,383,18,244,230,224,32356,spokane valley,99037,3259,2016
spokane,bowdish middle,506,5,7,0,7,10,34,415,35,273,233,259,32356,spokane valley,99206,3260,2016
spokane,broadway elementary,494,8,3,16,19,13,84,338,32,262,232,365,32356,spokane valley,99206,2892,2016
spokane,central valley early learning center,107,1,1,0,1,4,16,82,3,70,37,77,32356,spokane valley,99206,5043,2016
spokane,central valley high,2094,16,44,14,58,30,131,1768,91,1101,993,540,32356,spokane valley,99037,3065,2016
spokane,chester elementary,389,2,5,0,5,4,20,352,6,201,188,86,32356,spokane valley,99206,3929,2016
spokane,cvsd open doors programs,22,0,0,1,1,2,1,17,1,17,5,9,32356,spokane valley,99016,5328,2016
spokane,evergreen middle,712,1,12,2,14,7,49,611,30,372,340,239,32356,spokane valley,99206,3890,2016
spokane,greenacres elementary,621,5,12,0,12,1,43,531,29,326,295,223,32356,spokane valley,99016,2157,2016
spokane,greenacres middle,767,1,15,1,16,7,51,651,41,388,379,191,32356,spokane valley,99016,3573,2016
spokane,horizon middle,489,8,4,1,5,1,32,419,24,236,253,133,32356,spokane valley,99206,4185,2016
spokane,i-tracc,102,1,0,1,1,1,7,87,5,62,40,58,32356,spokane valley,99037,5166,2016
spokane,liberty lake elementary,662,3,13,0,13,6,37,585,18,328,334,117,32356,liberty lake,99019,4529,2016
spokane,mcdonald elementary,361,9,2,3,5,11,20,310,6,210,151,202,32356,spokane valley,99216,3127,2016
spokane,mica peak high,82,0,2,1,3,1,6,68,4,41,41,52,32356,spokane valley,99037,3918,2016
spokane,north pines middle,506,6,11,17,28,19,47,381,25,263,243,361,32356,spokane valley,99206,2776,2016
spokane,opportunity elementary,431,7,8,9,17,21,52,313,21,236,195,325,32356,spokane valley,99206,2113,2016
spokane,ponderosa elementary,411,4,1,2,3,6,27,367,4,222,189,119,32356,spokane valley,99206,4098,2016
spokane,progress elementary,395,6,4,1,5,7,34,327,16,188,207,218,32356,spokane valley,99037,2953,2016
spokane,school to life,38,1,0,0,0,2,2,31,2,25,13,19,32356,spokane valley,99037,5003,2016
spokane,south pines elementary,415,0,6,0,6,11,39,345,14,212,203,187,32356,spokane valley,99206,3307,2016
spokane,spokane valley learning academy,76,0,2,0,2,2,0,72,0,26,50,24,32356,spokane valley,99216,1964,2016
spokane,summit,346,1,4,0,4,2,5,322,12,169,177,78,32356,spokane valley,99216,3465,2016
spokane,sunrise elementary,589,1,8,2,10,8,32,513,25,305,284,133,32356,spokane valley,99206,4160,2016
spokane,university elementary,299,4,3,2,5,7,26,249,8,159,140,167,32356,spokane valley,99206,3064,2016
spokane,university high,1811,22,14,9,23,35,107,1517,107,964,847,641,32356,spokane valley,99216,3415,2016
lewis,centralia high,1051,7,10,4,14,13,293,696,28,549,502,594,21401,centralia,98531,2166,2016
lewis,centralia middle,535,5,4,1,5,7,174,321,23,257,278,380,21401,centralia,98531,3240,2016
lewis,edison elementary,365,0,4,0,4,2,135,201,23,188,177,288,21401,centralia,98531,2244,2016
lewis,fords prairie elementary,395,2,1,0,1,5,134,238,15,209,186,301,21401,centralia,98531,2704,2016
lewis,futurus high,74,0,0,0,0,2,15,55,2,35,39,56,21401,centralia,98531,5359,2016
lewis,jefferson lincoln elementary,392,1,0,1,1,2,155,221,12,199,193,334,21401,centralia,98531,3172,2016
lewis,oakview elementary,421,1,2,1,3,5,130,261,21,223,198,322,21401,centralia,98531,2291,2016
lewis,washington elementary,354,3,3,1,4,3,129,207,8,182,172,275,21401,centralia,98531,2768,2016
lewis,chehalis middle,649,2,9,1,10,8,116,479,34,313,336,317,21302,chehalis,98532,4311,2016
lewis,lewis county alternative,27,0,0,0,0,2,3,21,1,19,8,21,21302,chehalis,98532,5369,2016
lewis,olympic elementary,379,0,2,0,2,2,72,280,23,206,173,212,21302,longview,98632,2726,2016
lewis,w f west high,987,9,16,0,16,5,139,778,40,481,506,333,21302,chehalis,98532,2799,2016
spokane,betz elementary,421,5,5,1,6,7,63,327,13,222,199,234,32360,cheney,99004,2954,2016
spokane,birth to three,35,0,0,0,0,1,1,30,3,19,16,15,32360,cheney,99004,5126,2016
spokane,cheney high,1220,15,29,5,34,16,118,949,88,644,576,440,32360,cheney,99004,3610,2016
spokane,cheney middle,487,11,9,1,10,4,60,363,39,264,223,214,32360,cheney,99004,2447,2016
spokane,cheney open doors,9,0,0,0,0,0,1,6,2,5,4,6,32360,cheney,99004,5396,2016
spokane,homeworks,73,0,0,0,0,1,2,70,0,37,36,7,32360,cheney,99004,5035,2016
spokane,phil snowdon elementary,471,9,8,3,11,11,36,374,30,249,222,221,32360,cheney,99004,5294,2016
spokane,salnave elementary,362,5,3,1,4,8,40,286,19,194,168,188,32360,cheney,99004,3761,2016
spokane,sunset elementary,399,18,8,14,22,13,44,272,30,211,188,282,32360,airway heights,99001,2814,2016
spokane,three springs high,41,1,0,0,0,0,2,33,5,12,29,45,32360,cheney,99004,1769,2016
spokane,westwood middle,528,12,8,1,9,16,53,404,34,284,244,250,32360,spokane,99224,5269,2016
spokane,windsor elementary,505,3,4,0,4,7,44,400,47,281,224,211,32360,spokane,99224,3309,2016
stevens,gess elementary,343,1,3,2,5,3,18,300,16,198,145,246,33036,chewelah,99109,2664,2016
stevens,jenkins junior/senior high,400,2,2,0,2,4,11,374,7,208,192,198,33036,chewelah,99109,2404,2016
jefferson,chimacum creek primary,233,2,1,0,1,0,15,197,18,130,103,137,16049,chimacum,98325,4552,2016
jefferson,chimacum elementary,205,2,3,0,3,2,16,161,21,115,90,113,16049,chimacum,98325,2697,2016
jefferson,chimacum high,350,6,12,1,13,3,27,285,16,167,183,129,16049,chimacum,98325,3275,2016
jefferson,chimacum middle,213,2,1,0,1,3,24,171,12,103,110,103,16049,chimacum,98325,4261,2016
jefferson,open doors reengagement program,11,0,0,0,0,0,1,10,0,2,9,5,16049,chimacum,98325,5397,2016
jefferson,pi program,65,1,0,1,1,1,7,49,6,29,36,27,16049,chimacum,98325,1724,2016
asotin,charles francis adams high,766,19,8,0,8,9,49,661,20,373,393,314,02250,clarkston,99403,2299,2016
asotin,educational opportunity center,117,3,0,1,1,0,7,101,5,60,57,67,02250,clarkston,99403,1617,2016
asotin,grantham elementary,254,2,0,0,0,0,19,209,24,137,117,213,02250,clarkston,99403,2962,2016
asotin,heights elementary,403,2,2,0,2,3,22,357,17,191,212,143,02250,clarkston,99403,4384,2016
asotin,highland elementary,333,3,5,0,5,3,38,266,18,160,173,267,02250,clarkston,99403,3266,2016
asotin,lincoln middle,413,11,5,0,5,7,27,352,11,194,219,235,02250,clarkston,99403,2501,2016
asotin,parkway elementary,352,6,5,0,5,10,25,301,5,194,158,253,02250,clarkston,99403,2823,2016
asotin,special services,41,0,0,0,0,0,1,36,4,25,16,30,02250,clarkston,99403,3616,2016
kittitas,cle elum roslyn elementary,396,2,2,0,2,1,35,338,18,196,200,175,19404,cle elum,98922,2328,2016
kittitas,cle elum roslyn high,274,1,4,2,6,4,31,219,13,143,131,82,19404,cle eum,98922,2329,2016
kittitas,swiftwater learning center,31,1,0,0,0,0,4,26,0,17,14,17,19404,cle elum,98922,1987,2016
kittitas,walter strom middle,202,1,1,0,1,1,20,171,8,105,97,73,19404,cle elum,98922,2570,2016
pierce,alfaretta house,147,0,3,4,7,17,38,66,19,92,55,57,27400,lakewood,98499,1825,2016
pierce,beachwood elementary,312,0,12,7,19,29,67,145,52,154,158,141,27400,jblm lewis north,98433,3454,2016
pierce,carter lake elementary,442,1,16,7,23,51,92,228,47,237,205,199,27400,jblm mcchord field,98439,3457,2016
pierce,clover park early learning program,13,0,0,0,0,3,5,3,2,11,2,19,27400,lakewood,98499,5386,2016
pierce,clover park high,1179,7,94,78,172,174,449,236,141,616,563,851,27400,lakewood,98499,2425,2016
pierce,cpsd open doors program,99,2,2,8,10,19,36,26,6,51,48,124,27400,lakewood,98499,5411,2016
pierce,custer elementary,322,0,16,16,32,63,76,136,15,181,141,252,27400,lakewood,98498,2943,2016
pierce,dower elementary,293,2,17,13,30,49,78,79,55,161,132,220,27400,lakewood,98499,3455,2016
pierce,evergreen elementary,490,0,19,24,43,45,127,244,31,287,203,289,27400,jblm lewis main,98433,4396,2016
pierce,four heroes elementary,687,7,22,37,59,63,371,102,85,345,342,625,27400,lakewood,98499,5387,2016
pierce,harrison prep,637,3,34,12,46,76,173,241,98,285,352,304,27400,lakewood,98499,5027,2016
pierce,hillside elementary,532,9,18,18,36,85,160,190,52,270,262,338,27400,jblm lewis main,98433,3298,2016
pierce,hudtloff middle,748,5,35,26,61,83,266,240,93,382,366,456,27400,lakewood,98498,3248,2016
pierce,idlewild elementary,473,1,21,2,23,25,83,251,90,258,215,190,27400,lakewood,98498,3117,2016
pierce,lake louise elementary,411,2,6,24,30,28,107,144,100,202,209,323,27400,lakewood,98498,3351,2016
pierce,lakes high,1370,7,81,40,121,208,273,559,202,717,653,589,27400,lakewood,98498,3456,2016
pierce,lakeview hope academy,712,1,27,39,66,79,397,98,71,359,353,565,27400,lakewood,98499,2652,2016
pierce,lochburn middle,547,1,37,45,82,81,205,108,70,288,259,476,27400,lakewood,98499,3602,2016
pierce,mann middle,408,3,20,23,43,40,88,184,50,215,193,211,27400,lakewood,98498,3297,2016
pierce,meriwether elementary,325,0,5,4,9,36,74,146,59,156,169,130,27400,jblm lewis north,98433,5364,2016
pierce,oakbrook elementary,334,2,22,14,36,38,74,141,43,177,157,193,27400,lakewood,98498,3763,2016
pierce,park lodge elementary,415,1,12,12,24,59,175,94,62,208,207,388,27400,lakewood,98499,2189,2016
pierce,rainier elementary,545,4,17,11,28,70,138,246,59,282,263,291,27400,jblm lewis main,98433,5365,2016
pierce,special education services/relife,13,0,0,0,0,3,2,6,2,9,4,11,27400,lakewood,98499,1882,2016
pierce,tillicum elementary,369,4,13,34,47,36,132,89,61,205,164,334,27400,lakewood,98498,2651,2016
pierce,transition day students,10,0,0,0,0,1,2,6,1,6,4,4,27400,lakewood,98499,5297,2016
pierce,tyee park elementary,450,0,9,27,36,53,193,98,70,227,223,374,27400,lakewood,98499,3249,2016
pierce,woodbrook middle,470,1,19,26,45,63,147,173,41,255,215,362,27400,lakewood,98439,3500,2016
whitman,colfax high,300,0,2,0,2,1,7,270,20,160,140,87,38300,colfax,99111,3366,2016
whitman,leonard m jennings elementary,299,3,1,0,1,0,13,257,25,166,133,98,38300,colfax,99111,2894,2016
walla walla,college place high,215,1,0,2,2,4,73,132,3,124,91,107,36250,college place,99362,5362,2016
walla walla,davis elementary,648,5,6,2,8,9,296,320,10,327,321,426,36250,college place,99324,2114,2016
walla walla,john sager middle,337,2,4,2,6,6,136,184,3,176,161,191,36250,college place,99324,3541,2016
whitman,colton,158,0,3,0,3,3,5,143,4,80,78,31,38306,colton,99113,2588,2016
stevens,columbia alternative,1,1,0,0,0,0,0,0,0,0,1,2,33206,hunters,99137,5283,2016
stevens,columbia high and elementary,160,35,1,0,1,0,10,94,20,92,68,109,33206,hunters,99137,3508,2016
walla walla,columbia elementary,357,0,0,0,0,3,137,214,3,185,172,201,36400,burbank,99323,3613,2016
walla walla,columbia high,293,2,5,0,5,2,70,204,10,146,147,92,36400,burbank,99323,4049,2016
walla walla,columbia middle,185,1,0,0,0,2,63,114,5,88,97,90,36400,burbank,99323,3012,2016
stevens,colville junior high,401,9,2,1,3,5,12,354,18,196,205,189,33115,colville,99114,3831,2016
stevens,colville senior high,559,14,3,0,3,3,29,480,30,279,280,233,33115,colville,99114,3310,2016
stevens,fort colville elementary,376,3,5,0,5,1,18,337,12,197,179,205,33115,colville,99114,4180,2016
stevens,hofstetter elementary,382,5,0,0,0,1,27,338,11,192,190,238,33115,colville,99114,2957,2016
stevens,panorama,93,1,0,0,0,0,5,82,5,42,51,68,33115,colville,99114,1594,2016
skagit,concrete elementary,252,6,2,0,2,0,18,225,1,132,120,191,29011,concrete,98237,2577,2016
skagit,concrete high,264,5,1,1,2,0,12,239,6,146,118,138,29011,concrete,98237,2810,2016
skagit,special services,6,0,0,0,0,0,0,6,0,3,3,7,29011,concrete,98237,5087,2016
skagit,twin cedars high,5,0,0,0,0,0,0,5,0,1,4,15,29011,concrete,98237,1605,2016
skagit,conway,440,1,5,0,5,5,45,381,3,228,212,94,29317,mount vernon,98274,2578,2016
grays harbor,cosmopolis elementary,147,0,0,0,0,0,18,117,12,77,70,81,14099,cosmopolis,98537,3326,2016
grant,almira coulee hartline high,83,0,0,0,0,1,4,77,1,42,41,29,13151,coulee city,99115,2968,2016
grant,coulee city elementary,72,0,0,0,0,2,5,63,2,40,32,33,13151,coulee city,99115,2693,2016
island,coupeville elementary,417,0,2,0,2,6,58,297,54,195,222,142,15204,coupeville,98239,3664,2016
island,coupeville high,315,0,5,0,5,7,41,231,31,161,154,90,15204,coupeville,98239,2625,2016
island,coupeville middle,227,0,6,0,6,3,32,167,19,101,126,67,15204,coupeville,98239,4004,2016
clallam,crescent,203,1,0,0,0,0,12,165,25,101,102,98,05313,joyce,98343,3473,2016
clallam,homeconnection,69,0,0,0,0,0,1,67,1,32,37,29,05313,joyce,98343,5030,2016
lincoln,creston elementary,37,0,0,0,0,0,2,34,1,27,10,14,22073,creston,99117,2862,2016
lincoln,creston jr-sr high,51,0,1,0,1,0,1,48,1,25,26,19,22073,creston,99117,2863,2016
ferry,curlew elem & high,169,5,0,0,0,3,7,141,13,90,79,96,10050,curlew,99118,2006,2016
pend oreille,bess herian elementary,94,22,0,0,0,0,1,49,22,57,37,65,26059,cusick,99119,2770,2016
pend oreille,cusick jr sr high,145,50,1,0,1,1,10,72,11,83,62,84,26059,cusick,99119,2423,2016
kittitas,damman elementary,40,1,0,0,0,0,0,39,0,19,21,0,19007,ellensburg,98926,2077,2016
snohomish,darrington elementary,294,9,1,0,1,0,28,233,23,145,149,169,31330,darrington,98241,3609,2016
lincoln,davenport elementary,270,3,2,0,2,1,9,250,5,120,150,166,22207,davenport,99122,2668,2016
lincoln,davenport senior high,327,10,1,0,1,0,6,308,2,162,165,172,22207,davenport,99122,3173,2016
columbia,dayton elementary,182,3,1,0,1,0,31,143,4,89,93,116,07002,dayton,99328,2830,2016
columbia,dayton high,147,8,2,0,2,1,21,114,1,67,80,75,07002,dayton,99328,2302,2016
columbia,dayton middle,70,3,1,0,1,2,10,51,3,31,39,46,07002,dayton,99328,4011,2016
spokane,arcadia elementary,452,12,3,3,6,3,29,399,3,241,211,252,32414,deer park,99006,2173,2016
spokane,deer park early learning center,6,0,0,0,0,0,0,6,0,5,1,13,32414,deer park,99006,5270,2016
spokane,deer park elementary,403,10,0,1,1,4,22,366,0,211,192,244,32414,deer park,99006,2430,2016
spokane,deer park high,661,16,3,0,3,11,29,594,8,328,333,300,32414,deer park,99006,4123,2016
spokane,deer park home link program,486,8,2,1,3,8,17,448,2,242,244,57,32414,deer park,99006,1852,2016
spokane,deer park middle,482,13,6,1,7,9,23,429,1,252,230,252,32414,deer park,99006,3261,2016
pierce,dieringer heights elementary,561,2,28,1,29,9,45,432,44,286,275,73,27343,lake tapps,98391,4548,2016
pierce,lake tapps elementary,481,2,31,4,35,8,46,330,60,257,224,63,27343,lake tapps,98391,3683,2016
pierce,north tapps middle,514,2,34,3,37,4,45,382,44,246,268,53,27343,lake tapps,98391,4416,2016
spokane,children first,36,0,0,0,0,0,6,28,2,27,9,18,32361,spokane valley,99216,1937,2016
spokane,continuous curriculum,521,1,11,0,11,2,27,444,36,245,276,137,32361,spokane,99216,1712,2016
spokane,east farms,423,3,3,8,11,3,53,325,28,216,207,279,32361,newman lake,99025,4097,2016
spokane,east valley high,1068,11,16,7,23,14,96,869,55,564,504,481,32361,spokane valley,99216,3360,2016
spokane,east valley middle,493,7,5,6,11,7,57,377,34,255,238,283,32361,spokane valley,99216,5346,2016
spokane,otis orchards,434,7,5,1,6,5,32,346,38,206,228,246,32361,otis orchards,99027,2955,2016
spokane,trent,475,7,3,14,17,13,78,304,56,249,226,403,32361,spokane valley,99206,2653,2016
spokane,trentwood,490,5,10,3,13,2,34,398,38,240,250,337,32361,spokane valley,99216,3128,2016
yakima,east valley central middle,684,8,6,1,7,7,321,328,13,378,306,415,39090,yakima,98901,4055,2016
yakima,east valley elementary,544,5,1,1,2,3,275,246,13,294,250,357,39090,yakima,98901,4487,2016
yakima,east valley high,874,11,7,2,9,8,364,472,10,459,415,413,39090,yakima,98901,2344,2016
yakima,moxee elementary,493,1,0,0,0,5,304,174,9,240,253,294,39090,moxee,98936,2530,2016
yakima,terrace heights elementary,534,2,10,0,10,6,201,295,20,259,275,295,39090,yakima,98901,2821,2016
douglas,cascade elementary,470,0,2,0,2,0,165,291,12,253,217,206,09206,east wenatchee,98802,3659,2016
douglas,clovis point,603,0,2,2,4,1,344,236,18,310,293,408,09206,east wenatchee,98802,4590,2016
douglas,eastmont junior high,899,3,11,2,13,4,388,471,20,459,440,496,09206,east wenatchee,98802,3372,2016
douglas,eastmont senior high,1431,6,9,0,9,6,613,750,47,748,683,631,09206,east wenatchee,98802,2727,2016
douglas,grant elementary,491,2,6,1,7,1,236,233,12,260,231,276,09206,east wenatchee,98802,2966,2016
douglas,kenroy elementary,467,2,2,0,2,0,215,238,10,224,243,266,09206,east wenatchee,98802,3212,2016
douglas,rock island elementary,226,0,0,0,0,0,160,58,8,136,90,183,09206,rock island,98850,2563,2016
kittitas,easton,113,4,0,0,0,2,29,75,3,54,59,73,19028,easton,98925,3554,2016
pierce,columbia crest a-stem academy,195,0,2,0,2,1,9,168,15,86,109,91,27404,ashford,98304,2808,2016
pierce,eatonville developmental pre-school,9,0,0,0,0,0,0,9,0,3,6,2,27404,eatonville,98328,5079,2016
pierce,eatonville elementary,364,5,3,2,5,2,24,307,21,188,176,177,27404,eatonville,98328,2205,2016
pierce,eatonville high,697,6,3,4,7,6,52,597,29,351,346,210,27404,eatonville,98328,2206,2016
pierce,eatonville middle,384,3,1,3,4,3,24,325,25,195,189,161,27404,eatonville,98328,4230,2016
pierce,mt. rainier parent partnership,32,0,1,0,1,0,2,27,2,12,20,22,27404,eatonville,98328,5300,2016
pierce,new beginnings,8,0,0,0,0,0,2,5,1,3,5,8,27404,eatonville,98328,5332,2016
pierce,weyerhaeuser elementary,262,0,0,1,1,1,16,221,23,141,121,120,27404,eatonville,98328,2361,2016
snohomish,alderwood middle,723,3,152,8,160,49,174,269,68,355,368,341,31015,lynnwood,98037,3560,2016
snohomish,beverly elementary,553,5,58,13,71,36,131,240,70,279,274,248,31015,lynnwood,98037,3302,2016
snohomish,brier elementary,432,1,30,4,34,16,50,285,46,234,198,91,31015,brier,98036,3536,2016
snohomish,brier terrace middle,655,1,79,8,87,21,90,363,93,344,311,194,31015,brier,98036,3650,2016
snohomish,cedar valley community,449,2,40,0,40,28,246,106,27,234,215,345,31015,lynnwood,98036,3409,2016
snohomish,cedar way elementary,469,0,67,7,74,38,70,224,63,238,231,215,31015,mtlk terrace,98043,3304,2016
snohomish,challenge elementary,318,0,78,0,78,12,19,173,36,169,149,28,31015,mtlk terrace,98043,1520,2016
snohomish,chase lake elementary,387,2,26,3,29,48,99,160,49,220,167,217,31015,edmonds,98020,3534,2016
snohomish,college place elementary,471,7,28,1,29,61,214,114,46,234,237,360,31015,lynnwood,98036,3691,2016
snohomish,college place middle,486,2,37,1,38,43,126,225,52,249,237,233,31015,lynnwood,98036,3754,2016
snohomish,contracted schools,130,0,10,0,10,11,30,60,19,82,48,38,31015,lynnwood,98036,1830,2016
snohomish,early childhood center,152,2,17,1,18,21,32,64,15,113,39,68,31015,lynnwood,98036,3185,2016
snohomish,edmonds career access program,280,3,12,2,14,9,60,172,22,154,126,71,31015,lynnwood,98036,5358,2016
snohomish,edmonds elearning academy,78,0,4,0,4,0,11,56,7,37,41,43,31015,lynnwood,98036,1519,2016
snohomish,edmonds elementary,350,3,16,0,16,16,35,233,47,180,170,70,31015,edmonds,98020,3606,2016
snohomish,edmonds heights k-12,537,2,27,0,27,12,71,357,68,277,260,89,31015,edmonds,98020,1966,2016
snohomish,edmonds woodway high,1655,12,238,5,243,106,274,867,153,819,836,473,31015,edmonds,98026,3123,2016
snohomish,hazelwood elementary,506,3,87,1,88,29,106,236,44,270,236,178,31015,lynnwood,98036,3607,2016
snohomish,hilltop elementary,550,3,85,3,88,12,57,332,58,294,256,96,31015,lynnwood,98036,3689,2016
snohomish,lynndale elementary,401,3,32,7,39,32,103,174,50,204,197,202,31015,lynnwood,98036,3122,2016
snohomish,lynnwood elementary,603,3,108,6,114,42,140,234,70,329,274,314,31015,lynnwood,98037,3503,2016
snohomish,lynnwood high,1429,3,298,11,309,99,295,606,117,742,687,587,31015,bothell,98012,3755,2016
snohomish,maplewood parent coop,454,0,38,0,38,19,19,336,42,237,217,27,31015,edmonds,98026,1685,2016
snohomish,martha lake elementary,517,3,120,5,125,38,85,221,45,240,277,239,31015,lynnwood,98037,2887,2016
snohomish,meadowdale elementary,483,1,66,0,66,34,119,210,53,253,230,242,31015,lynnwood,98037,3504,2016
snohomish,meadowdale high,1616,10,212,17,229,96,261,887,133,843,773,499,31015,lynnwood,98037,3464,2016
snohomish,meadowdale middle,748,3,95,7,102,49,169,361,64,400,348,300,31015,lynnwood,98037,3353,2016
snohomish,mountlake terrace elementary,425,1,33,12,45,18,112,201,48,219,206,233,31015,mountlake terrace,98043,3254,2016
snohomish,mountlake terrace high,1295,12,155,8,163,65,203,719,133,684,611,376,31015,mtlk terrace,98043,3303,2016
snohomish,oak heights elementary,595,1,102,4,106,29,112,299,48,278,317,248,31015,lynnwood,98037,3608,2016
snohomish,scriber lake high,261,0,10,2,12,16,60,147,26,142,119,153,31015,edmonds,98020,3854,2016
snohomish,seaview elementary,380,0,19,1,20,8,49,251,52,202,178,95,31015,edmonds,98020,3461,2016
snohomish,sherwood elementary,473,3,25,0,25,25,79,284,57,238,235,113,31015,edmonds,98020,3605,2016
snohomish,spruce elementary,536,1,94,9,103,73,138,172,49,280,256,299,31015,lynnwood,98037,3410,2016
snohomish,terrace park elementary,346,3,42,4,46,19,78,154,46,157,189,133,31015,mtlk terrace,98043,2888,2016
snohomish,unassigned,86,1,6,0,6,2,6,64,7,60,26,15,31015,lynnwood,98036,1558,2016
snohomish,westgate elementary,483,3,41,1,42,32,82,258,66,249,234,181,31015,edmonds,98020,3186,2016
spokane,structural alt confinement,20,1,0,0,0,2,1,16,0,15,5,28,32801,spokane,99205,3507,2016
clark,esd 112 open doors reengagement,87,2,0,1,1,2,20,57,5,47,40,0,06801,vancouver,98661,5398,2016
kittitas,ellensburg developmental preschool,43,0,0,1,1,4,11,26,1,26,17,1,19401,ellensburg,98926,1924,2016
kittitas,ellensburg high,977,10,16,3,19,10,133,791,14,482,495,279,19401,ellensburg,98926,2996,2016
kittitas,k-12 ellensburg learning center,26,0,2,0,2,0,0,24,0,15,11,4,19401,ellensburg,98926,5097,2016
kittitas,lincoln elementary,498,7,13,3,16,4,101,366,4,257,241,203,19401,ellensburg,98926,2741,2016
kittitas,morgan middle,710,5,12,1,13,10,131,538,13,362,348,263,19401,ellensburg,98926,2453,2016
kittitas,mt. stuart elementary,486,2,4,0,4,7,93,378,2,255,231,276,19401,ellensburg,98926,3596,2016
kittitas,valley view elementary,498,2,7,1,8,6,82,387,13,246,252,187,19401,ellensburg,98936,4411,2016
grays harbor,east grays harbor high,37,0,0,0,0,0,4,27,6,14,23,22,14068,elma,98541,1629,2016
grays harbor,elma elementary,613,14,5,0,5,3,157,397,37,314,299,413,14068,elma,98541,3217,2016
grays harbor,elma high,472,6,4,0,4,2,56,373,31,246,226,218,14068,elma,98541,2137,2016
grays harbor,elma middle,308,3,1,0,1,0,60,217,27,158,150,193,14068,elma,98541,4245,2016
whitman,endicott/st john elem and middle,102,0,0,0,0,0,2,97,3,60,42,64,38308,endicott,99125,2207,2016
chelan,entiat middle and high,179,0,2,2,4,1,65,100,9,94,85,104,04127,entiat,98822,3317,2016
chelan,paul rumburg elementary,163,0,0,0,0,0,67,94,2,91,72,114,04127,entiat,98822,2688,2016
king,black diamond elementary,295,3,0,2,2,0,58,208,24,149,146,97,17216,black diamond,98010,3430,2016
king,byron kibler elementary,425,2,3,5,8,3,87,306,19,215,210,183,17216,enumclaw,98022,2980,2016
king,enumclaw middle,424,9,1,2,3,5,44,351,12,221,203,146,17216,enumclaw,98022,4210,2016
king,enumclaw sr high,1388,22,9,3,12,9,169,1128,48,724,664,339,17216,enumclaw,98022,3330,2016
king,southwood elementary,305,1,4,0,4,5,37,245,13,150,155,100,17216,enumclaw,98022,3739,2016
king,special ed,23,0,1,0,1,0,2,18,2,19,4,16,17216,enumclaw,98022,1523,2016
king,sunrise elementary,421,1,3,3,6,3,67,330,14,218,203,150,17216,enumclaw,98022,4289,2016
king,thunder mountain middle,462,9,1,1,2,2,72,363,14,249,213,130,17216,enumclaw,98022,4550,2016
king,westwood elementary,319,6,2,0,2,4,57,236,14,176,143,92,17216,enumclaw,98022,3585,2016
grant,beezley springs elementary,10,0,0,0,0,0,2,8,0,9,1,13,13165,ephrata,98823,4229,2016
grant,columbia ridge elementary,476,0,0,1,1,1,180,286,8,244,232,338,13165,ephrata,98823,2793,2016
grant,ephrata high,713,2,7,0,7,1,210,480,13,359,354,304,13165,ephrata,98823,2920,2016
grant,ephrata middle,376,0,3,0,3,1,93,272,7,188,188,187,13165,ephrata,98823,3373,2016
grant,grant elementary,455,1,0,0,0,3,135,308,8,248,207,245,13165,ephrata,98823,3092,2016
grant,parkway,322,1,3,0,3,4,103,200,11,155,167,188,13165,ephrata,98823,2695,2016
lewis,evaline elementary,50,0,0,0,0,0,12,36,2,26,24,24,21036,winlock,98596,2355,2016
snohomish,cascade high,1839,17,230,18,248,89,351,1047,87,985,854,752,31002,everett,98203,3407,2016
snohomish,cedar wood elementary,685,1,199,3,202,13,57,359,53,349,336,86,31002,bothell,98012,4382,2016
snohomish,eisenhower middle,838,9,110,10,120,42,169,452,46,396,442,344,31002,everett,98208,3752,2016
snohomish,emerson elementary,617,1,73,5,78,31,226,238,43,302,315,430,31002,everett,98208,3184,2016
snohomish,everett high,1470,21,102,46,148,74,232,919,76,734,736,672,31002,everett,98201,2126,2016
snohomish,everett reengagement academy,30,0,3,0,3,1,7,18,1,12,18,37,31002,everett,98213,5330,2016
snohomish,evergreen middle,969,4,99,13,112,40,246,515,52,499,470,562,31002,everett,98203,3253,2016
snohomish,forest view elementary,682,1,151,0,151,17,48,420,45,334,348,62,31002,everett,98208,5091,2016
snohomish,garfield elementary,391,5,10,13,23,7,100,209,47,194,197,293,31002,everett,98201,2065,2016
snohomish,gateway middle,854,3,161,4,165,13,80,502,91,409,445,99,31002,everett,98208,4437,2016
snohomish,hawthorne elementary school - everett,472,0,33,45,78,34,151,175,34,246,226,419,31002,everett,98201,2883,2016
snohomish,heatherwood middle,956,3,181,4,185,29,140,523,76,484,472,266,31002,mill creek,98012,4334,2016
snohomish,henry m. jackson high,2203,12,419,6,425,69,242,1321,134,1082,1121,393,31002,mill creek,98012,4438,2016
snohomish,jackson elementary,372,3,9,2,11,19,86,212,41,184,188,254,31002,everett,98201,2751,2016
snohomish,jefferson elementary,563,1,60,1,61,29,98,346,28,266,297,224,31002,everett,98208,3533,2016
snohomish,lowell elementary - everett,509,4,42,3,45,18,152,232,58,255,254,372,31002,everett,98203,2811,2016
snohomish,madison elementary,458,3,32,8,40,25,184,179,27,231,227,345,31002,everett,98203,2669,2016
snohomish,mill creek elementary,663,2,129,1,130,23,67,380,61,362,301,90,31002,mill creek,98012,4316,2016
snohomish,monroe elementary,569,0,51,3,54,33,113,323,46,306,263,244,31002,everett,98208,3686,2016
snohomish,north middle,684,7,35,35,70,51,161,365,30,362,322,448,31002,everett,98201,2364,2016
snohomish,nw learning center,7,0,0,1,1,0,1,5,0,6,1,5,31002,everett,98213,1663,2016
snohomish,penny creek elementary,721,0,139,3,142,26,84,417,52,379,342,170,31002,everett,98208,4530,2016
snohomish,port gardner,130,0,2,0,2,0,9,109,10,64,66,15,31002,everett,98201,1907,2016
snohomish,sequoia high,214,5,3,4,7,12,40,136,14,95,119,130,31002,everett,98201,4137,2016
snohomish,silver firs elementary,519,2,68,4,72,16,80,308,41,291,228,106,31002,everett,98208,4298,2016
snohomish,silver lake elementary - everett,677,5,99,6,105,26,156,327,58,337,340,314,31002,everett,98208,2545,2016
snohomish,special services,146,0,11,2,13,8,16,90,19,93,53,34,31002,everett,98213,3903,2016
snohomish,view ridge elementary,569,1,33,1,34,18,78,407,31,280,289,223,31002,everett,98203,3002,2016
snohomish,whittier elementary,470,5,12,3,15,18,62,322,48,241,229,193,31002,everett,98201,2752,2016
snohomish,woodside elementary,680,0,68,2,70,16,180,338,76,356,324,240,31002,bothell,98012,4125,2016
clark,49th street academy,100,1,3,2,5,9,9,71,5,82,18,74,06114,vancouver,98682,1646,2016
clark,burnt bridge creek elementary,443,2,19,9,28,6,72,284,51,244,199,217,06114,vancouver,98682,4299,2016
clark,burton elementary,456,1,14,13,27,4,126,270,28,238,218,285,06114,vancouver,98682,3736,2016
clark,cascade middle,861,7,37,28,65,26,217,482,64,436,425,582,06114,vancouver,98684,3785,2016
clark,columbia valley elementary,552,0,57,3,60,20,91,328,53,293,259,222,06114,vancouver,98683,4587,2016
clark,covington middle,1021,3,39,22,61,32,269,599,57,542,479,644,06114,vancouver,98662,3320,2016
clark,crestline elementary,495,3,12,14,26,16,196,200,54,246,249,339,06114,vancouver,98683,3822,2016
clark,early childhood center,130,1,4,2,6,2,28,85,8,95,35,99,06114,vancouver,98682,1530,2016
clark,ellsworth elementary,449,2,14,3,17,11,157,211,51,225,224,279,06114,vancouver,98664,3148,2016
clark,endeavour elementary,693,0,31,14,45,22,192,378,56,359,334,417,06114,vancouver,98684,5136,2016
clark,evergreen high,1796,15,75,60,135,74,336,1109,125,923,873,869,06114,vancouver,98684,2724,2016
clark,fircrest elementary,447,3,22,17,39,8,85,269,43,225,222,315,06114,vancouver,98684,3971,2016
clark,fishers landing elementary,644,0,121,1,122,11,68,381,62,337,307,132,06114,vancouver,98683,4499,2016
clark,frontier middle,794,5,58,16,74,15,138,516,46,420,374,367,06114,vancouver,98682,4498,2016
clark,harmony elementary,671,1,40,12,52,23,66,468,61,350,321,169,06114,vancouver,98684,4380,2016
clark,hearthwood elementary,435,0,16,5,21,9,75,286,44,223,212,244,06114,vancouver,98684,4163,2016
clark,heritage high,1882,21,83,41,124,45,395,1199,98,976,906,898,06114,vancouver,98682,4523,2016
clark,home choice academy,116,0,4,0,4,0,8,91,13,60,56,28,06114,vancouver,98682,1926,2016
clark,illahee elementary,598,1,102,5,107,9,71,353,57,286,312,155,06114,camas,98607,4560,2016
clark,image elementary,690,0,33,10,43,11,137,428,71,345,345,415,06114,vancouver,98682,3994,2016
clark,legacy high,240,4,4,2,6,3,42,162,23,107,133,118,06114,vancouver,98684,4042,2016
clark,marrion elementary,550,1,13,6,19,8,203,265,54,289,261,377,06114,vancouver,98664,3618,2016
clark,mill plain elementary,497,6,9,25,34,17,130,259,51,250,247,308,06114,vancouver,98684,2829,2016
clark,mountain view high,1862,12,188,26,214,68,390,1022,156,1004,858,670,06114,vancouver,98683,4162,2016
clark,orchards elementary,581,5,15,17,32,13,158,323,50,322,259,443,06114,vancouver,98662,2912,2016
clark,pacific middle,1032,7,67,17,84,24,155,682,80,537,495,385,06114,vancouver,98684,4209,2016
clark,pioneer elementary,714,1,35,19,54,17,212,388,42,369,345,381,06114,vancouver,98682,4445,2016
clark,riverview elementary,494,3,21,5,26,13,110,273,69,251,243,229,06114,vancouver,98684,3995,2016
clark,shahala middle,1115,1,189,6,195,41,151,631,96,577,538,279,06114,vancouver,98683,4561,2016
clark,sifton elementary,485,0,16,12,28,7,115,293,42,230,255,286,06114,vancouver,98682,3149,2016
clark,silver star elementary,480,1,11,13,24,3,81,324,47,247,233,271,06114,vancouver,98662,3823,2016
clark,sunset elementary,551,6,22,11,33,15,102,351,44,288,263,318,06114,vancouver,98662,3970,2016
clark,union high,2075,13,219,21,240,56,247,1380,138,1096,979,527,06114,camas,98607,5111,2016
clark,wyeast middle,878,8,28,15,43,30,262,473,62,460,418,490,06114,vancouver,98683,4051,2016
clark,york elementary,542,4,23,0,23,7,88,373,47,283,259,221,06114,vancouver,98682,4579,2016
stevens,evergreen,25,6,0,0,0,0,0,19,0,14,11,19,33205,gifford,99131,3197,2016
king,adelaide elementary,379,0,27,30,57,36,125,108,53,213,166,254,17210,federal way,98023,3519,2016
king,birth to three development center,71,0,7,4,11,5,15,30,10,46,25,49,17210,federal way,98093,5279,2016
king,brigadoon elementary,351,0,17,8,25,49,102,124,51,174,177,203,17210,federal way,98023,3700,2016
king,camelot elementary,324,1,39,13,52,21,53,147,50,165,159,204,17210,auburn,98001,3547,2016
king,career academy at truman high,110,2,7,7,14,13,32,41,8,52,58,81,17210,federal way,98003,5163,2016
king,decatur high,1406,6,143,63,206,210,318,530,136,742,664,601,17210,federal way,98023,3766,2016
king,employment transition program,40,0,4,2,6,5,5,18,6,28,12,33,17210,federal way,98023,1950,2016
king,enterprise elementary,479,3,69,26,95,57,107,149,68,260,219,262,17210,federal way,98023,4470,2016
king,federal way high,1611,14,161,127,288,255,473,404,177,839,772,871,17210,federal way,98003,2417,2016
king,federal way public academy,303,0,69,5,74,19,39,133,38,143,160,80,17210,federal way,98003,1789,2016
king,federal way public school eceap,7,0,1,0,1,0,1,2,3,6,1,9,17210,federal way,98003,5218,2016
king,federal way public schools headstart,7,0,0,1,1,1,3,1,1,5,2,3,17210,federal way,98003,5219,2016
king,gateway to college,39,0,1,4,5,4,13,15,2,29,10,17,17210,federal way,98003,5255,2016
king,green gables elementary,416,2,34,11,45,43,59,201,66,209,207,145,17210,federal way,98023,4426,2016
king,illahee middle,763,2,126,38,164,83,161,248,105,387,376,382,17210,federal way,98003,3898,2016
king,internet academy,271,2,16,1,17,21,31,174,26,107,164,92,17210,federal way,98003,1759,2016
king,kilo middle,551,3,54,19,73,41,172,196,66,267,284,350,17210,auburn,98001,3701,2016
king,lake dolloff elementary,432,5,61,11,72,67,84,133,71,233,199,294,17210,auburn,98001,3738,2016
king,lake grove elementary,401,5,20,22,42,50,140,104,60,198,203,326,17210,federal way,98023,3568,2016
king,lakeland elementary,410,5,41,12,53,32,58,217,45,194,216,208,17210,auburn,98001,2841,2016
king,lakota middle,769,7,82,41,123,99,182,266,92,403,366,402,17210,federal way,98023,3381,2016
king,mark twain elementary,582,1,54,57,111,110,264,48,48,281,301,441,17210,federal way,98003,3627,2016
king,meredith hill elementary,444,1,69,8,77,25,100,198,43,233,211,196,17210,auburn,98001,4480,2016
king,mirror lake elementary,436,3,36,34,70,87,164,67,45,208,228,346,17210,federal way,98003,3159,2016
king,nautilus k-8,503,2,43,28,71,47,145,168,70,245,258,301,17210,federal way,98003,3625,2016
king,olympic view elementary,416,1,16,20,36,47,227,57,48,223,193,358,17210,federal way,98023,3432,2016
king,open doors youth reengagement (1418),217,2,13,11,24,45,64,63,19,112,105,111,17210,federal way,98003,5348,2016
king,panther lake elementary,459,6,56,51,107,68,121,84,73,240,219,321,17210,federal way,98003,3329,2016
king,rainier view elementary,513,1,25,13,38,114,125,145,90,266,247,390,17210,federal way,98003,4422,2016
king,sacajawea middle,735,3,89,47,136,80,235,187,94,389,346,439,17210,federal way,98003,3626,2016
king,sequoyah middle,639,5,71,21,92,106,135,214,87,320,319,396,17210,auburn,98001,5029,2016
king,sherwood forest elementary,460,1,81,18,99,33,101,158,68,229,231,209,17210,federal way,98023,4374,2016
king,silver lake elementary school - federal way,398,0,40,36,76,55,125,84,58,203,195,278,17210,federal way,98023,4343,2016
king,star lake elementary,447,4,51,20,71,64,110,120,78,255,192,257,17210,kent,98031,3160,2016
king,sunnycrest elementary,577,4,41,34,75,71,258,81,88,296,281,568,17210,kent,98032,3567,2016
king,support,61,0,3,1,4,8,10,17,22,41,20,27,17210,federal way,98003,1951,2016
king,thomas jefferson high,1798,7,360,34,394,182,469,598,148,909,889,940,17210,auburn,98001,3584,2016
king,todd beamer high,1716,15,251,67,318,246,306,627,204,886,830,804,17210,federal way,98003,4570,2016
king,totem middle,652,3,83,49,132,100,234,106,77,309,343,498,17210,kent,98031,3431,2016
king,twin lakes elementary,392,0,16,28,44,62,88,134,64,221,171,250,17210,federal way,98023,3628,2016
king,valhalla elementary,573,3,69,16,85,39,253,129,64,275,298,431,17210,auburn,98001,3582,2016
king,wildwood elementary,490,0,23,35,58,49,276,59,48,260,230,456,17210,federal way,98003,3583,2016
king,woodmont k-8,475,4,62,10,72,65,127,155,52,229,246,268,17210,des moines,98198,3328,2016
whatcom,beach elem,30,0,0,0,0,0,2,27,1,15,15,9,37502,lummi island,98262,2263,2016
whatcom,cascadia elementary,470,7,30,1,31,1,115,292,24,236,234,202,37502,ferndale,98248,5207,2016
whatcom,central elementary,328,3,8,2,10,1,68,213,33,169,159,163,37502,ferndale,98248,2458,2016
whatcom,custer elem,340,5,4,0,4,3,65,254,9,161,179,161,37502,custer,98240,2607,2016
whatcom,eagleridge elementary,477,103,8,0,8,4,89,238,35,246,231,291,37502,ferndale,98248,4482,2016
whatcom,ferndale high,1450,88,54,0,54,10,257,955,86,759,691,473,37502,ferndale,98248,2488,2016
whatcom,ferndale special services,29,6,3,0,3,0,7,11,2,15,14,0,37502,ferndale,98248,5084,2016
whatcom,horizon middle,477,58,15,0,15,7,90,280,27,256,221,221,37502,ferndale,98248,4554,2016
whatcom,skyline elementary,430,81,7,0,7,6,60,247,29,220,210,169,37502,ferndale,98248,4130,2016
whatcom,vista middle,622,52,28,4,32,9,113,384,32,315,307,263,37502,ferndale,98248,3762,2016
whatcom,windward high,136,7,2,0,2,2,14,104,7,59,77,41,37502,ferndale,98248,5245,2016
pierce,columbia junior high,552,5,53,16,69,18,99,294,67,289,263,217,27417,tacoma,98424,4582,2016
pierce,discovery primary,627,5,37,37,74,17,121,310,100,348,279,288,27417,milton,98354,2878,2016
pierce,endeavour intermediate,557,3,43,27,70,23,139,249,73,279,278,292,27417,milton,98354,2809,2016
pierce,fife high,837,11,69,35,104,31,154,437,100,424,413,273,27417,tacoma,98424,2773,2016
pierce,hedden elementary,544,2,43,14,57,24,95,294,72,272,272,224,27417,edgewood,98372,4557,2016
pierce,surprise lake middle,580,6,45,21,66,25,124,298,61,282,298,244,27417,milton,98354,3798,2016
benton,finley elementary,380,0,0,0,0,0,167,201,12,209,171,291,03053,kennewick,99337,3078,2016
benton,finley middle,212,1,1,0,1,1,91,115,3,105,107,160,03053,kennewick,99337,4031,2016
benton,river view high,320,2,1,0,1,3,137,163,14,172,148,221,03053,kennewick,99337,2367,2016
pierce,brookdale elementary,496,4,28,43,71,34,111,184,92,244,252,405,27402,tacoma,98444,3180,2016
pierce,central avenue elementary,460,2,38,6,44,20,96,222,76,242,218,319,27402,tacoma,98446,2398,2016
pierce,christensen elementary,457,1,23,36,59,83,131,112,71,210,247,384,27402,tacoma,98444,3301,2016
pierce,collins elementary,405,4,28,8,36,16,93,203,53,211,194,228,27402,tacoma,98446,2257,2016
pierce,elmhurst elementary,446,4,21,25,46,55,78,157,106,246,200,337,27402,tacoma,98445,3532,2016
pierce,franklin pierce high,1201,10,108,39,147,112,254,560,118,597,604,678,27402,tacoma,98445,2876,2016
pierce,gates secondary,157,4,5,12,17,12,37,66,21,69,88,111,27402,tacoma,98444,4063,2016
pierce,harvard elementary,392,0,31,9,40,19,230,57,46,225,167,348,27402,tacoma,98445,3000,2016
pierce,james sales elementary,458,6,14,31,45,45,150,130,82,240,218,397,27402,tacoma,98444,2945,2016
pierce,learning support,79,0,4,3,7,5,29,32,6,60,19,102,27402,tacoma,98444,5129,2016
pierce,midland elementary,544,4,37,29,66,60,150,169,95,266,278,433,27402,tacoma,98445,2340,2016
pierce,morris ford middle,925,3,74,25,99,69,252,387,115,486,439,680,27402,tacoma,98445,3300,2016
pierce,perry g keithley middle,737,7,27,55,82,100,204,240,104,351,386,586,27402,tacoma,98444,3401,2016
pierce,washington high,983,6,65,104,169,162,192,338,116,516,467,697,27402,tacoma,98444,3648,2016
spokane,freeman elementary,336,3,2,0,2,3,9,312,7,179,157,96,32358,rockford,99030,3794,2016
spokane,freeman high,330,4,5,0,5,7,22,282,9,165,165,56,32358,rockford,99030,3192,2016
spokane,freeman middle,150,0,5,1,6,2,8,132,2,71,79,32,32358,rockford,99030,4593,2016
whitman,garfield at palouse high,28,2,0,0,0,0,2,22,2,15,13,11,38302,palouse,99161,1962,2016
whitman,garfield elementary,58,0,0,0,0,0,1,57,0,35,23,29,38302,garfield,99130,2895,2016
whitman,garfield middle,30,0,0,0,0,0,3,26,1,15,15,13,38302,garfield,99130,2896,2016
klickitat,glenwood elementary,36,0,0,0,0,0,5,25,6,18,18,19,20401,glenwood,98619,3047,2016
klickitat,glenwood secondary,30,0,0,0,0,0,2,23,5,15,15,6,20401,glenwood,98619,3048,2016
klickitat,goldendale high,303,14,3,1,4,0,47,226,10,176,127,137,20404,goldendale,98620,2856,2016
klickitat,goldendale middle,212,9,3,0,3,2,29,160,9,123,89,119,20404,goldendale,98620,3393,2016
klickitat,goldendale primary,342,13,1,1,2,3,47,253,24,162,180,222,20404,goldendale,98620,2677,2016
klickitat,goldendale support service center,16,1,1,0,1,0,2,12,0,11,5,1,20404,goldendale,98620,5012,2016
grant,lake roosevelt elementary,397,130,1,2,3,1,43,114,106,208,189,271,13301,coulee dam,99116,2802,2016
grant,lake roosevelt jr/sr high,322,147,3,1,4,3,32,84,52,172,150,198,13301,coulee dam,99116,2801,2016
yakima,contract learning center,50,0,0,0,0,0,39,10,1,18,32,31,39200,grandview,98930,1776,2016
yakima,grandview high,858,0,1,0,1,0,780,73,4,398,460,571,39200,grandview,98930,2555,2016
yakima,grandview middle,827,1,1,0,1,0,774,47,4,403,424,673,39200,grandview,98930,3071,2016
yakima,mcclure elementary,671,0,0,0,0,1,627,42,1,348,323,588,39200,grandview,98930,2345,2016
yakima,smith elementary,593,0,1,0,1,0,558,33,1,315,278,520,39200,grandview,98930,3013,2016
yakima,thompson elementary,587,0,0,0,0,0,517,69,1,296,291,499,39200,grandview,98930,2756,2016
yakima,granger high,442,11,0,0,0,0,405,17,9,239,203,362,39204,granger,98932,3314,2016
yakima,granger middle,466,14,0,0,0,0,436,15,1,244,222,427,39204,granger,98932,2531,2016
yakima,roosevelt elementary,618,17,0,0,0,2,575,18,6,320,298,574,39204,granger,98932,4535,2016
snohomish,crossroads high,161,7,0,0,0,3,23,116,12,82,79,96,31332,granite falls,98252,5171,2016
snohomish,granite falls high,573,8,6,3,9,3,46,489,18,298,275,170,31332,granite falls,98252,2580,2016
snohomish,granite falls middle,408,2,3,1,4,7,29,346,20,213,195,168,31332,granite falls,98252,4113,2016
snohomish,granite falls open doors,61,1,0,0,0,0,10,43,7,35,26,47,31332,granite falls,98252,5349,2016
snohomish,monte cristo elementary,318,12,3,1,4,2,35,235,30,176,142,162,31332,granite falls,98252,4479,2016
snohomish,mountain way elementary,522,9,3,1,4,9,55,432,13,264,258,267,31332,granite falls,98252,4330,2016
mason,grapeview elementary & middle,229,4,2,0,2,2,12,191,18,123,106,94,23054,grapeview,98546,2145,2016
spokane,great northern elementary,48,3,5,0,5,0,2,38,0,28,20,1,32312,spokane,99224,2097,2016
clark,green mountain,159,1,0,0,0,1,4,153,0,73,86,53,06103,woodland,98674,2484,2016
thurston,griffin,659,14,16,1,17,12,61,509,46,328,331,126,34324,olympia,98502,2406,2016
lincoln,harrington elementary,44,0,0,0,0,0,1,37,6,27,17,17,22204,harrington,99134,2743,2016
lincoln,harrington high,45,1,0,0,0,0,2,39,3,24,21,24,22204,harrington,99134,3113,2016
yakima,highland high,365,2,2,0,2,3,251,96,11,198,167,258,39203,cowiche,98923,4559,2016
yakima,highland junior high,168,1,1,0,1,1,119,42,4,85,83,136,39203,cowiche,98923,2718,2016
yakima,marcus whitman-cowiche elementary,356,1,1,0,1,0,276,75,3,198,158,295,39203,cowiche,98923,3072,2016
yakima,tieton intermediate,279,1,0,0,0,1,214,55,8,133,146,245,39203,tieton,98947,3073,2016
king,beverly park elem at glendale,444,10,56,22,78,72,198,57,29,230,214,352,17401,seattle,98168,2765,2016
king,big picture,188,3,6,3,9,9,69,87,11,92,96,100,17401,burien,98148,5028,2016
king,bow lake elementary,723,1,101,56,157,174,269,81,41,359,364,606,17401,seatac,98188,2982,2016
king,cascade middle,570,8,118,29,147,75,259,55,26,299,271,454,17401,seattle,98146,3163,2016
king,cedarhurst elementary,615,1,117,33,150,51,278,100,35,305,310,487,17401,burien,98168,2926,2016
king,chinook middle,608,3,110,37,147,103,246,78,31,304,304,491,17401,seatac,98188,3098,2016
king,choice academy,139,0,8,1,9,10,33,77,10,57,82,41,17401,seattle,98148,1539,2016
king,des moines elementary,387,3,43,8,51,59,80,158,36,194,193,193,17401,des moines,98198,2418,2016
king,gregory heights elementary,671,3,55,26,81,43,240,267,37,357,314,358,17401,burien,98166,2844,2016
king,hazel valley elementary,677,12,101,20,121,63,340,92,49,344,333,561,17401,burien,98146,2699,2016
king,highline high,1253,13,177,59,236,96,518,324,66,642,611,750,17401,burien,98148,2325,2016
king,highline home school center,16,0,2,0,2,0,1,13,0,11,5,3,17401,burien,98148,5371,2016
king,hilltop elementary,630,2,109,38,147,42,333,67,39,332,298,525,17401,seattle,98168,3165,2016
king,madrona elementary,702,1,45,41,86,159,377,50,29,380,322,575,17401,seatac,98198,3278,2016
king,marvista elementary,625,8,46,10,56,84,123,325,29,317,308,247,17401,normandy park,98166,3097,2016
king,mcmicken heights elementary,533,1,88,44,132,124,157,95,24,286,247,418,17401,seatac,98188,2734,2016
king,midway elementary,661,7,65,49,114,98,337,60,45,342,319,495,17401,des moines,98198,2984,2016
king,mount rainier high,1638,11,223,58,281,191,427,603,125,822,816,767,17401,des moines,98198,3279,2016
king,mount view elementary,658,4,99,17,116,54,406,60,18,339,319,502,17401,seattle,98146,2144,2016
king,new start,131,0,3,5,8,15,65,29,14,78,53,69,17401,seattle,98146,1972,2016
king,north hill elementary,602,8,45,8,53,63,123,273,82,306,296,298,17401,des moines,98148,2983,2016
king,pacific middle,650,6,67,39,106,70,201,204,63,356,294,389,17401,des moines,98198,3333,2016
king,parkside elementary,628,2,81,37,118,102,174,179,53,337,291,392,17401,des moines,98198,3335,2016
king,puget sound high,84,1,6,1,7,12,32,24,8,40,44,69,17401,burien,98148,5172,2016
king,raisbeck aviation high,417,1,75,1,76,25,38,259,18,263,154,44,17401,tukwila,98108,3553,2016
king,seahurst elementary,596,7,55,6,61,65,310,109,44,298,298,469,17401,burien,98166,3382,2016
king,shorewood elementary,574,5,99,8,107,52,144,219,47,305,269,307,17401,burien,98146,2842,2016
king,southern heights elementary,317,5,62,14,76,26,147,31,32,186,131,257,17401,seattle,98168,3032,2016
king,sylvester middle,693,8,132,21,153,53,294,147,38,370,323,471,17401,burien,98166,2927,2016
king,valley view early childhood center,216,2,24,5,29,42,69,63,11,151,65,102,17401,seatac,98188,5119,2016
king,white center heights elementary,617,8,158,21,179,137,194,74,25,314,303,495,17401,seattle,98146,2639,2016
clark,hockinson heights elementary,764,1,18,1,19,5,40,666,33,388,376,160,06098,brush prairie,98606,5311,2016
clark,hockinson high,670,4,16,0,16,6,29,605,10,365,305,103,06098,brush prairie,98606,4568,2016
clark,hockinson middle,440,3,10,0,10,2,18,400,7,214,226,83,06098,brush prairie,98606,3319,2016
grays harbor,central elementary,242,16,3,0,3,2,40,171,10,129,113,155,14028,hoquiam,98550,2972,2016
grays harbor,emerson elementary,244,16,1,0,1,7,51,160,9,126,118,169,14028,hoquiam,98550,2268,2016
grays harbor,hoquiam high,490,27,6,0,6,9,89,333,26,240,250,240,14028,hoquiam,98550,3622,2016
grays harbor,hoquiam homelink,89,4,0,0,0,3,13,68,1,45,44,66,14028,hoquiam,98550,5191,2016
grays harbor,hoquiam middle,369,24,2,1,3,6,54,265,17,191,178,238,14028,hoquiam,98550,2391,2016
grays harbor,lincoln elementary,262,16,0,0,0,3,50,178,15,136,126,177,14028,hoquiam,98550,3621,2016
ferry,inchelium elementary,105,83,0,0,0,0,1,1,20,44,61,83,10070,inchelium,99138,4215,2016
ferry,inchelium high,62,50,2,0,2,0,0,3,7,33,29,48,10070,inchelium,99138,2603,2016
ferry,inchelium middle,46,36,0,0,0,0,1,2,7,24,22,34,10070,inchelium,99138,4214,2016
snohomish,index elementary,43,0,0,0,0,0,0,40,3,20,23,17,31063,index,98256,2948,2016
king,apollo elementary,624,0,197,1,198,9,66,296,55,315,309,91,17411,renton,98059,3746,2016
king,beaver lake middle,867,1,275,3,278,6,51,479,52,455,412,42,17411,issaquah,98029,4460,2016
king,briarwood elementary,631,0,129,6,135,10,46,381,59,310,321,80,17411,renton,98059,3440,2016
king,cascade ridge elementary,542,0,186,0,186,4,28,282,42,289,253,2,17411,sammamish,98075,4565,2016
king,challenger elementary,584,0,170,2,172,6,54,294,58,297,287,29,17411,issaquah,98029,4300,2016
king,clark elementary,677,2,149,0,149,11,90,356,69,355,322,124,17411,issaquah,98027,2738,2016
king,cougar ridge elementary,586,1,205,0,205,6,31,292,51,308,278,10,17411,bellevue,98006,4375,2016
king,creekside elementary,716,0,193,2,195,4,42,430,45,359,357,14,17411,sammamish,98075,5201,2016
king,discovery elementary,563,0,274,0,274,2,38,218,31,276,287,8,17411,issaquah,98075,4376,2016
king,endeavour elementary,686,1,235,0,235,3,49,354,44,339,347,50,17411,issaquah,98029,4493,2016
king,grand ridge elementary,772,0,267,0,267,17,43,380,65,405,367,41,17411,issaquah,98029,5056,2016
king,issaquah high,2232,8,483,6,489,33,171,1411,120,1149,1083,170,17411,issaquah,98027,3385,2016
king,issaquah middle,763,4,136,1,137,18,79,474,51,358,405,98,17411,issaquah,98027,3038,2016
king,issaquah special services,94,0,17,0,17,1,12,58,6,53,41,0,17411,issaquah,98027,1624,2016
king,issaquah valley elementary,640,0,68,0,68,12,101,399,60,315,325,127,17411,issaquah,98027,3673,2016
king,liberty sr high,1284,5,212,7,219,24,128,851,57,646,638,131,17411,renton,98059,3962,2016
king,maple hills elementary,407,1,2,1,3,7,29,327,40,204,203,34,17411,renton,98059,3637,2016
king,maywood middle,1079,1,227,6,233,23,103,650,69,522,557,137,17411,renton,98059,3636,2016
king,newcastle elementary,586,0,167,1,168,9,46,284,79,291,295,26,17411,newcastle,98059,4592,2016
king,pacific cascade middle,975,1,294,4,298,24,56,539,57,486,489,64,17411,issaquah,98029,5200,2016
king,pine lake middle,911,1,319,4,323,13,55,479,40,466,445,35,17411,sammamish,98075,3879,2016
king,skyline high,2172,6,611,8,619,36,131,1293,87,1140,1032,84,17411,sammamish,98075,4495,2016
king,sunny hills elementary,606,0,180,4,184,7,40,317,58,315,291,28,17411,sammamish,98075,3386,2016
king,sunset elementary,653,2,130,1,131,14,44,414,48,337,316,40,17411,bellevue,98008,3228,2016
franklin,kahlotus elem & high,46,0,0,0,0,0,14,30,2,20,26,38,11056,kahlotus,99335,3214,2016
cowlitz,kalama elem,437,3,6,2,8,1,25,398,2,227,210,169,08402,kalama,98625,2915,2016
ferry,keller elementary,31,30,0,0,0,0,0,0,1,14,17,24,10003,keller,99140,2602,2016
cowlitz,barnes elementary,365,1,1,5,6,1,76,270,11,184,181,284,08458,kelso,98626,3323,2016
cowlitz,beacon hill elementary,551,0,4,2,6,0,82,429,34,263,288,275,08458,longview,98632,3578,2016
cowlitz,butler acres elementary,383,5,4,1,5,0,43,303,27,189,194,192,08458,kelso,98626,3082,2016
cowlitz,carrolls elementary,149,4,7,0,7,0,9,119,10,72,77,61,08458,carrolls,98609,2913,2016
cowlitz,catlin elementary,302,2,0,5,5,0,50,219,26,171,131,234,08458,kelso,98626,2691,2016
cowlitz,coweeman middle,555,17,7,5,12,2,85,406,33,254,301,276,08458,kelso,98626,3322,2016
cowlitz,huntington middle,548,7,5,4,9,1,97,397,37,271,277,290,08458,kelso,98626,2916,2016
cowlitz,kelso high,1571,28,21,9,30,9,238,1152,114,787,784,692,08458,kelso,98626,2266,2016
cowlitz,kelso virtual academy,26,1,0,0,0,0,5,15,5,9,17,27,08458,kelso,98626,5194,2016
cowlitz,loowit high,33,0,1,0,1,0,5,25,2,11,22,24,08458,kelso,98626,1934,2016
cowlitz,rose valley elementary,132,2,0,1,1,2,9,116,2,60,72,40,08458,kelso,98626,2596,2016
cowlitz,special education,11,1,0,0,0,0,1,9,0,5,6,13,08458,kelso,98626,5076,2016
cowlitz,wallace elementary,376,0,1,15,16,3,132,196,29,202,174,351,08458,kelso,98626,2624,2016
benton,canyon view elementary,632,1,1,1,2,13,257,329,30,329,303,454,03017,kennewick,99337,4072,2016
benton,cascade elementary,590,0,1,0,1,3,111,443,32,318,272,279,03017,kennewick,99337,4202,2016
benton,cottonwood elementary,715,2,11,1,12,12,57,607,25,372,343,138,03017,kennewick,99338,5220,2016
benton,desert hills middle,989,8,26,1,27,13,142,766,33,504,485,269,03017,kennewick,99338,4028,2016
benton,eastgate elementary,551,1,3,0,3,4,417,117,9,301,250,532,03017,kennewick,99336,2824,2016
benton,edison elementary school - kennewick,637,6,3,1,4,13,344,248,22,306,331,532,03017,kennewick,99336,3315,2016
benton,hawthorne elementary school - kennewick,557,1,4,4,8,12,309,202,25,267,290,441,03017,kennewick,99336,3077,2016
benton,highlands middle,947,5,18,8,26,23,481,382,30,499,448,758,03017,kennewick,99336,3267,2016
benton,horse heaven hills middle,975,3,7,4,11,11,261,643,46,513,462,489,03017,kennewick,99337,4429,2016
benton,kamiakin high,1778,11,48,4,52,34,441,1210,30,933,845,630,03017,kennewick,99336,3731,2016
benton,keewaydin discovery center,169,0,3,1,4,1,57,99,8,113,56,133,03017,kennewick,99336,2000,2016
benton,kennewick high,1563,15,47,1,48,36,749,679,36,865,698,1051,03017,kennewick,99336,2826,2016
benton,legacy high,236,0,0,0,0,2,83,145,6,133,103,138,03017,kennewick,99336,1884,2016
benton,lincoln elementary,563,0,10,2,12,16,140,369,26,303,260,314,03017,kennewick,99338,4181,2016
benton,mid-columbia parent partnership,299,2,4,0,4,1,28,261,3,159,140,86,03017,kennewick,99336,1941,2016
benton,park middle,865,3,42,0,42,39,560,201,20,469,396,782,03017,kennewick,99336,3472,2016
benton,phoenix high,56,0,0,0,0,0,19,37,0,25,31,35,03017,kennewick,99338,5106,2016
benton,ridge view elementary,565,1,19,0,19,5,81,422,37,286,279,161,03017,kennewick,99338,4446,2016
benton,southgate elementary,623,1,13,1,14,12,161,406,29,331,292,321,03017,kennewick,99337,4073,2016
benton,southridge high,1680,8,29,4,33,30,522,1053,34,826,854,809,03017,kennewick,99338,4484,2016
benton,sunset view elementary,546,3,17,0,17,20,112,372,22,264,282,265,03017,kennewick,99336,4136,2016
benton,vista elementary,594,1,8,0,8,8,203,335,39,298,296,452,03017,kennewick,99336,3369,2016
benton,washington elementary,523,1,3,0,3,13,288,200,18,265,258,403,03017,kennewick,99337,3144,2016
benton,westgate elementary,499,2,41,5,46,43,198,197,13,264,235,478,03017,kennewick,99336,2825,2016
king,birth to age 2,116,2,12,2,14,15,28,43,14,61,55,0,17415,kent,98030,5150,2016
king,carriage crest elementary,423,2,83,4,87,27,54,204,49,214,209,99,17415,renton,98058,4353,2016
king,cedar heights middle,674,7,38,15,53,54,111,390,59,360,314,256,17415,covington,98042,4440,2016
king,cedar valley elementary,309,6,6,2,8,23,96,149,27,177,132,190,17415,covington,98042,3676,2016
king,covington elementary,507,5,68,0,68,30,124,240,40,278,229,236,17415,covington,98042,3388,2016
king,crestwood elementary,487,3,31,0,31,16,68,318,51,250,237,113,17415,covington,98042,4126,2016
king,east hill elementary,589,0,113,19,132,116,169,104,68,296,293,381,17415,kent,98031,2851,2016
king,emerald park elementary,494,2,152,12,164,78,76,121,53,248,246,258,17415,kent,98031,4545,2016
king,fairwood elementary,424,0,44,1,45,49,82,180,68,209,215,161,17415,renton,98058,3678,2016
king,george t. daniel elementary,533,0,73,11,84,113,181,105,50,291,242,398,17415,kent,98030,4413,2016
king,glenridge elementary,449,1,143,11,154,84,57,113,40,216,233,258,17415,kent,98031,4489,2016
king,grass lake elementary,412,2,20,1,21,12,64,284,29,210,202,118,17415,kent,98042,3708,2016
king,horizon elementary,449,2,67,11,78,46,73,201,49,224,225,200,17415,kent,98042,4345,2016
king,igrad,406,2,41,9,50,56,104,154,40,226,180,190,17415,kent,98030,5275,2016
king,jenkins creek elementary,421,2,24,6,30,19,80,240,50,225,196,170,17415,covington,98042,4301,2016
king,kent elementary,703,1,60,59,119,61,378,93,51,368,335,555,17415,kent,98032,4520,2016
king,kent mountain view academy,311,1,59,4,63,25,47,137,38,147,164,99,17415,des moines,98198,3014,2016
king,kent phoenix academy,302,4,17,4,21,49,69,125,34,133,169,144,17415,kent,98030,5098,2016
king,kent-meridian high,2166,3,446,103,549,415,573,472,154,1128,1038,1353,17415,kent,98030,2797,2016
king,kentlake high,1497,9,116,27,143,97,243,882,123,775,722,499,17415,kent,98042,4492,2016
king,kentridge high,2238,10,555,37,592,237,252,923,224,1129,1109,653,17415,kent,98031,3640,2016
king,kentwood high,2024,11,451,39,490,178,362,808,175,1077,947,718,17415,covington,98042,4128,2016
king,lake youngs elementary,523,1,111,2,113,28,77,249,55,274,249,134,17415,kent,98042,3550,2016
king,martin sortun elementary,677,0,230,15,245,91,106,186,49,340,337,328,17415,kent,98030,4294,2016
king,mattson middle,621,4,87,10,97,41,110,311,58,324,297,257,17415,covington,98042,4127,2016
king,meadow ridge elementary,582,4,143,24,167,107,126,126,52,330,252,428,17415,kent,98030,4465,2016
king,meeker middle,630,0,159,14,173,112,120,180,45,353,277,399,17415,renton,98058,3764,2016
king,meridian elementary,632,0,112,6,118,49,114,284,67,339,293,308,17415,kent,98042,2565,2016
king,meridian middle,624,2,162,26,188,87,133,160,54,329,295,353,17415,kent,98031,3233,2016
king,mill creek middle,820,5,146,39,185,145,291,146,48,419,401,606,17415,kent,98032,5016,2016
king,millennium elementary,566,1,100,17,117,95,140,170,43,293,273,423,17415,kent,98030,4581,2016
king,neely o brien elementary,753,2,141,33,174,115,239,117,106,409,344,492,17415,kent,98032,4356,2016
king,northwood middle,642,5,136,7,143,69,64,275,86,314,328,183,17415,renton,98058,4485,2016
king,panther lake elementary,654,0,127,21,148,88,188,142,88,343,311,462,17415,kent,98031,5178,2016
king,park orchard elementary,548,2,108,9,117,82,200,97,50,296,252,387,17415,kent,98031,3491,2016
king,pine tree elementary,491,3,64,29,93,98,115,123,59,269,222,332,17415,kent,98030,3593,2016
king,regional justice center,8,0,0,0,0,6,1,0,1,8,0,11,17415,kent,98030,1807,2016
king,ridgewood elementary,506,1,115,4,119,35,48,229,74,265,241,88,17415,renton,98058,4293,2016
king,sawyer woods elementary,447,0,21,6,27,6,39,320,55,239,208,120,17415,black diamond,98010,4466,2016
king,scenic hill elementary,618,4,36,12,48,118,276,113,59,318,300,411,17415,kent,98030,3389,2016
king,soos creek elementary,363,0,75,15,90,45,62,124,42,193,170,170,17415,kent,98031,3707,2016
king,springbrook elementary,534,3,88,32,120,77,217,88,29,280,254,403,17415,kent,98031,3677,2016
king,sunrise elementary,563,0,186,7,193,51,72,179,68,291,272,196,17415,kent,98042,4420,2016
stevens,columbia virtual academy - kettle falls,204,4,5,0,5,5,23,158,9,82,122,27,33212,kettle falls,99141,5180,2016
stevens,kettle falls elementary,279,4,2,0,2,2,12,246,13,142,137,177,33212,kettle falls,99141,2385,2016
stevens,kettle falls high,216,5,2,2,4,2,12,188,5,118,98,104,33212,kettle falls,99141,4206,2016
stevens,kettle falls middle,213,3,1,0,1,0,10,195,4,104,109,129,33212,kettle falls,99141,3198,2016
benton,kiona-benton city high,477,0,1,0,1,4,156,307,9,254,223,253,03052,benton city,99320,2904,2016
benton,kiona-benton city middle,333,2,2,0,2,0,135,188,6,176,157,211,03052,benton city,99320,3961,2016
benton,kiona-benton city primary,356,0,1,0,1,0,146,200,9,201,155,260,03052,benton city,99320,2759,2016
benton,kiona-benton intermediate,316,1,0,0,0,0,131,177,7,151,165,237,03052,benton city,99320,4217,2016
kittitas,kittitas b-5 special ed program,7,0,0,0,0,0,2,5,0,4,3,4,19403,kittitas,98934,5086,2016
kittitas,kittitas elementary,267,0,1,0,1,0,55,206,5,122,145,133,19403,kittitas,98934,2569,2016
kittitas,kittitas high,374,0,7,0,7,2,92,269,4,203,171,153,19403,kittitas,98934,2766,2016
klickitat,klickitat elem & high,76,0,0,0,0,0,4,66,6,42,34,41,20402,klickitat,98628,3494,2016
clark,la center elementary,682,2,3,0,3,6,54,601,16,362,320,196,06101,la center,98629,2558,2016
clark,la center high,574,1,10,0,10,3,34,518,8,295,279,106,06101,la center,98629,4431,2016
clark,la center home school academy,5,0,0,0,0,0,0,5,0,2,3,2,06101,la center,98629,5326,2016
clark,la center middle,383,2,2,0,2,1,18,356,4,197,186,85,06101,la center,98629,3371,2016
skagit,la conner elementary,264,103,1,0,1,0,22,124,14,136,128,160,29311,la conner,98257,2522,2016
skagit,la conner high,224,70,3,2,5,2,23,120,4,114,110,102,29311,la conner,98257,2276,2016
skagit,la conner middle,139,41,1,0,1,0,16,77,4,67,72,69,29311,la conner,98257,3900,2016
whitman,lacrosse elementary,30,0,0,0,0,0,0,29,1,16,14,8,38126,lacrosse,99143,2087,2016
whitman,lacrosse high,39,1,0,0,0,2,3,33,0,19,20,18,38126,lacrosse,99143,2088,2016
chelan,chelan high,426,1,0,0,0,1,212,206,6,225,201,240,04129,chelan,98816,4260,2016
chelan,chelan middle,332,0,0,0,0,1,176,152,3,172,160,217,04129,chelan,98816,2317,2016
chelan,chelan school of innovation,29,1,0,0,0,0,16,10,2,18,11,22,04129,chelan,98816,1940,2016
chelan,lake chelan preschool,13,0,0,0,0,0,10,3,0,11,2,13,04129,chelan,98816,1675,2016
chelan,morgen owings elementary,622,0,5,0,5,1,350,263,3,331,291,441,04129,chelan,98816,2689,2016
snohomish,cavelero mid high,1295,7,47,10,57,25,163,949,94,698,597,336,31004,lake stevens,98258,5099,2016
snohomish,glenwood elementary,576,0,6,3,9,5,46,460,56,311,265,139,31004,lake stevens,98258,4391,2016
snohomish,highland elementary,700,3,16,1,17,9,64,553,54,363,337,162,31004,lake stevens,98258,4534,2016
snohomish,hillcrest elementary,879,3,32,1,33,16,175,576,76,468,411,311,31004,lake stevens,98258,2885,2016
snohomish,homelink,87,0,0,0,0,0,6,78,3,39,48,10,31004,lake stevens,98258,1753,2016
snohomish,lake stevens middle,619,1,18,5,23,5,105,422,63,315,304,202,31004,lake stevens,98258,3408,2016
snohomish,lake stevens sr high,1825,14,75,5,80,35,226,1352,118,956,869,387,31004,lake stevens,98258,2426,2016
snohomish,mt. pilchuck elementary,645,5,13,6,19,11,75,486,49,360,285,253,31004,lake stevens,98258,2884,2016
snohomish,north lake middle,699,5,22,0,22,8,76,532,56,354,345,182,31004,lake stevens,98258,4139,2016
snohomish,skyline elementary,507,0,14,1,15,8,87,351,46,262,245,208,31004,lake stevens,98258,4392,2016
snohomish,sunnycrest elementary,745,1,35,0,35,20,100,517,72,397,348,182,31004,lake stevens,98258,3753,2016
king,lake washington technical academy,353,1,12,4,16,11,51,252,18,224,129,0,17937,kirkland,98034,5953,2016
king,alcott elementary,733,1,399,0,399,4,29,266,34,387,346,33,17414,redmond,98053,4256,2016
king,audubon elementary,556,0,256,1,257,5,33,225,36,271,285,22,17414,redmond,98052,3548,2016
king,bell elementary,387,0,45,1,46,16,66,232,27,201,186,104,17414,kirkland,98033,3592,2016
king,blackwell elementary,534,0,182,0,182,6,33,289,24,283,251,10,17414,sammamish,98074,4532,2016
king,carson elementary,406,0,93,0,93,4,21,263,25,198,208,14,17414,sammamish,98074,5139,2016
king,community,71,0,6,0,6,1,3,53,8,32,39,3,17414,kirkland,98033,3856,2016
king,contractual schools,23,0,2,0,2,1,3,17,0,20,3,2,17414,redmond,98073,1649,2016
king,dickinson elementary,538,3,142,0,142,12,80,266,35,311,227,81,17414,redmond,98053,4018,2016
king,discovery,71,0,17,0,17,0,3,44,7,37,34,1,17414,kirkland,98034,1658,2016
king,eastlake high,1680,5,201,3,204,20,115,1231,105,842,838,77,17414,sammamish,98074,4439,2016
king,einstein elementary,438,0,96,3,99,26,118,165,30,236,202,169,17414,redmond,98052,4424,2016
king,emerson high,69,1,1,1,2,0,12,51,3,29,40,24,17414,kirkland,98033,3855,2016
king,emerson k-12,91,0,3,0,3,0,7,72,9,46,45,6,17414,kirkland,98033,1688,2016
king,environmental & adventure,140,0,21,0,21,3,2,104,10,80,60,3,17414,kirkland,98034,1800,2016
king,evergreen middle,1018,3,369,1,370,17,74,507,47,539,479,47,17414,redmond,98053,4148,2016
king,explorer community,71,0,21,0,21,0,3,44,3,35,36,0,17414,redmond,98052,1687,2016
king,finn hill middle,589,2,55,0,55,16,63,395,57,287,302,113,17414,kirkland,98034,3590,2016
king,franklin elementary,482,0,155,0,155,3,42,238,44,257,225,29,17414,kirkland,98033,3591,2016
king,frost elementary,412,3,31,1,32,10,119,206,42,211,201,171,17414,kirkland,98034,3675,2016
king,futures,56,1,4,0,4,1,15,32,3,28,28,18,17414,kirkland,98034,1804,2016
king,inglewood middle,1152,2,243,0,243,8,73,756,70,606,546,34,17414,sammamish,98074,4386,2016
king,international community,418,1,189,1,190,1,18,184,24,197,221,8,17414,kirkland,98033,1706,2016
king,juanita elementary,388,0,41,0,41,9,68,214,56,222,166,102,17414,kirkland,98034,2796,2016
king,juanita high,1464,2,219,5,224,46,219,862,111,779,685,338,17414,kirkland,98034,3771,2016
king,kamiakin middle,548,1,115,2,117,10,109,263,48,284,264,181,17414,kirkland,98034,3922,2016
king,keller elementary,369,2,41,2,43,11,59,206,48,191,178,83,17414,kirkland,98034,3704,2016
king,kirk elementary,519,1,43,0,43,8,26,399,42,257,262,28,17414,kirkland,98033,3941,2016
king,kirkland middle,569,4,52,2,54,6,36,434,35,309,260,57,17414,kirkland,98033,2308,2016
king,lake washington high,1591,4,169,3,172,29,209,1070,106,807,784,229,17414,kirkland,98033,2739,2016
king,lakeview elementary,513,2,48,2,50,9,46,375,31,256,257,73,17414,kirkland,98033,3041,2016
king,mann elementary,472,1,111,0,111,8,38,282,32,245,227,29,17414,redmond,98052,3529,2016
king,mcauliffe elementary,506,0,134,2,136,8,43,289,30,266,240,15,17414,sammamish,98074,4354,2016
king,mead elementary,596,2,152,0,152,2,47,359,34,303,293,21,17414,sammamish,98074,4096,2016
king,muir elementary,406,0,98,0,98,4,77,203,24,197,209,152,17414,kirkland,98034,3748,2016
king,northstar middle,88,0,29,0,29,0,4,48,7,49,39,3,17414,kirkland,98033,4167,2016
king,ready start preschool,3,0,0,0,0,0,2,0,1,2,1,0,17414,redmond,98052,3549,2016
king,redmond elementary,548,0,209,0,209,14,90,185,50,286,262,121,17414,redmond,98052,2289,2016
king,redmond high,1872,3,333,3,336,34,201,1163,134,937,935,209,17414,redmond,98052,3528,2016
king,redmond middle,997,3,248,2,250,24,149,492,79,516,481,173,17414,redmond,98052,3232,2016
king,renaissance,96,0,16,0,16,0,9,64,7,21,75,1,17414,sammamish,98074,5057,2016
king,rockwell elementary,626,0,247,0,247,3,33,291,52,319,307,26,17414,redmond,98052,4147,2016
king,rosa parks elementary,659,1,297,1,298,15,42,270,33,324,335,20,17414,redmond,98053,5053,2016
king,rose hill elementary,395,0,54,1,55,9,95,196,40,212,183,127,17414,kirkland,98033,2992,2016
king,rose hill middle,785,1,133,0,133,17,115,454,65,415,370,145,17414,redmond,98052,3706,2016
king,rush elementary,542,0,222,0,222,8,49,231,32,274,268,44,17414,redmond,98052,3703,2016
king,sandburg elementary,484,0,36,0,36,1,36,374,37,259,225,40,17414,kirkland,98034,3747,2016
king,smith elementary,616,1,299,0,299,2,32,244,38,314,302,19,17414,sammamish,98074,4302,2016
king,stella schola,87,0,39,0,39,0,2,40,6,39,48,1,17414,redmond,98052,1975,2016
king,tesla stem high,560,1,228,0,228,2,30,270,29,351,209,10,17414,redmond,98053,5265,2016
king,thoreau elementary,354,1,37,2,39,4,38,231,41,183,171,67,17414,kirkland,98034,3490,2016
king,twain elementary,553,4,81,1,82,6,72,331,58,276,277,99,17414,kirkland,98033,3441,2016
king,wilder elementary,590,1,202,0,202,7,35,314,31,304,286,13,17414,woodinville,98077,4336,2016
snohomish,cougar creek elementary,351,4,7,2,9,3,50,254,31,187,164,131,31306,n. lakewood,98259,4576,2016
snohomish,english crossing elementary,317,3,5,2,7,5,67,211,24,162,155,132,31306,n. lakewood,98259,4477,2016
snohomish,lakewood elementary,389,4,7,6,13,8,73,260,31,200,189,195,31306,n. lakewood,98259,3255,2016
snohomish,lakewood high,707,4,16,3,19,13,82,560,29,379,328,155,31306,n lakewood,98259,4204,2016
snohomish,lakewood middle,551,10,12,6,18,3,79,408,33,277,274,183,31306,n. lakewood,98259,3893,2016
whitman,lamont middle,32,1,0,0,0,0,3,28,0,15,17,17,38264,lamont,99017,3137,2016
spokane,liberty high,139,1,0,0,0,2,5,129,2,75,64,54,32362,spangle,99031,3416,2016
spokane,liberty jr high & elementary,307,2,2,0,2,0,23,269,11,164,143,112,32362,spangle,99031,4226,2016
adams,lind elementary,84,0,1,0,1,1,23,59,0,44,40,68,01158,lind,99341,3421,2016
adams,lind-ritzville high,61,0,2,0,2,0,20,35,4,30,31,29,01158,ritzville,99169,2903,2016
adams,lind-ritzville middle,46,0,2,0,2,0,13,30,1,16,30,29,01158,lind,99341,5293,2016
cowlitz,broadway learning center,85,0,0,0,0,1,13,63,8,62,23,96,08122,longview,98632,2665,2016
cowlitz,cascade middle,538,7,10,2,12,7,116,347,49,262,276,303,08122,longview,98632,3475,2016
cowlitz,columbia heights elementary,361,5,2,1,3,3,42,284,24,186,175,182,08122,longview,98632,3211,2016
cowlitz,columbia valley garden elem,516,3,6,0,6,6,66,414,21,249,267,242,08122,longview,98632,2369,2016
cowlitz,discovery high,211,2,1,1,2,9,58,124,16,91,120,124,08122,longview,98632,5312,2016
cowlitz,kessler elementary,322,3,8,4,12,1,87,183,36,172,150,296,08122,longview,98632,2319,2016
cowlitz,longview school district special services,56,0,3,0,3,0,14,35,4,35,21,43,08122,longview,98632,3913,2016
cowlitz,mark morris high,980,12,15,7,22,5,146,726,69,500,480,371,08122,longview,98632,3151,2016
cowlitz,mint valley elementary,403,0,2,3,5,3,63,299,33,207,196,319,08122,longview,98632,3658,2016
cowlitz,monticello middle,473,12,14,3,17,3,128,277,36,253,220,366,08122,longview,98632,2831,2016
cowlitz,mt. solo middle,475,7,7,0,7,1,61,373,26,223,252,204,08122,longview,98632,4574,2016
cowlitz,northlake elementary,334,5,3,3,6,5,146,150,22,180,154,295,08122,longview,98632,2914,2016
cowlitz,olympic elementary,373,5,7,0,7,2,101,229,29,182,191,310,08122,longview,98632,2726,2016
cowlitz,r a long high,926,11,27,7,34,12,168,644,57,476,450,466,08122,longview,98632,2416,2016
cowlitz,robert gray elementary,467,6,7,0,7,2,58,365,29,218,249,187,08122,longview,98632,3019,2016
cowlitz,saint helens elementary,344,2,4,3,7,6,129,169,31,184,160,318,08122,longview,98632,2370,2016
stevens,loon lake elementary,113,0,0,0,0,1,16,91,5,54,59,98,33183,loon lake,99148,2480,2016
stevens,loon lake homelink program,114,0,5,0,5,1,17,84,7,52,62,34,33183,loon lake,99148,1922,2016
san juan,cva-lopez island,25,0,0,1,1,3,5,16,0,13,12,1,28144,lopez island,98261,5299,2016
san juan,decatur elementary,2,0,0,0,0,0,0,2,0,1,1,0,28144,anacortes,98221,4178,2016
san juan,lopez elementary,116,0,2,0,2,1,35,76,2,63,53,56,28144,lopez island,98261,4107,2016
san juan,lopez middle high,99,2,10,0,10,1,12,72,2,56,43,24,28144,lopez island,98261,2632,2016
whatcom,lummi nation,271,245,0,1,1,0,9,6,10,157,114,190,37903,bellingham,98226,5373,2016
klickitat,dallesport elementary,112,14,0,0,0,0,14,74,10,62,50,83,20406,lyle,98635,3049,2016
klickitat,lyle high,93,12,0,0,0,1,13,63,4,53,40,54,20406,lyle,98635,3111,2016
klickitat,lyle middle,46,6,0,0,0,0,10,28,2,24,22,28,20406,lyle,98635,3643,2016
whatcom,fisher elementary,340,1,3,1,4,6,120,202,7,192,148,178,37504,lynden,98264,3417,2016
whatcom,isom elementary,411,3,13,0,13,6,96,282,11,208,203,146,37504,lynden,98264,4324,2016
whatcom,lynden academy,198,1,0,0,0,1,7,186,3,82,116,9,37504,lynden,98264,1983,2016
whatcom,lynden high,880,4,26,2,28,8,201,606,33,442,438,262,37504,lynden,98264,4201,2016
whatcom,lynden middle,591,2,10,1,11,9,148,396,25,297,294,239,37504,lynden,98264,2219,2016
whatcom,lynden special services,61,0,1,0,1,0,6,53,1,38,23,0,37504,lynden,98264,1914,2016
whatcom,vossbeck elementary,385,2,9,1,10,8,90,257,18,206,179,149,37504,lynden,98264,4517,2016
yakima,artz fox elementary,570,3,0,0,0,0,555,12,0,293,277,504,39120,mabton,98935,3070,2016
yakima,mabton jr. sr. high,391,0,0,0,0,0,379,12,0,186,205,314,39120,mabton,98935,5289,2016
douglas,mansfield elem and high,96,7,3,0,3,1,25,59,1,44,52,57,09207,mansfield,98830,2233,2016
chelan,manson elementary,319,4,1,0,1,2,225,87,0,161,158,245,04019,manson,98831,2196,2016
chelan,manson high,199,0,2,0,2,1,137,59,0,111,88,158,04019,manson,98831,2623,2016
chelan,manson middle,150,3,1,0,1,1,93,50,2,79,71,110,04019,manson,98831,5286,2016
stevens,mary walker high,152,16,3,0,3,1,8,106,18,80,72,83,33207,springdale,99173,3311,2016
stevens,springdale academy,7,0,0,0,0,0,0,7,0,5,2,7,33207,springdale,99173,1857,2016
stevens,springdale elementary,171,22,0,0,0,3,14,112,20,89,82,137,33207,springdale,99173,2297,2016
stevens,springdale middle,110,15,1,1,2,1,3,82,7,62,48,76,33207,springdale,99173,3894,2016
snohomish,10th street,171,8,5,0,5,1,20,122,15,77,94,29,31025,marysville,98271,1656,2016
snohomish,allen creek elementary,478,9,38,2,40,9,68,306,46,262,216,202,31025,marysville,98270,4454,2016
snohomish,cascade elementary,448,11,32,6,38,8,129,200,62,223,225,269,31025,marysville,98270,3059,2016
snohomish,cedarcrest,831,20,51,5,56,8,209,453,85,409,422,375,31025,marysville,98270,4357,2016
snohomish,grove elementary,528,18,33,4,37,3,89,305,76,276,252,213,31025,marysville,98270,5123,2016
snohomish,heritage,77,46,0,0,0,0,12,6,13,35,42,47,31025,marysville,98271,1657,2016
snohomish,kellogg marsh elementary,486,12,9,7,16,6,93,311,48,260,226,220,31025,marysville,98270,4323,2016
snohomish,liberty elementary,520,31,23,10,33,5,212,207,32,263,257,379,31025,marysville,98270,3964,2016
snohomish,marshall elementary,376,10,11,8,19,6,83,208,50,200,176,219,31025,marysville,98271,4150,2016
snohomish,marysville coop program,279,19,4,0,4,3,38,183,32,143,136,56,31025,marysville,98270,1862,2016
snohomish,marysville middle,799,20,41,10,51,17,199,437,75,407,392,372,31025,marysville,98270,3355,2016
snohomish,marysville pilchuck high,1268,68,52,1,53,24,288,723,112,668,600,482,31025,marysville,98271,5213,2016
snohomish,marysville sd special,101,11,4,0,4,1,24,51,10,62,39,44,31025,marysville,98270,1910,2016
snohomish,pinewood elementary,533,10,16,2,18,6,122,320,57,265,268,244,31025,marysville,98270,3651,2016
snohomish,quil ceda tulalip elementary,555,206,2,2,4,6,106,154,79,274,281,466,31025,tulalip,98271,5350,2016
snohomish,school home partnership program,97,8,1,0,1,2,10,64,12,33,64,43,31025,marysville,98271,1744,2016
snohomish,shoultes elementary,478,11,26,2,28,12,115,258,54,250,228,273,31025,marysville,98271,3187,2016
snohomish,sunnyside elementary,514,8,39,6,45,9,105,312,35,243,271,214,31025,marysville,98270,3537,2016
snohomish,totem middle,554,99,32,4,36,7,102,247,63,281,273,271,31025,marysville,98270,2813,2016
grays harbor,mccleary elem,305,4,3,0,3,4,11,274,9,171,134,183,14065,mccleary,98557,2835,2016
spokane,brentwood elementary,551,2,4,0,4,11,35,463,36,297,254,202,32354,spokane,99218,3693,2016
spokane,colbert elementary,513,2,6,4,10,0,27,457,17,257,256,130,32354,colbert,99005,3562,2016
spokane,evergreen elementary,557,4,6,7,13,8,29,468,35,273,284,260,32354,spokane,99208,3414,2016
spokane,farwell elementary,593,4,11,0,11,8,50,470,50,313,280,207,32354,spokane,99208,3759,2016
spokane,mead alternative high,92,0,0,0,0,1,5,78,8,40,52,53,32354,spokane,99218,1803,2016
spokane,mead education partnership prog,402,1,1,0,1,1,11,369,19,190,212,102,32354,spokane,99208,1858,2016
spokane,mead open doors,16,0,0,0,0,0,1,14,1,11,5,5,32354,mead,99021,5401,2016
spokane,mead preschool,64,1,0,0,0,1,3,57,2,40,24,0,32354,mead,99021,5122,2016
spokane,mead senior high,1618,3,2,1,3,21,94,1328,169,842,776,358,32354,spokane,99218,2402,2016
spokane,meadow ridge elementary,557,2,3,1,4,1,33,497,20,280,277,156,32354,mead,99021,4400,2016
spokane,midway elementary,563,1,3,1,4,2,39,487,30,290,273,86,32354,colbert,99005,4133,2016
spokane,mountainside middle,781,6,10,19,29,11,39,661,35,404,377,252,32354,colbert,99005,3191,2016
spokane,mt spokane high,1522,4,14,10,24,25,91,1242,136,750,772,418,32354,mead,99021,4491,2016
spokane,northwood middle,734,3,10,1,11,14,48,591,67,399,335,208,32354,spokane,99208,3851,2016
spokane,prairie view elementary,668,0,1,0,1,9,17,570,71,350,318,78,32354,spokane,99208,5094,2016
spokane,riverpoint academy,105,0,0,0,0,2,6,90,7,62,43,16,32354,spokane,99218,5268,2016
spokane,shiloh hills elementary,540,12,19,29,48,12,52,355,61,272,268,412,32354,spokane,99208,4134,2016
spokane,hallett elementary,505,6,3,0,3,8,36,417,35,259,246,248,32326,medical lake,99022,4483,2016
spokane,medical lake high,553,1,6,2,8,21,50,429,44,320,233,169,32326,medical lake,99022,2890,2016
spokane,medical lake middle,383,0,2,4,6,8,42,293,34,199,184,154,32326,medical lake,99022,3965,2016
spokane,michael anderson elementary,429,2,7,1,8,22,67,278,52,221,208,99,32326,fairchild afb,99011,4577,2016
king,island park elementary,556,0,113,1,114,4,29,333,76,283,273,20,17400,mercer island,98040,3162,2016
king,islander middle,1104,1,201,4,205,11,40,764,83,602,502,29,17400,mercer island,98040,3219,2016
king,lakeridge elementary,622,1,92,0,92,6,30,434,59,339,283,14,17400,mercer island,98040,2981,2016
king,mercer island high,1464,7,302,3,305,20,54,1023,55,764,700,44,17400,mercer island,98040,3029,2016
king,west mercer elementary,700,0,151,0,151,3,33,428,85,378,322,30,17400,mercer island,98040,3433,2016
whatcom,irene reither elementary,612,11,24,3,27,14,121,416,23,316,296,280,37505,everson,98226,2584,2016
whatcom,meridian high,534,6,38,0,38,1,109,362,18,285,249,207,37505,bellingham,98226,2554,2016
whatcom,meridian middle,290,2,15,0,15,4,69,190,10,158,132,149,37505,lynden,98264,3930,2016
whatcom,meridian parent partnership program,301,0,5,1,6,4,15,260,16,160,141,17,37505,bellingham,98226,5047,2016
whatcom,meridian special programs,20,0,0,0,0,0,3,17,0,11,9,0,37505,bellingham,98226,1743,2016
okanogan,alternative,16,0,0,0,0,0,1,15,0,8,8,9,24350,winthrop,98862,1621,2016
okanogan,home school experience,10,0,0,0,0,0,0,10,0,7,3,4,24350,winthrop,98862,1845,2016
okanogan,liberty bell jr sr high,262,1,4,0,4,1,16,234,6,138,124,95,24350,winthrop,98862,2146,2016
okanogan,methow valley elementary,324,4,1,0,1,0,22,289,8,164,160,141,24350,winthrop,98862,4501,2016
skamania,mill a elementary,17,4,0,0,0,0,1,11,1,10,7,18,30031,cook,98605,3406,2016
snohomish,chain lake elementary,544,0,13,0,13,4,54,440,33,264,280,98,31103,snohomish,98290,4362,2016
snohomish,frank wagner elementary,585,1,10,2,12,2,347,190,33,305,280,407,31103,monroe,98272,3060,2016
snohomish,fryelands elementary,504,1,10,0,10,3,132,328,30,262,242,155,31103,monroe,98272,4594,2016
snohomish,hidden river middle,413,2,14,0,14,2,69,305,21,235,178,101,31103,snohomish,98296,4544,2016
snohomish,leaders in learning,84,1,1,1,2,1,21,53,6,35,49,47,31103,monroe,98272,1806,2016
snohomish,maltby elementary,408,2,21,1,22,1,50,318,15,208,200,94,31103,snohomish,98296,2546,2016
snohomish,monroe high,1668,14,47,2,49,8,315,1206,76,835,833,375,31103,monroe,98272,4528,2016
snohomish,monroe special ed preschool,38,1,0,0,0,1,9,26,1,26,12,0,31103,monroe,98272,1570,2016
snohomish,out of district special ed,13,0,0,0,0,0,1,11,1,11,2,1,31103,monroe,98272,1643,2016
snohomish,park place middle,789,10,14,5,19,1,186,538,35,385,404,292,31103,monroe,98272,5040,2016
snohomish,salem woods elementary,478,8,4,0,4,4,42,393,27,248,230,116,31103,monroe,98272,4159,2016
snohomish,shoreline-monroe high,317,3,10,1,11,30,52,191,30,196,121,0,31103,monroe,98272,5154,2016
snohomish,sky valley education center,932,5,16,3,19,9,55,804,40,452,480,5,31103,monroe,98272,1777,2016
snohomish,youth re-engagement,229,4,0,0,0,8,41,173,3,116,113,1,31103,monroe,98272,1883,2016
grays harbor,beacon avenue elementary,429,6,2,0,2,0,42,352,27,224,205,167,14066,montesano,98563,3661,2016
grays harbor,montesano jr-sr high,652,8,7,1,8,0,73,520,43,339,313,215,14066,montesano,98563,2180,2016
grays harbor,simpson avenue elementary,302,9,5,0,5,0,34,237,17,149,153,114,14066,montesano,98563,3374,2016
lewis,morton elementary,168,2,1,0,1,1,17,131,16,91,77,113,21214,morton,98356,2678,2016
lewis,morton junior-senior high,153,1,2,1,3,0,18,129,2,72,81,95,21214,morton,98356,3112,2016
grant,chief moses middle,888,2,8,0,8,4,418,438,18,422,466,531,13161,moses lake,98837,3022,2016
grant,endeavor middle,251,4,0,0,0,3,148,85,11,125,126,221,13161,moses lake,98837,5354,2016
grant,frontier middle,690,2,9,0,9,20,298,351,10,343,347,412,13161,moses lake,98837,2673,2016
grant,garden heights elementary,494,5,7,0,7,3,212,247,20,238,256,240,13161,moses lake,98837,3091,2016
grant,knolls vista elementary,449,2,11,1,12,10,231,178,16,241,208,344,13161,moses lake,98837,2833,2016
grant,lakeview terrace elementary,417,1,2,0,2,4,192,212,6,208,209,246,13161,moses lake,98837,2969,2016
grant,larson heights elementary,336,1,0,1,1,8,165,154,7,175,161,313,13161,moses lake,98837,3021,2016
grant,longview elementary,438,0,3,1,4,3,223,204,4,228,210,325,13161,moses lake,98837,3153,2016
grant,midway elementary,387,3,2,1,3,4,203,161,13,220,167,303,13161,moses lake,98837,2970,2016
grant,moses lake high,2375,20,27,0,27,29,1015,1243,41,1178,1197,1227,13161,moses lake,98837,3215,2016
grant,north elementary,283,2,0,0,0,2,159,106,14,144,139,260,13161,moses lake,98837,3779,2016
grant,park orchard elementary,430,4,1,0,1,3,204,204,14,218,212,285,13161,moses lake,98837,5251,2016
grant,peninsula elementary,435,0,6,0,6,4,198,218,9,227,208,298,13161,moses lake,98837,2832,2016
grant,sage point elementary,423,1,2,0,2,4,116,291,9,223,200,150,13161,moses lake,98837,5173,2016
grant,skill source learning center,57,0,0,0,0,2,23,31,1,38,19,61,13161,moses lake,98837,5323,2016
lewis,mossyrock academy,10,0,0,0,0,0,0,10,0,7,3,8,21206,mossyrock,98564,5415,2016
lewis,mossyrock elementary,289,7,1,1,2,0,89,191,0,147,142,212,21206,mossyrock,98564,2572,2016
lewis,mossyrock jr./sr. high,217,5,2,1,3,3,43,160,3,117,100,111,21206,mossyrock,98564,3238,2016
yakima,harrah elementary,583,318,0,0,0,0,220,19,26,303,280,511,39209,harrah,98933,2506,2016
yakima,mount adams middle,133,69,0,0,0,0,56,4,4,74,59,110,39209,white swan,98952,2389,2016
yakima,white swan high,235,123,0,0,0,0,85,11,16,123,112,173,39209,white swan,98952,2532,2016
whatcom,acme elementary,222,23,1,1,2,1,14,149,33,119,103,119,37507,acme,98220,2585,2016
whatcom,educational resource center,33,2,0,0,0,1,4,24,2,21,12,13,37507,deming,98244,1936,2016
whatcom,harmony elementary,378,33,0,2,2,3,36,281,23,201,177,158,37507,bellingham,98226,3365,2016
whatcom,kendall elementary,426,12,8,1,9,4,60,326,15,216,210,291,37507,maple falls,98266,4533,2016
whatcom,mount baker academy,37,0,0,0,0,1,2,34,0,18,19,6,37507,acme,98220,5112,2016
whatcom,mount baker junior high,257,16,4,0,4,1,30,194,12,139,118,153,37507,deming,98244,3003,2016
whatcom,mount baker senior high,579,25,6,1,7,1,68,446,32,306,273,249,37507,deming,98244,2343,2016
skamania,mount pleasant,47,0,1,0,1,0,6,39,1,23,24,13,30029,washougal,98671,3459,2016
skagit,jefferson elementary,476,4,7,4,11,5,249,203,4,254,222,296,29320,mount vernon,98273,3183,2016
skagit,la venture middle,631,7,6,2,8,3,425,178,10,302,329,481,29320,mount vernon,98273,3821,2016
skagit,lincoln elementary,373,3,7,3,10,0,209,131,20,184,189,273,29320,mount vernon,98274,2579,2016
skagit,little mountain elementary,633,4,15,3,18,6,330,256,19,318,315,388,29320,mount vernon,98274,4013,2016
skagit,madison elementary,532,0,6,2,8,6,362,146,10,266,266,348,29320,mount vernon,98273,3001,2016
skagit,mount baker middle,689,1,13,7,20,14,356,278,20,343,346,414,29320,mount vernon,98274,4511,2016
skagit,mount vernon high,1994,14,42,23,65,14,1042,814,45,1020,974,1050,29320,mount vernon,98273,2295,2016
skagit,mount vernon special ed,116,2,4,0,4,1,66,39,4,74,42,67,29320,mount vernon,98273,3829,2016
skagit,washington elementary,438,4,7,1,8,4,242,165,15,234,204,342,29320,mount vernon,98273,2880,2016
king,muckleshoot tribal,417,412,0,1,1,2,0,2,0,208,209,323,17903,auburn,98092,1986,2016
snohomish,aces high,188,3,5,2,7,9,73,83,13,116,72,122,31006,everett,98204,4247,2016
snohomish,challenger elementary,826,2,72,19,91,41,340,262,90,410,416,608,31006,everett,98204,4303,2016
snohomish,columbia elementary,570,2,90,3,93,25,89,279,82,300,270,164,31006,mukilteo,98275,4342,2016
snohomish,discovery elementary,680,1,61,5,66,44,304,196,69,354,326,496,31006,everett,98208,4304,2016
snohomish,endeavour elementary,503,0,170,2,172,22,52,201,56,261,242,92,31006,mukilteo,98275,4469,2016
snohomish,explorer middle,960,5,150,17,167,44,365,319,60,526,434,616,31006,everett,98204,4231,2016
snohomish,fairmount elementary,752,5,114,8,122,63,216,254,92,403,349,475,31006,everett,98204,2886,2016
snohomish,harbour pointe middle,855,5,210,1,211,26,115,419,79,448,407,180,31006,mukilteo,98275,4430,2016
snohomish,horizon elementary,775,1,10,10,20,38,472,161,83,396,379,657,31006,everett,98204,4344,2016
snohomish,kamiak high,2129,12,467,9,476,51,200,1241,149,1097,1032,365,31006,mukilteo,98275,4433,2016
snohomish,mariner high,2209,17,299,47,346,197,779,724,146,1179,1030,1310,31006,everett,98204,3688,2016
snohomish,mukilteo elementary,652,0,99,1,100,13,55,417,67,331,321,108,31006,mukilteo,98275,4164,2016
snohomish,odyssey elementary,723,5,139,14,153,73,186,247,59,382,341,378,31006,everett,98204,4583,2016
snohomish,olivia park elementary,719,1,62,17,79,43,315,217,64,365,354,489,31006,everett,98204,3121,2016
snohomish,olympic view middle,870,4,120,11,131,48,183,445,59,463,407,398,31006,mukilteo,98275,3120,2016
snohomish,picnic point elementary,578,1,64,5,69,59,116,262,71,285,293,248,31006,edmonds,98026,4165,2016
snohomish,serene lake elementary,461,0,42,1,43,32,88,228,70,242,219,227,31006,edmonds,98026,3687,2016
snohomish,special services,67,1,8,0,8,3,12,38,5,41,26,19,31006,everett,98204,1848,2016
snohomish,voyager middle,839,3,111,13,124,81,322,254,55,433,406,541,31006,everett,98204,4425,2016
yakima,naches valley high,453,4,3,0,3,1,87,346,12,245,208,167,39003,naches,98937,2591,2016
yakima,naches valley middle,408,2,2,0,2,1,77,316,10,191,217,190,39003,naches,98937,2898,2016
lewis,napavine elementary,423,0,2,0,2,3,57,340,21,238,185,227,21014,napavine,98565,3288,2016
lewis,napavine jr sr high,373,4,4,0,4,1,44,309,11,193,180,133,21014,napavine,98565,2273,2016
pacific,naselle elementary,161,1,3,0,3,2,19,135,1,77,84,83,25155,naselle,98638,2868,2016
pacific,naselle jr sr high schools,149,0,2,2,4,0,13,123,9,80,69,79,25155,naselle,98638,3295,2016
pend oreille,newport high,355,2,3,1,4,2,21,308,18,170,185,167,26056,newport,99156,2518,2016
pend oreille,pend oreille river,15,0,0,0,0,0,0,14,1,8,7,29,26056,newport,99156,5118,2016
pend oreille,sadie halstead middle,329,2,1,0,1,0,12,292,22,175,154,207,26056,newport,99156,3968,2016
pend oreille,stratton elementary,387,2,1,0,1,0,15,350,19,215,172,269,26056,newport,99156,4478,2016
spokane,lake spokane elementary,422,9,3,2,5,4,28,339,37,227,195,162,32325,nine mile falls,99026,4036,2016
spokane,lakeside high,524,10,1,0,1,1,21,469,22,255,269,110,32325,nine mile falls,99026,4333,2016
spokane,lakeside middle,358,7,1,2,3,3,12,314,19,170,188,97,32325,nine mile falls,99026,4521,2016
spokane,nine mile falls elementary,144,2,0,0,0,2,9,127,4,76,68,28,32325,nine mile falls,99026,2341,2016
spokane,re-engagement school (nine mile falls),1,0,0,0,0,0,0,1,0,0,1,0,32325,nine mile falls,99026,5417,2016
whatcom,everson elementary,234,24,3,0,3,0,89,98,20,123,111,156,37506,everson,98247,4428,2016
whatcom,nooksack elementary,348,8,1,1,2,0,113,208,17,176,172,172,37506,everson,98247,4525,2016
whatcom,nooksack valley high,455,16,6,0,6,3,137,271,22,221,234,204,37506,everson,98247,2459,2016
whatcom,nooksack valley middle,326,10,2,0,2,0,100,199,15,165,161,179,37506,everson,98247,2687,2016
whatcom,nooksack valley special services,32,0,0,0,0,0,12,18,2,23,9,29,37506,everson,98247,1823,2016
whatcom,sumas elementary,224,4,1,0,1,2,75,128,14,119,105,143,37506,sumas,98295,2489,2016
grays harbor,north beach junior high,85,13,0,0,0,2,9,57,4,42,43,61,14064,ocean shores,98569,3788,2016
grays harbor,north beach senior high,197,19,2,0,2,7,21,134,14,117,80,109,14064,ocean shores,98569,2728,2016
grays harbor,ocean shores elementary,249,25,7,1,8,10,29,176,1,119,130,195,14064,ocean shores,98569,3787,2016
grays harbor,pacific beach elementary,139,42,0,0,0,1,16,58,22,72,67,120,14064,pacific beach,98571,3155,2016
franklin,basin city elem,416,0,2,0,2,0,345,67,2,227,189,356,11051,connell,99326,3325,2016
franklin,connell elem,524,1,9,1,10,1,391,114,7,270,254,411,11051,connell,99326,2918,2016
franklin,connell high,597,0,10,0,10,0,394,185,8,298,299,383,11051,connell,99326,3272,2016
franklin,connell preschool,37,0,0,0,0,0,32,5,0,21,16,15,11051,connell,99326,1889,2016
franklin,mesa elem,185,0,0,0,0,2,104,79,0,103,82,122,11051,mesa,99343,3086,2016
franklin,north franklin virtual academy,9,0,0,0,0,0,2,7,0,3,6,1,11051,connell,99326,5261,2016
franklin,palouse junction high,36,1,0,0,0,0,26,8,1,26,10,43,11051,connell,99326,1754,2016
franklin,robert l olds junior high,307,1,5,0,5,3,204,89,5,161,146,227,11051,connell,99326,2198,2016
kitsap,david wolfle elementary,362,63,2,4,6,2,56,166,69,189,173,199,18400,kingston,98346,2798,2016
kitsap,hilder pearson elementary,334,0,7,2,9,7,30,248,40,155,179,110,18400,poulsbo,98370,2854,2016
kitsap,kingston high,853,55,23,2,25,4,64,603,102,441,412,252,18400,kingston,98346,5085,2016
kitsap,kingston middle,494,52,7,2,9,7,46,319,61,251,243,191,18400,kingston,98346,4359,2016
kitsap,middle school options,27,0,0,0,0,0,0,24,3,10,17,2,18400,kingston,98346,3126,2016
kitsap,north kitsap high,1132,18,39,6,45,12,143,822,92,572,560,201,18400,poulsbo,98370,3236,2016
kitsap,pal program,57,0,0,0,0,1,7,49,0,27,30,25,18400,kingston,98346,1733,2016
kitsap,poulsbo elementary,540,7,32,2,34,8,93,346,52,254,286,173,18400,poulsbo,98370,2026,2016
kitsap,poulsbo middle,835,5,34,3,37,8,120,579,86,418,417,236,18400,poulsbo,98370,2476,2016
kitsap,richard gordon elementary,432,5,6,0,6,3,40,343,35,224,208,125,18400,kingston,98346,4467,2016
kitsap,special programs,31,2,0,0,0,0,9,18,2,23,8,4,18400,poulsbo,98370,1677,2016
kitsap,suquamish elementary,391,44,6,0,6,3,54,217,67,189,202,200,18400,suquamish,98392,3391,2016
kitsap,vinland elementary,619,5,21,0,21,8,107,412,66,304,315,194,18400,poulsbo,98370,4461,2016
mason,belfair elementary,499,3,4,0,4,2,122,331,37,242,257,244,23403,belfair,98528,2662,2016
mason,hawkins middle,427,6,3,1,4,4,77,312,24,198,229,248,23403,belfair,98528,3174,2016
mason,james a. taylor high,35,0,0,1,1,2,5,25,2,21,14,23,23403,belfair,98528,1680,2016
mason,north mason homelink program,17,0,0,0,0,0,2,13,2,5,12,9,23403,belfair,98528,1861,2016
mason,north mason senior high,736,5,13,6,19,5,100,558,49,397,339,306,23403,belfair,98528,3175,2016
mason,sand hill elementary,456,8,2,4,6,1,106,302,33,234,222,299,23403,belfair,98528,4320,2016
pacific,north river,63,1,0,0,0,6,14,42,0,32,31,44,25200,cosmopolis,98537,2292,2016
thurston,aspire middle,308,1,26,0,26,8,29,192,52,125,183,77,34003,lacey,98513,5168,2016
thurston,chambers prairie elementary,580,2,22,22,44,51,143,248,92,309,271,323,34003,lacey,98513,5167,2016
thurston,chinook middle,1000,10,96,13,109,58,185,514,124,558,442,436,34003,lacey,98516,3361,2016
thurston,evergreen forest elementary,513,19,15,3,18,28,81,266,101,236,277,192,34003,lacey,98503,4058,2016
thurston,horizons elementary,676,3,43,10,53,44,117,379,80,357,319,170,34003,lacey,98513,4408,2016
thurston,komachin middle,736,6,52,26,78,39,115,400,98,376,360,339,34003,lacey,98503,4409,2016
thurston,lacey elementary,459,3,20,10,30,11,109,245,61,242,217,295,34003,lacey,98503,3653,2016
thurston,lakes elementary,742,5,42,16,58,37,120,401,121,381,361,299,34003,lacey,98503,3539,2016
thurston,lydia hawk elementary,382,7,32,22,54,10,136,131,44,201,181,285,34003,lacey,98503,3262,2016
thurston,meadows elementary,425,8,26,8,34,17,107,183,76,212,213,257,34003,lacey,98513,4255,2016
thurston,mountain view elementary,715,8,57,21,78,32,165,344,88,374,341,412,34003,lacey,98503,3130,2016
thurston,nisqually middle,797,26,53,27,80,46,177,340,128,419,378,433,34003,lacey,98503,3611,2016
thurston,north thurston high,1504,17,159,18,177,69,262,840,139,771,733,493,34003,lacey,98506,3010,2016
thurston,olympic view elementary,755,6,58,15,73,27,116,422,111,404,351,212,34003,lacey,98516,3709,2016
thurston,pleasant glade elementary,427,5,53,6,59,19,96,174,74,212,215,279,34003,lacey,98516,4271,2016
thurston,river ridge high,1093,30,73,37,110,69,232,499,153,594,499,457,34003,lacey,98513,4427,2016
thurston,seven oaks elementary,576,2,31,15,46,31,109,313,75,297,279,299,34003,lacey,98503,4368,2016
thurston,south bay elementary,642,11,27,5,32,23,88,412,76,323,319,208,34003,lacey,98506,2754,2016
thurston,south sound high,178,4,8,3,11,10,31,100,22,86,92,115,34003,lacey,98516,4314,2016
thurston,timberline high,1814,24,116,50,166,122,301,955,246,973,841,614,34003,lacey,98503,3710,2016
thurston,woodland elementary,547,5,17,9,26,22,95,329,70,282,265,203,34003,lacey,98503,4122,2016
stevens,northport elementary,110,0,1,2,3,0,13,91,3,58,52,81,33211,northport,99157,2062,2016
stevens,northport high,56,3,3,0,3,0,3,46,1,33,23,31,33211,northport,99157,2958,2016
stevens,northport homelink program,59,0,2,0,2,0,7,50,0,26,33,38,33211,northport,99157,5252,2016
king,arrowhead elementary,417,1,40,0,40,13,38,289,36,201,216,64,17417,kenmore,98028,3107,2016
king,bear creek elementary,429,0,87,0,87,2,31,275,34,221,208,18,17417,woodinville,98077,4305,2016
king,bothell high,1650,15,225,5,230,50,203,1037,115,882,768,287,17417,bothell,98011,3106,2016
king,c o sorenson,119,1,14,0,14,3,27,63,11,88,31,9,17417,bothell,98011,2493,2016
king,canyon creek elementary,742,2,176,0,176,25,85,371,83,374,368,109,17417,bothell,98021,4017,2016
king,cottage lake elementary,372,0,20,1,21,5,45,275,26,212,160,46,17417,woodinville,98077,3234,2016
king,crystal springs elementary,680,0,145,4,149,25,136,295,75,319,361,165,17417,bothell,98021,3105,2016
king,east ridge elementary,338,0,20,0,20,0,15,281,22,170,168,17,17417,woodinville,98077,4379,2016
king,fernwood elementary,860,2,309,1,310,11,73,397,67,445,415,70,17417,bothell,98012,4306,2016
king,frank love elementary,761,3,110,1,111,16,97,460,74,366,395,149,17417,bothell,98021,4355,2016
king,hollywood hill elementary,369,2,20,0,20,0,42,274,31,197,172,40,17417,woodinville,98072,4124,2016
king,inglemoor hs,1504,5,244,5,249,29,184,936,101,743,761,213,17417,kenmore,98028,3492,2016
king,kenmore elementary,548,0,51,1,52,14,160,272,50,281,267,202,17417,kenmore,98028,2993,2016
king,kokanee elementary,722,2,235,7,242,11,57,350,60,407,315,78,17417,woodinville,98072,4455,2016
king,lockwood elementary,552,3,87,0,87,10,52,349,51,270,282,45,17417,bothell,98021,3390,2016
king,maywood hills elementary,660,1,90,0,90,12,87,405,65,333,327,137,17417,bothell,98011,3344,2016
king,moorlands elementary,739,1,92,1,93,12,70,513,50,380,359,61,17417,kenmore,98028,3442,2016
king,northshore networks,157,1,7,1,8,1,17,120,10,67,90,20,17417,bothell,98021,1814,2016
king,northshore online,23,0,2,0,2,1,0,19,1,14,9,5,17417,bothell,98021,5331,2016
king,northshore special services,137,1,32,0,32,2,19,70,13,88,49,0,17417,bothell,98021,1815,2016
king,secondary academy for success,128,3,3,3,6,2,16,91,10,70,58,33,17417,bothell,98021,3811,2016
king,shelton view elementary,548,1,155,1,156,9,47,282,53,287,261,57,17417,bothell,98021,3679,2016
king,sunrise elementary,393,0,88,0,88,4,15,259,27,202,191,14,17417,redmond,98052,4187,2016
king,wellington elementary,541,0,62,0,62,5,41,387,46,275,266,40,17417,woodinville,98072,4069,2016
king,westhill elementary,495,0,45,2,47,17,62,300,69,246,249,94,17417,bothell,98011,3287,2016
king,woodin elementary,615,0,64,3,67,6,224,279,39,334,281,189,17417,bothell,98011,3749,2016
king,woodinville hs,1407,1,119,4,123,19,131,1043,90,762,645,112,17417,woodinville,98072,4208,2016
king,woodmoor elementary,829,7,104,0,104,9,187,432,90,426,403,214,17417,bothell,98011,4377,2016
island,broadview elementary,530,1,43,10,53,22,66,303,85,271,259,204,15201,oak harbor,98277,3477,2016
island,crescent harbor elem,551,1,16,4,20,24,103,342,61,277,274,298,15201,oak harbor,98277,3377,2016
island,hillcrest elementary,556,3,27,2,29,14,81,364,65,278,278,171,15201,oak harbor,98277,4328,2016
island,homeconnection,282,0,5,0,5,4,18,242,13,142,140,47,15201,oak harbor,98277,1758,2016
island,igrad academy,14,0,0,0,0,2,1,10,1,7,7,6,15201,oak harbor,98277,5343,2016
island,north whidbey middle,503,2,39,4,43,23,87,305,43,288,215,251,15201,oak harbor,98277,3939,2016
island,oak harbor elementary,552,3,31,6,37,21,109,304,78,281,271,227,15201,oak harbor,98277,2696,2016
island,oak harbor high,1577,7,190,14,204,91,202,970,103,810,767,519,15201,oak harbor,98277,2974,2016
island,olympic view elem,528,6,35,6,41,33,114,256,78,262,266,280,15201,oak harbor,98277,3566,2016
island,special education,102,0,3,0,3,9,8,68,14,70,32,15,15201,oak harbor,98277,3662,2016
whitman,oakesdale elementary,67,0,0,0,0,0,3,64,0,33,34,21,38324,oakesdale,99158,3205,2016
whitman,oakesdale high,37,0,0,0,0,0,3,34,0,19,18,13,38324,oakesdale,99158,2432,2016
grays harbor,oakville elementary,136,37,0,2,2,0,15,74,8,76,60,93,14400,oakville,98568,2922,2016
grays harbor,oakville high,92,29,1,2,3,2,11,47,0,41,51,69,14400,oakville,98568,2283,2016
pacific,hilltop,316,7,5,0,5,0,45,239,20,159,157,205,25101,ilwaco,98624,2517,2016
pacific,ilwaco high,286,4,3,0,3,0,45,218,16,159,127,154,25101,ilwaco,98624,4220,2016
pacific,long beach elementary,243,2,2,0,2,0,52,171,16,137,106,158,25101,long beach,98631,3531,2016
pacific,ocean beach early childhood center,14,0,0,0,0,0,3,11,0,8,6,6,25101,long beach,98631,5179,2016
pacific,ocean park elementary,164,0,0,0,0,0,46,108,10,84,80,127,25101,ocean park,98640,4039,2016
grays harbor,ocosta elementary,312,10,2,0,2,3,75,190,32,171,141,245,14172,westport,98595,3025,2016
grays harbor,ocosta junior - senior high,303,18,3,0,3,0,43,204,35,147,156,166,14172,westport,98595,3024,2016
lincoln,odessa high,106,4,0,0,0,1,8,93,0,56,50,29,22105,odessa,99159,2443,2016
lincoln,p c jantz elementary,126,1,0,0,0,1,16,108,0,70,56,79,22105,odessa,99159,2769,2016
okanogan,grainger elementary,491,42,3,0,3,3,143,274,26,262,229,328,24105,okanogan,98840,2539,2016
okanogan,okanogan alternative high,14,2,0,0,0,0,6,5,1,9,5,12,24105,omak,98841,1980,2016
okanogan,okanogan high,274,23,1,0,1,0,52,187,11,132,142,122,24105,okanogan,98840,2246,2016
okanogan,okanogan middle,252,18,1,0,1,0,54,158,21,132,120,135,24105,okanogan,98840,2245,2016
okanogan,okanogan outreach alternative,70,8,0,0,0,0,14,44,4,28,42,64,24105,okanogan,98840,5151,2016
thurston,avanti high,146,0,0,1,1,0,17,114,14,65,81,44,34111,olympia,98501,1768,2016
thurston,boston harbor elementary,156,0,3,0,3,2,13,124,14,83,73,35,34111,olympia,98506,2487,2016
thurston,capital high,1429,10,104,5,109,38,140,1014,118,754,675,377,34111,olympia,98502,3960,2016
thurston,centennial elementary olympia,514,0,66,0,66,8,43,341,56,262,252,76,34111,olympia,98501,4367,2016
thurston,garfield elementary,401,2,34,0,34,13,69,228,55,212,189,241,34111,olympia,98502,2448,2016
thurston,jefferson middle,422,0,50,1,51,10,51,262,48,212,210,161,34111,olympia,98502,3133,2016
thurston,julia butler hansen elementary,475,4,47,0,47,28,87,236,73,239,236,230,34111,olympia,98502,4472,2016
thurston,leland p brown elementary,322,1,8,1,9,11,44,218,39,153,169,200,34111,olympia,98502,3540,2016
thurston,lincoln elementary,290,1,5,0,5,4,27,231,22,148,142,92,34111,olympia,98501,2342,2016
thurston,madison elementary,239,0,11,0,11,10,46,140,32,125,114,123,34111,olympia,98501,3066,2016
thurston,mckenny elementary,364,1,24,0,24,8,52,232,47,209,155,112,34111,olympia,98501,4458,2016
thurston,mclane elementary,333,2,21,0,21,13,33,242,22,180,153,122,34111,olympia,98502,2621,2016
thurston,olympia high,1835,5,182,4,186,29,156,1292,167,915,920,325,34111,olympia,98501,3132,2016
thurston,olympia regional learning academy,390,2,3,1,4,7,17,335,25,198,192,114,34111,olympia,98501,5078,2016
thurston,olympia regional learning academy - montessori,203,1,15,0,15,2,14,151,20,105,98,33,34111,olympia,98501,5248,2016
thurston,pioneer elementary,487,0,32,1,33,6,35,381,32,277,210,110,34111,olympia,98501,3697,2016
thurston,reeves middle,412,2,19,2,21,9,47,299,34,212,200,133,34111,olympia,98506,3696,2016
thurston,roosevelt elementary,402,1,13,0,13,4,52,286,46,209,193,167,34111,olympia,98506,2778,2016
thurston,thurgood marshall middle,388,2,27,1,28,19,40,268,31,211,177,146,34111,olympia,98502,4473,2016
thurston,washington middle,762,3,74,3,77,12,63,530,77,412,350,129,34111,olympia,98501,3711,2016
okanogan,e omak elementary,329,73,2,0,2,0,74,140,40,175,154,147,24019,omak,98841,3051,2016
okanogan,highlands high,20,7,0,0,0,0,4,9,0,8,12,5,24019,omak,98841,4279,2016
okanogan,n omak elementary,443,76,3,0,3,1,131,197,35,233,210,240,24019,omak,98841,2999,2016
okanogan,omak high,428,128,5,0,5,3,92,180,20,213,215,122,24019,omak,98841,2031,2016
okanogan,omak middle,292,72,1,0,1,0,71,136,12,156,136,132,24019,omak,98841,4237,2016
okanogan,washington virtual academy omak elementary,1431,26,78,23,101,102,116,1057,29,713,718,626,24019,omak,98841,5195,2016
okanogan,washington virtual academy omak high,1165,13,40,7,47,49,78,963,15,528,637,330,24019,omak,98841,5197,2016
okanogan,washington virtual academy omak middle,1320,26,44,18,62,85,92,1042,13,657,663,529,24019,omak,98841,5196,2016
lewis,onalaska elementary,342,2,0,0,0,1,33,283,23,181,161,232,21300,onalaska,98570,3239,2016
lewis,onalaska high,224,4,1,0,1,1,24,189,5,120,104,108,21300,onalaska,98570,2331,2016
lewis,onalaska middle,146,1,2,0,2,0,19,120,4,78,68,89,21300,onalaska,98570,4335,2016
stevens,onion creek elementary,40,0,0,0,0,0,2,35,3,24,16,38,33030,colville,99114,2049,2016
san juan,oasis k-12,430,1,8,0,8,13,16,372,20,167,263,44,28137,eastsound,98245,1892,2016
san juan,orcas island elementary,211,1,4,1,5,2,47,143,13,125,86,102,28137,eastsound,98245,2749,2016
san juan,orcas island high,132,1,9,2,11,2,13,103,2,72,60,36,28137,eastsound,98245,2750,2016
san juan,orcas island middle,55,0,0,0,0,0,5,44,6,22,33,20,28137,eastsound,98245,4558,2016
san juan,waldron island,11,0,0,0,0,0,0,10,1,4,7,1,28137,waldron island,98297,3808,2016
spokane,orchard prairie elementary,87,0,0,0,0,2,5,80,0,45,42,10,32123,spokane,99217,3723,2016
ferry,orient elem,33,0,1,0,1,0,0,32,0,18,15,21,10065,orient,99160,2136,2016
douglas,orondo elementary and middle,156,0,0,0,0,0,143,13,0,73,83,136,09013,orondo,98843,2666,2016
okanogan,oroville elementary,310,8,5,1,6,0,126,164,6,160,150,223,24410,oroville,98844,2422,2016
okanogan,oroville middle-high,259,5,4,1,5,1,80,164,4,144,115,150,24410,oroville,98844,2706,2016
pierce,orting high,804,3,7,6,13,11,88,633,56,403,401,208,27344,orting,98360,2942,2016
pierce,orting middle,540,3,9,3,12,2,74,403,46,276,264,177,27344,orting,98360,4262,2016
pierce,orting primary,452,6,5,2,7,7,61,327,44,224,228,175,27344,orting,98360,2360,2016
pierce,orting special education,17,1,0,1,1,1,5,8,1,11,6,5,27344,orting,98360,5011,2016
pierce,ptarmigan ridge elementary,685,4,10,1,11,9,106,503,52,351,334,257,27344,orting,98360,4547,2016
adams,desert oasis high,81,0,0,0,0,0,76,5,0,38,43,81,01147,othello,99344,5367,2016
adams,hiawatha elementary,555,0,0,0,0,0,488,66,1,283,272,486,01147,othello,99344,2961,2016
adams,lutacaga elementary,566,0,1,0,1,1,534,28,2,284,282,461,01147,othello,99344,2902,2016
adams,mcfarland middle,923,0,3,0,3,2,807,111,0,518,405,726,01147,othello,99344,3471,2016
adams,othello high,1062,0,3,0,3,0,919,132,8,530,532,783,01147,othello,99344,3015,2016
adams,scootney springs elementary,567,0,2,0,2,1,484,76,4,304,263,448,01147,othello,99344,3730,2016
adams,wahitis elementary,528,0,0,0,0,0,481,45,2,272,256,427,01147,othello,99344,5285,2016
douglas,palisades elementary,32,0,0,0,0,0,20,12,0,18,14,30,09102,palisades,98845,2502,2016
whitman,palouse at garfield middle,37,0,0,0,0,1,4,31,1,18,19,11,38301,palouse,99161,1961,2016
whitman,palouse elementary,93,0,0,0,0,0,9,76,8,43,50,30,38301,palouse,99161,2622,2016
whitman,palouse high,53,1,0,0,0,1,6,43,2,34,19,16,38301,palouse,99161,2634,2016
franklin,barbara mcclintock stem elementary,679,0,10,1,11,5,326,307,30,339,340,358,11001,pasco,99301,5391,2016
franklin,captain gray stem elementary,587,0,0,0,0,6,541,32,8,279,308,584,11001,pasco,99301,5392,2016
franklin,chiawana high,2549,3,51,10,61,49,1652,732,52,1362,1187,1511,11001,pasco,99301,5164,2016
franklin,edwin markham elementary,372,2,0,0,0,1,117,248,4,211,161,192,11001,pasco,99301,3425,2016
franklin,ellen ochoa middle,700,0,1,0,1,7,657,29,6,364,336,650,11001,pasco,99301,4564,2016
franklin,emerson elementary,646,0,0,0,0,3,590,49,4,330,316,625,11001,pasco,99301,2967,2016
franklin,internet pasco academy of learning,1,0,0,0,0,0,0,1,0,0,1,12,11001,pasco,99301,5393,2016
franklin,james mcgee elementary,612,0,11,2,13,14,298,258,29,340,272,314,11001,pasco,99301,4155,2016
franklin,mark twain elementary,778,0,1,0,1,5,482,267,23,409,369,534,11001,pasco,99301,3085,2016
franklin,maya angelou elementary,936,0,21,8,29,15,451,398,43,447,489,429,11001,pasco,99301,4595,2016
franklin,mcloughlin middle,1176,3,28,2,30,19,575,496,53,605,571,565,11001,pasco,99301,2267,2016
franklin,new horizons high,269,0,0,2,2,9,232,22,4,148,121,219,11001,pasco,99301,3912,2016
franklin,pasco early childhood,51,0,1,0,1,0,31,18,1,34,17,30,11001,pasco,99301,1970,2016
franklin,pasco senior high,2059,2,17,0,17,30,1612,364,34,1067,992,1445,11001,pasco,99301,2917,2016
franklin,robert frost elementary,651,0,0,1,1,3,503,137,7,323,328,587,11001,pasco,99301,3515,2016
franklin,rosalind franklin stem elementary,745,0,19,0,19,5,368,328,25,405,340,394,11001,pasco,99301,5345,2016
franklin,ruth livingston elementary,794,4,19,3,22,11,256,450,51,407,387,305,11001,pasco,99301,4041,2016
franklin,stevens middle,654,0,2,0,2,6,586,52,8,322,332,599,11001,pasco,99301,3324,2016
okanogan,pateros elementary,129,0,0,0,0,0,76,53,0,72,57,86,24122,pateros,98846,2396,2016
okanogan,pateros high,143,0,0,0,0,0,75,58,10,74,69,94,24122,pateros,98846,2397,2016
lewis,pe ell,271,7,1,0,1,1,15,236,11,137,134,156,21301,pe ell,98572,2858,2016
lewis,trojan alternative,3,0,0,0,0,0,0,3,0,2,1,0,21301,pe ell,98572,1925,2016
pierce,artondale elementary,417,2,7,1,8,2,42,321,42,207,210,78,27401,gig harbor,98335,3299,2016
pierce,discovery elementary,479,5,11,2,13,6,44,378,33,242,237,119,27401,gig harbor,98335,4080,2016
pierce,evergreen elementary,222,3,0,0,0,3,16,185,15,114,108,142,27401,lakebay,98349,3055,2016
pierce,gig harbor high,1726,7,47,4,51,18,118,1427,105,891,835,225,27401,gig harbor,98335,4081,2016
pierce,goodman middle,513,3,18,4,22,5,46,384,53,266,247,111,27401,gig harbor,98335,2294,2016
pierce,harbor heights elementary,581,1,6,0,6,3,77,433,61,304,277,160,27401,gig harbor,98335,2944,2016
pierce,harbor ridge middle,613,4,12,3,15,4,42,498,50,315,298,130,27401,gig harbor,98332,4387,2016
pierce,henderson bay alt high,146,1,1,0,1,3,10,114,17,76,70,80,27401,gig harbor,98332,1516,2016
pierce,key peninsula middle,373,3,0,0,0,2,13,319,36,188,185,181,27401,lakebay,98349,4156,2016
pierce,kopachuck middle,539,0,8,0,8,1,39,448,43,264,275,88,27401,gig harbor,98335,4219,2016
pierce,minter creek elementary,392,2,7,0,7,2,29,314,38,202,190,143,27401,gig harbor,98329,4189,2016
pierce,peninsula high,1428,6,28,7,35,9,84,1155,139,725,703,439,27401,gig harbor,98332,2681,2016
pierce,purdy elementary,623,2,17,2,19,6,54,484,58,302,321,119,27401,gig harbor,98332,3685,2016
pierce,vaughn elementary,372,1,1,0,1,1,28,311,30,209,163,168,27401,vaughn,98394,3056,2016
pierce,voyager elementary,503,3,10,1,11,6,39,417,27,261,242,83,27401,gig harbor,98335,4307,2016
garfield,pomeroy elementary,174,0,2,0,2,0,9,156,7,95,79,97,12110,pomeroy,99347,3087,2016
garfield,pomeroy jr sr high,211,0,6,0,6,0,8,193,4,97,114,67,12110,pomeroy,99347,2241,2016
clallam,dry creek elementary,386,70,1,0,1,1,23,222,69,194,192,265,05121,port angeles,98363,4494,2016
clallam,franklin elementary,406,10,12,0,12,7,41,299,37,222,184,237,05121,port angeles,98362,2909,2016
clallam,hamilton elementary,358,11,7,1,8,4,43,246,46,181,177,195,05121,port angeles,98363,3079,2016
clallam,jefferson elementary,338,8,9,2,11,4,51,230,34,175,163,217,05121,port angeles,98362,2368,2016
clallam,lincoln high,86,6,0,0,0,3,7,61,9,40,46,68,05121,port angeles,98363,4003,2016
clallam,parents as partners,11,3,0,0,0,0,0,7,1,6,5,7,05121,port angeles,98362,1715,2016
clallam,port angeles high,1166,36,17,1,18,12,91,906,103,595,571,472,05121,port angeles,98362,2908,2016
clallam,roosevelt elementary,502,7,4,0,4,0,19,423,49,262,240,238,05121,port angeles,98362,5115,2016
clallam,special education,26,1,2,1,3,1,3,18,0,17,9,19,05121,port angeles,98362,1897,2016
clallam,stevens middle,555,18,10,0,10,4,42,414,67,282,273,279,05121,port angeles,98363,3318,2016
jefferson,blue heron middle,377,3,7,1,8,7,30,312,17,201,176,183,16050,port townsend,98368,4475,2016
jefferson,ocean,70,2,3,0,3,0,1,60,4,25,45,35,16050,port townsend,98368,1798,2016
jefferson,port townsend high,368,5,9,2,11,4,28,296,24,190,178,138,16050,port townsend,98368,2503,2016
walla walla,prescott elementary,100,0,0,0,0,0,77,22,1,60,40,95,36402,prescott,99348,3574,2016
walla walla,prescott special ed pre-school,4,0,0,0,0,0,4,0,0,3,1,3,36402,prescott,99348,5157,2016
benton,housel middle,624,4,8,2,10,11,347,251,1,313,311,412,03116,prosser,99350,2906,2016
benton,keene-riverview elementary,494,4,15,0,15,6,323,146,0,266,228,333,03116,prosser,99350,2195,2016
benton,prosser heights elementary,474,2,5,3,8,1,291,169,3,221,253,329,03116,prosser,99350,3316,2016
benton,prosser high,897,7,21,2,23,3,541,321,2,461,436,517,03116,prosser,99350,2508,2016
benton,whitstran elementary,276,0,2,0,2,1,204,69,0,138,138,231,03116,prosser,99350,2905,2016
whitman,franklin elementary,453,2,61,1,62,15,33,314,27,238,215,195,38267,pullman,99163,2587,2016
whitman,jefferson elementary,496,2,56,0,56,16,63,318,41,265,231,173,38267,pullman,99163,3203,2016
whitman,lincoln middle,626,3,64,4,68,13,57,444,41,305,321,187,38267,pullman,99163,3419,2016
whitman,pullman high,797,6,65,3,68,24,90,564,45,419,378,194,38267,pullman,99163,2499,2016
whitman,sunnyside elementary,466,1,49,1,50,8,51,317,39,252,214,145,38267,pullman,99163,3614,2016
pierce,aylen jr high,642,10,21,5,26,16,111,433,46,343,299,224,27003,puyallup,98371,3447,2016
pierce,ballou jr high,843,8,68,8,76,39,124,497,99,431,412,293,27003,puyallup,98373,3750,2016
pierce,brouillet elementary,720,8,30,14,44,22,90,428,128,382,338,185,27003,puyallup,98375,4361,2016
pierce,carson elementary,975,3,65,26,91,60,149,534,138,501,474,354,27003,puyallup,98375,5088,2016
pierce,edgemont jr high,446,2,24,5,29,20,57,293,45,234,212,144,27003,edgewood,98372,2575,2016
pierce,edgerton elementary,752,4,23,12,35,34,84,505,90,381,371,164,27003,puyallup,98374,5093,2016
pierce,emerald ridge high,1513,13,67,16,83,66,199,972,180,765,748,318,27003,puyallup,98374,4540,2016
pierce,ferrucci jr high,696,12,17,6,23,27,102,440,92,369,327,284,27003,puyallup,98374,4183,2016
pierce,firgrove elementary,601,1,41,8,49,32,209,254,56,334,267,367,27003,puyallup,98373,2496,2016
pierce,fruitland elementary,630,1,29,11,40,16,69,412,92,332,298,174,27003,puyallup,98371,3557,2016
pierce,glacier view junior high,803,5,33,7,40,32,122,499,105,417,386,211,27003,puyallup,98374,5142,2016
pierce,kalles junior high,884,8,58,7,65,25,103,597,86,447,437,230,27003,puyallup,98372,3052,2016
pierce,karshner elementary,323,7,7,5,12,4,127,142,31,172,151,186,27003,puyallup,98371,2870,2016
pierce,maplewood elementary,431,1,16,1,17,3,35,318,57,222,209,106,27003,puyallup,98371,2498,2016
pierce,meeker elementary,447,5,13,4,17,12,67,295,51,226,221,129,27003,puyallup,98371,2334,2016
pierce,mt view elementary,322,3,8,6,14,4,45,224,32,155,167,117,27003,edgewood,98372,3572,2016
pierce,northwood elementary,382,1,35,10,45,19,47,222,48,203,179,136,27003,edgewood,98371,3927,2016
pierce,pope elementary,575,7,14,2,16,16,87,386,63,282,293,190,27003,puyallup,98374,4146,2016
pierce,psd special services,121,1,2,2,4,3,34,72,7,79,42,2,27003,puyallup,98371,3951,2016
pierce,puyallup high,1753,19,92,11,103,46,227,1189,169,907,846,438,27003,puyallup,98371,2125,2016
pierce,puyallup parent partnership program,1,0,0,0,0,0,0,1,0,1,0,1,27003,puyallup,98373,5322,2016
pierce,ridgecrest elementary,586,7,14,10,24,14,75,405,61,308,278,224,27003,puyallup,98374,4121,2016
pierce,rogers high,1814,9,101,36,137,99,270,1080,219,939,875,496,27003,puyallup,98373,3645,2016
pierce,shaw road elementary,635,2,48,2,50,9,62,439,73,341,294,120,27003,puyallup,98372,4414,2016
pierce,spinning elementary,317,8,10,7,17,11,64,172,45,163,154,182,27003,puyallup,98372,2497,2016
pierce,stahl junior high,855,10,55,28,83,58,130,454,120,412,443,315,27003,puyallup,98375,4443,2016
pierce,stewart elementary,352,3,17,6,23,21,71,194,40,174,178,222,27003,puyallup,98372,2311,2016
pierce,sunrise elementary,517,3,15,10,25,24,88,303,74,275,242,238,27003,puyallup,98374,3896,2016
pierce,walker high,139,1,0,2,2,1,25,99,11,70,69,75,27003,puyallup,98372,3972,2016
pierce,waller road elementary,306,8,6,4,10,4,48,193,43,171,135,158,27003,tacoma,98443,2495,2016
pierce,wildwood elementary,485,3,13,6,19,14,124,265,60,269,216,278,27003,puyallup,98374,3558,2016
pierce,woodland elementary,702,6,22,20,42,30,110,417,97,345,357,318,27003,puyallup,98373,2519,2016
pierce,zeiger elementary,701,2,56,8,64,33,109,393,100,374,327,239,27003,puyallup,98373,4496,2016
jefferson,queets-clearwater elementary,19,12,0,0,0,0,0,0,7,6,13,18,16020,forks,98331,2491,2016
jefferson,crossroads community,10,0,0,0,0,0,2,7,1,8,2,4,16048,quilcene,98376,5081,2016
jefferson,pearl,106,1,4,1,5,0,6,89,5,60,46,0,16048,quilcene,98376,5236,2016
jefferson,quilcene high and elementary,207,6,2,0,2,0,8,177,14,113,94,100,16048,quilcene,98376,2474,2016
clallam,district run home,20,0,0,0,0,0,1,17,2,11,9,7,05402,forks,98331,1671,2016
clallam,forks alternative,24,2,0,0,0,0,4,17,1,13,11,15,05402,forks,98331,1500,2016
clallam,forks elementary,344,40,2,0,2,0,112,160,30,177,167,236,05402,forks,98331,3737,2016
clallam,forks intermediate,240,15,1,0,1,0,73,124,27,126,114,168,05402,forks,98331,5363,2016
clallam,forks junior-senior high,452,46,7,0,7,3,133,228,35,245,207,239,05402,forks,98331,2349,2016
clallam,insight school of washington,2014,26,39,15,54,111,257,1439,127,817,1197,1228,05402,forks,98331,5071,2016
grant,monument elementary,612,0,0,0,0,1,551,58,2,308,304,535,13144,quincy,98848,4536,2016
grant,mountain view elementary,444,0,0,0,0,1,400,42,1,228,216,385,13144,quincy,98848,3020,2016
grant,pioneer elementary,434,0,1,0,1,0,387,44,2,195,239,378,13144,quincy,98848,2919,2016
grant,quincy high,829,0,1,0,1,2,682,140,3,424,405,601,13144,quincy,98848,3088,2016
grant,quincy junior high,388,0,0,0,0,3,335,50,0,198,190,327,13144,quincy,98848,2510,2016
thurston,rainier elementary,343,1,3,2,5,2,39,272,24,176,167,201,34307,rainier,98576,4486,2016
thurston,rainier middle,174,1,1,0,1,0,20,140,12,83,91,92,34307,rainier,98576,2158,2016
thurston,rainier senior high,286,4,2,0,2,2,19,249,10,151,135,114,34307,rainier,98576,2468,2016
pacific,developmental preschool,7,0,0,0,0,0,1,6,0,3,4,4,25116,raymond,98577,1672,2016
pacific,raymond elementary,276,6,16,2,18,0,72,173,7,137,139,157,25116,raymond,98577,2803,2016
pacific,raymond jr sr high,250,14,12,0,12,1,67,150,6,137,113,98,25116,raymond,98577,2357,2016
lincoln,reardan elementary,253,8,0,0,0,0,8,215,22,134,119,126,22009,reardan,99029,2864,2016
lincoln,reardan middle-senior high,261,11,0,0,0,1,13,225,11,128,133,86,22009,reardan,99029,2478,2016
king,benson hill elementary,554,3,178,8,186,68,90,130,77,303,251,290,17403,renton,98058,3587,2016
king,bryn mawr elementary,473,8,117,5,122,121,94,62,66,238,235,309,17403,seattle,98178,2439,2016
king,campbell hill elementary,494,4,129,13,142,164,99,34,51,259,235,387,17403,seattle,98178,3034,2016
king,cascade elementary,557,6,94,7,101,87,163,125,75,269,288,369,17403,renton,98058,3337,2016
king,dimmitt middle,939,5,257,17,274,246,244,106,64,445,494,636,17403,seattle,98178,3280,2016
king,griffin home,5,1,0,0,0,0,1,2,1,5,0,4,17403,renton,98056,1534,2016
king,hazelwood elementary,630,3,158,0,158,34,67,308,60,330,300,138,17403,newcastle,98056,3485,2016
king,hazen senior high,1600,12,464,4,468,106,325,630,59,845,755,530,17403,renton,98059,3630,2016
king,highlands elementary,577,1,107,5,112,58,270,97,39,297,280,402,17403,renton,98056,2640,2016
king,honey dew elementary,549,1,86,1,87,44,272,118,27,285,264,357,17403,renton,98058,5229,2016
king,kennydale elementary,607,1,172,4,176,31,116,224,59,316,291,211,17403,renton,98056,2597,2016
king,lakeridge elementary,415,4,54,11,65,236,56,32,22,183,232,354,17403,seattle,98178,2929,2016
king,lindbergh senior high,1248,13,349,11,360,217,216,390,52,636,612,599,17403,renton,98058,3741,2016
king,maplewood heights elementary,693,1,205,5,210,22,145,246,69,354,339,241,17403,renton,98059,3586,2016
king,mcknight middle,1225,5,364,5,369,72,312,404,63,611,614,478,17403,renton,98056,3035,2016
king,meadow crest early childhood education center,188,2,41,1,42,28,56,36,24,134,54,106,17403,renton,98056,5313,2016
king,nelsen middle,990,5,244,15,259,174,207,278,67,535,455,582,17403,renton,98055,3434,2016
king,open door youth reengagement renton,112,5,5,1,6,40,30,22,9,55,57,59,17403,renton,98055,5335,2016
king,out of district facility,19,0,0,0,0,4,5,8,2,14,5,8,17403,renton,98055,1648,2016
king,renton academy,37,1,2,0,2,16,5,11,2,32,5,34,17403,renton,98055,5070,2016
king,renton park elementary,462,0,63,14,77,101,95,130,59,242,220,299,17403,renton,98058,3521,2016
king,renton senior high,1351,10,397,8,405,441,287,146,62,691,660,840,17403,renton,98055,2475,2016
king,sierra heights elementary,635,2,151,2,153,36,177,204,63,334,301,265,17403,renton,98059,3668,2016
king,talbot hill elementary,493,2,144,5,149,95,67,109,71,258,235,215,17403,renton,98055,3740,2016
king,tiffany park elementary,476,1,86,1,87,74,105,165,44,237,239,285,17403,renton,98058,3702,2016
ferry,republic elementary,161,4,4,0,4,1,5,122,25,97,64,121,10309,republic,99166,2789,2016
ferry,republic junior high,36,0,0,0,0,1,3,26,6,18,18,23,10309,republic,99166,3559,2016
ferry,republic parent partner,38,0,0,0,0,0,2,36,0,27,11,9,10309,republic,99166,1898,2016
ferry,republic senior high,98,3,2,0,2,1,2,86,4,45,53,51,10309,republic,99166,3579,2016
benton,badger mountain elementary,610,0,28,0,28,13,118,421,30,313,297,191,03400,richland,99352,4060,2016
benton,carmichael middle,938,5,26,1,27,22,170,679,35,469,469,334,03400,richland,99352,2721,2016
benton,chief joseph middle,794,7,25,5,30,29,160,537,31,379,415,425,03400,richland,99352,2785,2016
benton,enterprise middle,1136,10,48,1,49,16,131,909,21,538,598,228,03400,west richland,99353,3926,2016
benton,hanford high,1914,15,112,1,113,57,231,1449,49,1013,901,440,03400,richland,99352,3833,2016
benton,jason lee elementary,576,0,13,0,13,7,117,394,45,298,278,382,03400,richland,99352,2786,2016
benton,jefferson elementary,452,3,7,7,14,27,126,269,13,229,223,317,03400,richland,99352,2642,2016
benton,lewis & clark elementary,577,4,31,1,32,5,140,362,34,280,297,323,03400,richland,99352,2657,2016
benton,marcus whitman elementary,437,3,4,0,4,9,124,273,24,216,221,325,03400,richland,99352,2656,2016
benton,orchard elementary,658,0,56,1,57,6,76,482,37,346,312,123,03400,richland,99352,5419,2016
benton,richland high,2023,9,73,6,79,41,292,1567,35,1032,991,542,03400,richland,99352,3511,2016
benton,rivers edge high,219,4,1,0,1,5,45,158,6,117,102,125,03400,richland,99352,4295,2016
benton,sacajawea elementary,483,1,11,3,14,17,116,310,25,254,229,218,03400,richland,99352,3732,2016
benton,special programs,129,0,3,0,3,2,24,92,8,91,38,3,03400,richland,99352,2001,2016
benton,tapteal elementary,572,5,6,0,6,1,154,364,42,282,290,278,03400,west richland,99353,4059,2016
benton,three rivers home link,531,0,13,0,13,7,32,472,7,287,244,93,03400,richland,99352,5165,2016
benton,white bluffs elementary,630,2,27,0,27,3,68,504,26,324,306,82,03400,richland,99352,5092,2016
clark,ridgefield high,749,2,19,1,20,7,67,603,50,385,364,152,06122,ridgefield,98642,2390,2016
clark,south ridge elementary,600,1,13,3,16,6,92,448,37,322,278,178,06122,ridgefield,98642,3321,2016
clark,union ridge elementary,777,3,5,2,7,2,77,655,33,380,397,231,06122,ridgefield,98642,3786,2016
clark,view ridge middle,374,0,2,2,4,1,41,311,17,175,199,105,06122,ridgefield,98642,3891,2016
adams,lind ritzville middle,73,2,0,0,0,0,4,66,1,33,40,38,01160,lind,99341,5303,2016
adams,ritzville grade,171,0,3,0,3,6,15,146,1,105,66,83,01160,ritzville,99169,2719,2016
adams,ritzville high,117,4,3,0,3,1,9,100,0,58,59,28,01160,ritzville,99169,2132,2016
spokane,chattaroy elementary,256,5,2,1,3,1,13,222,12,132,124,169,32416,chattaroy,99003,2525,2016
spokane,independent scholar,63,2,0,0,0,0,1,60,0,37,26,49,32416,chattaroy,99003,1919,2016
spokane,riverside elementary,341,8,3,1,4,2,19,294,14,192,149,199,32416,chattaroy,99003,4033,2016
spokane,riverside high,482,14,3,1,4,5,19,435,5,237,245,204,32416,chattaroy,99003,4228,2016
spokane,riverside middle,328,10,2,1,3,2,13,296,4,179,149,170,32416,chattaroy,99003,3466,2016
king,carnation elementary,397,1,20,2,22,4,59,295,16,201,196,82,17407,carnation,98014,2485,2016
king,cedarcrest high,977,9,26,2,28,3,119,781,37,458,519,128,17407,duvall,98019,3524,2016
king,cherry valley elementary,508,1,17,3,20,2,76,380,29,257,251,73,17407,duvall,98019,3101,2016
king,choice,8,0,0,0,0,0,0,8,0,4,4,6,17407,carnation,98014,5244,2016
king,clip,31,1,1,0,1,0,3,22,4,17,14,17,17407,carnation,98014,1756,2016
king,eagle rock multiage,68,0,1,0,1,0,3,64,0,30,38,3,17407,duvall,98019,3006,2016
king,parade,107,0,1,0,1,0,3,99,4,54,53,5,17407,carnation,98014,1854,2016
king,stillwater elementary,458,1,5,0,5,2,78,348,24,250,208,66,17407,carnation,98014,4332,2016
king,tolt middle,693,4,19,4,23,4,82,546,34,330,363,104,17407,carnation,98014,4318,2016
thurston,grand mound elementary,502,16,2,0,2,1,99,341,43,252,250,272,34401,rochester,98579,3801,2016
thurston,h.e.a.r.t. high,24,0,0,0,0,1,4,15,4,11,13,12,34401,rochester,98579,1735,2016
thurston,rochester high,660,21,2,1,3,4,116,485,31,369,291,271,34401,rochester,98579,4326,2016
thurston,rochester middle,501,16,4,0,4,3,112,337,29,263,238,257,34401,rochester,98579,3067,2016
thurston,rochester primary,506,21,3,0,3,1,125,327,29,260,246,283,34401,rochester,98579,2527,2016
klickitat,roosevelt elementary,27,0,0,0,0,0,27,0,0,12,15,0,20403,roosevelt,99356,3530,2016
whitman,rosalia elementary & secondary,181,4,1,0,1,1,9,160,6,81,100,108,38320,rosalia,99170,3204,2016
grant,red rock elementary,592,3,0,0,0,0,502,87,0,294,298,493,13160,royal city,99357,3090,2016
grant,royal high,492,0,0,0,0,1,402,87,2,251,241,354,13160,royal city,99357,3516,2016
grant,royal intermediate,409,0,1,0,1,0,339,68,1,206,203,333,13160,royal city,99357,5388,2016
grant,royal middle,248,0,0,0,0,0,205,43,0,126,122,175,13160,royal city,99357,3620,2016
san juan,friday harbor elementary,384,4,3,0,3,1,75,282,19,183,201,187,28149,friday harbor,98250,2520,2016
san juan,friday harbor high,276,1,7,1,8,2,41,208,16,138,138,97,28149,friday harbor,98250,2879,2016
san juan,friday harbor middle,128,0,2,0,2,1,17,102,6,74,54,59,28149,friday harbor,98250,3011,2016
san juan,griffin bay,14,0,0,0,0,0,2,12,0,8,6,3,28149,friday harbor,98250,1963,2016
grays harbor,satsop elementary,67,0,2,0,2,0,11,51,3,30,37,29,14104,satsop,98583,2010,2016
king,adams elementary,545,2,20,1,21,24,57,385,56,288,257,85,17001,seattle,98107,2138,2016
king,aki kurose middle,721,3,293,8,301,237,120,24,36,382,339,579,17001,seattle,98118,3774,2016
king,alki elementary,413,5,9,0,9,35,38,279,47,224,189,83,17001,seattle,98116,2181,2016
king,arbor heights elementary,405,2,27,2,29,42,47,241,44,226,179,120,17001,seattle,98146,2730,2016
king,b f day elementary,283,0,22,1,23,36,27,162,35,151,132,95,17001,seattle,98103,3717,2016
king,bailey gatzert elementary,298,2,43,0,43,167,58,10,18,167,131,253,17001,seattle,98122,2307,2016
king,ballard high,1702,22,107,3,110,73,166,1236,95,865,837,203,17001,seattle,98117,2220,2016
king,beacon hill international,460,3,131,1,132,29,174,69,53,242,218,265,17001,seattle,98144,2070,2016
king,birth to 3 contracts,388,2,43,0,43,45,57,181,60,246,142,15,17001,seattle,98124,5048,2016
king,bridges transition,84,1,25,0,25,15,7,33,3,54,30,36,17001,seattle,98108,5406,2016
king,broadview-thomson k-8,628,3,72,2,74,133,146,210,62,323,305,352,17001,seattle,98133,2209,2016
king,bryant elementary,591,3,32,0,32,8,27,455,66,261,330,31,17001,seattle,98115,2372,2016
king,cascade parent partnership program,180,1,12,1,13,12,6,108,40,97,83,25,17001,seattle,98119,1751,2016
king,cascadia elementary,754,0,102,1,103,2,19,529,101,398,356,27,17001,seattle,98115,5292,2016
king,catharine blaine k-8,738,4,32,1,33,17,35,551,98,371,367,44,17001,seattle,98199,2838,2016
king,chief sealth international high,1174,23,194,25,219,246,325,291,70,584,590,699,17001,seattle,98126,3096,2016
king,cleveland high school stem,842,5,388,4,392,270,83,56,36,439,403,508,17001,seattle,98108,2392,2016
king,concord international,392,3,30,5,35,38,249,49,18,200,192,327,17001,seattle,98108,2199,2016
king,daniel bagley elementary,432,0,47,0,47,18,26,290,51,223,209,62,17001,seattle,98103,2450,2016
king,david t. denny international middle,866,16,137,15,152,192,256,195,55,435,431,597,17001,seattle,98126,2839,2016
king,dearborn park international,370,1,160,0,160,118,35,26,30,191,179,277,17001,seattle,98108,3803,2016
king,dunlap elementary,320,1,76,1,77,139,75,9,19,176,144,278,17001,seattle,98118,2321,2016
king,eckstein middle,906,3,85,2,87,41,61,643,71,436,470,119,17001,seattle,98115,2729,2016
king,emerson elementary,313,1,76,2,78,136,53,19,26,154,159,226,17001,seattle,98118,2118,2016
king,fairmount park elementary,478,1,22,0,22,19,43,322,71,244,234,68,17001,seattle,98126,3518,2016
king,franklin high,1308,8,681,8,689,356,129,88,38,681,627,841,17001,seattle,98144,2182,2016
king,frantz coe elementary,545,2,22,2,24,12,63,396,48,286,259,66,17001,seattle,98119,2090,2016
king,garfield high,1714,9,299,5,304,450,141,689,121,838,876,564,17001,seattle,98122,2306,2016
king,gatewood elementary,430,1,9,2,11,57,43,275,43,216,214,129,17001,seattle,98136,2139,2016
king,genesee hill elementary,640,1,28,2,30,20,28,484,77,346,294,63,17001,seattle,98116,3429,2016
king,graham hill elementary,352,3,69,0,69,111,56,68,45,187,165,245,17001,seattle,98118,3378,2016
king,green lake elementary,336,1,26,0,26,8,19,247,35,182,154,53,17001,seattle,98103,2061,2016
king,greenwood elementary,362,3,19,1,20,26,34,244,35,176,186,73,17001,seattle,98117,2123,2016
king,hamilton international middle,1083,4,99,1,100,20,56,811,92,617,466,83,17001,seattle,98103,2371,2016
king,hawthorne elementary school - seattle,391,0,74,0,74,112,73,92,40,193,198,254,17001,seattle,98118,4248,2016
king,hazel wolf k-8,757,6,46,5,51,56,80,495,69,364,393,152,17001,seattle,98125,5175,2016
king,highland park elementary,353,9,71,8,79,56,111,52,46,180,173,291,17001,seattle,98106,2269,2016
king,ingraham high,1235,8,190,2,192,110,143,692,90,642,593,329,17001,seattle,98133,3276,2016
king,interagency open doors,54,1,10,1,11,15,14,7,6,30,24,91,17001,seattle,98118,5405,2016
king,interagency programs,361,17,24,7,31,141,87,66,19,196,165,403,17001,seattle,98124,1635,2016
king,jane addams middle,825,10,123,4,127,78,97,439,74,443,382,236,17001,seattle,98125,5351,2016
king,john hay elementary,500,0,66,1,67,21,40,298,74,266,234,70,17001,seattle,98109,2063,2016
king,john muir elementary,397,2,44,2,46,189,41,75,44,199,198,267,17001,seattle,98144,2143,2016
king,john rogers elementary,389,3,26,2,28,45,62,202,49,213,176,148,17001,seattle,98125,2975,2016
king,john stanford international,450,4,50,0,50,4,67,243,82,225,225,31,17001,seattle,98105,2081,2016
king,kimball elementary,429,0,146,1,147,95,44,96,47,209,220,237,17001,seattle,98144,3478,2016
king,lafayette elementary,487,1,39,2,41,40,34,321,50,261,226,114,17001,seattle,98116,2733,2016
king,laurelhurst elementary,433,0,59,1,60,18,22,289,44,241,192,104,17001,seattle,98105,2437,2016
king,lawton elementary,426,1,23,3,26,6,28,307,58,208,218,42,17001,seattle,98199,2183,2016
king,leschi elementary,368,0,13,1,14,177,27,116,34,185,183,194,17001,seattle,98122,2121,2016
king,licton springs k-8,130,10,8,1,9,11,25,48,27,70,60,80,17001,seattle,98115,3874,2016
king,louisa boren stem k-8,403,0,39,0,39,52,46,214,52,233,170,111,17001,seattle,98106,5276,2016
king,lowell elementary,336,7,53,5,58,96,37,93,45,184,152,188,17001,seattle,98102,3714,2016
king,loyal heights elementary,427,0,9,0,9,10,20,342,46,208,219,27,17001,seattle,98115,2462,2016
king,madison middle,777,4,84,4,88,92,80,449,64,385,392,232,17001,seattle,98116,2435,2016
king,madrona k-8,301,1,6,0,6,133,38,81,42,161,140,172,17001,lynnwood,98036,3463,2016
king,maple elementary,480,1,247,2,249,51,90,47,42,253,227,318,17001,seattle,98108,2353,2016
king,martin luther king jr. elementary,323,0,105,12,117,131,55,5,15,167,156,224,17001,seattle,98118,2089,2016
king,mcclure middle,550,4,53,4,57,30,56,364,39,271,279,90,17001,seattle,98119,3517,2016
king,mcdonald international,453,0,18,0,18,2,55,303,75,230,223,21,17001,seattle,98105,5203,2016
king,mcgilvra elementary,275,0,24,0,24,18,15,179,39,140,135,26,17001,seattle,98112,2201,2016
king,mercer international middle,1101,2,474,1,475,267,192,110,55,559,542,761,17001,seattle,98108,3095,2016
king,middle college high,117,2,14,0,14,23,17,53,8,55,62,54,17001,seattle,98125,1547,2016
king,montlake elementary,265,0,24,1,25,14,9,177,40,139,126,16,17001,seattle,98112,2322,2016
king,nathan hale high,1179,16,158,5,163,142,133,649,76,628,551,354,17001,seattle,98125,3479,2016
king,north beach elementary,301,0,14,1,15,3,19,218,46,143,158,26,17001,seattle,98117,3218,2016
king,northgate elementary,243,0,26,3,29,51,81,51,31,135,108,195,17001,seattle,98125,3027,2016
king,nova high,344,5,18,0,18,11,37,237,36,141,203,80,17001,seattle,98122,3868,2016
king,olympic hills elementary,290,0,36,6,42,70,82,65,31,131,159,220,17001,seattle,98125,2976,2016
king,olympic view elementary,455,3,55,1,56,70,47,225,54,245,210,170,17001,seattle,98115,2256,2016
king,orca k-8,414,1,22,0,22,91,23,225,52,210,204,127,17001,seattle,98118,4065,2016
king,pathfinder k-8,505,3,29,0,29,25,47,343,58,274,231,94,17001,seattle,98106,1620,2016
king,private school services,97,0,6,0,6,14,13,57,7,65,32,0,17001,seattle,98124,5046,2016
king,queen anne elementary,425,0,24,0,24,8,29,305,59,216,209,30,17001,seattle,98109,5204,2016
king,rainier beach high,671,4,179,15,194,326,91,26,30,346,325,481,17001,seattle,98118,3327,2016
king,rainier view elementary,230,4,59,2,61,88,32,16,29,111,119,162,17001,seattle,98178,3380,2016
king,residential consortium,27,2,0,0,0,4,4,13,4,19,8,0,17001,seattle,98119,4263,2016
king,roosevelt high,1715,8,198,1,199,83,144,1159,122,865,850,202,17001,seattle,98115,2285,2016
king,roxhill elementary,301,1,37,7,44,82,113,38,23,151,150,239,17001,seattle,98126,3157,2016
king,sacajawea elementary,257,0,24,0,24,22,26,151,34,137,120,69,17001,seattle,98115,3028,2016
king,salmon bay k-8,672,4,33,0,33,13,45,512,65,349,323,58,17001,seattle,98117,1796,2016
king,sand point elementary,273,1,34,0,34,43,39,101,55,147,126,105,17001,seattle,98115,5205,2016
king,sanislo elementary,273,4,55,8,63,62,59,55,30,144,129,185,17001,seattle,98106,3665,2016
king,south lake high,96,1,11,0,11,47,29,3,5,44,52,97,17001,seattle,98118,3778,2016
king,south shore pk-8,623,6,142,1,143,279,71,57,67,336,287,385,17001,seattle,98118,4218,2016
king,stevens elementary,336,2,15,1,16,67,31,184,36,169,167,111,17001,seattle,98112,2080,2016
king,the center,270,2,12,0,12,17,27,191,21,103,167,37,17001,seattle,98109,1856,2016
king,thornton creek elementary,416,1,17,0,17,3,29,305,61,221,195,20,17001,seattle,98115,3974,2016
king,thurgood marshall elementary,531,1,90,1,91,97,36,235,71,290,241,155,17001,seattle,98144,2141,2016
king,tops k-8,485,3,94,1,95,73,34,230,50,229,256,125,17001,seattle,98102,1579,2016
king,van asselt elementary,511,1,212,4,216,195,53,21,25,262,249,409,17001,seattle,98108,2120,2016
king,view ridge elementary,591,2,84,0,84,12,33,385,75,277,314,54,17001,seattle,98115,2667,2016
king,viewlands elementary,392,5,33,1,34,35,82,191,45,193,199,178,17001,seattle,98177,2977,2016
king,washington middle,1080,9,194,2,196,308,88,387,92,563,517,493,17001,seattle,98144,4064,2016
king,wedgwood elementary,479,0,72,0,72,12,42,277,76,232,247,43,17001,seattle,98115,3026,2016
king,west seattle elementary,431,3,39,5,44,261,57,47,19,230,201,351,17001,seattle,98126,2645,2016
king,west seattle high,994,15,126,7,133,116,127,519,84,481,513,288,17001,seattle,98116,2234,2016
king,west woodland elementary,532,0,30,0,30,9,38,402,53,267,265,37,17001,seattle,98107,2142,2016
king,whitman middle,861,11,62,4,66,87,108,520,69,456,405,250,17001,seattle,98117,3277,2016
king,whittier elementary,469,0,26,0,26,10,19,370,44,251,218,45,17001,seattle,98117,2092,2016
king,wing luke elementary,360,1,135,1,136,161,22,10,30,177,183,287,17001,seattle,98118,3581,2016
skagit,big lake elementary,349,1,10,0,10,3,38,281,16,165,184,63,29101,mount vernon,98274,2521,2016
skagit,cascade middle,596,15,5,1,6,7,124,428,16,315,281,315,29101,sedro-woolley,98284,3181,2016
skagit,central elementary,416,3,4,0,4,2,108,282,17,207,209,268,29101,sedro-woolley,98284,2380,2016
skagit,clear lake elementary,264,3,1,0,1,0,25,229,6,129,135,127,29101,clear lake,98235,3403,2016
skagit,evergreen elementary,515,31,7,1,8,3,149,312,12,280,235,333,29101,sedro-woolley,98284,3942,2016
skagit,good beginnings center,56,2,0,0,0,2,20,27,5,36,20,44,29101,sedro-woolley,98273,5058,2016
skagit,lyman elementary,178,2,0,0,0,1,13,154,8,82,96,91,29101,lyman,98263,2620,2016
skagit,mary purcell elementary,387,3,0,1,1,2,118,249,14,190,197,284,29101,sedro-woolley,98284,2774,2016
skagit,samish elementary,182,2,0,0,0,1,23,151,5,89,93,85,29101,sedro-woolley,98284,3402,2016
skagit,sedro woolley senior high,1207,28,15,1,16,5,194,923,41,628,579,475,29101,sedro-woolley,98284,2150,2016
skagit,state street high,194,10,0,1,1,4,22,147,10,109,85,104,29101,sedro-woolley,98284,1537,2016
yakima,john campbell primary,804,7,3,1,4,3,222,547,21,407,397,471,39119,selah,98942,5383,2016
yakima,robert lince early learning center,32,0,0,0,0,1,8,22,1,22,10,17,39119,selah,98942,5232,2016
yakima,selah academy,85,2,0,0,0,2,11,70,0,34,51,57,39119,selah,98942,4272,2016
yakima,selah high,1060,6,5,0,5,8,249,771,21,583,477,353,39119,selah,98942,2388,2016
yakima,selah homelink,26,0,0,0,0,0,2,24,0,11,15,3,39119,selah,98942,5231,2016
yakima,selah intermediate,770,4,1,1,2,3,241,500,20,375,395,419,39119,selah,98942,5384,2016
yakima,selah middle,841,7,4,1,5,2,245,557,25,430,411,422,39119,selah,98942,5385,2016
pend oreille,selkirk elementary,119,0,0,0,0,0,8,106,5,65,54,60,26070,metaline falls,99153,5075,2016
pend oreille,selkirk high,92,1,1,0,1,0,6,81,3,49,43,34,26070,ione,99139,5226,2016
pend oreille,selkirk middle,47,0,2,0,2,0,1,43,1,24,23,17,26070,ione,99139,5225,2016
clallam,greywolf elementary,506,8,4,3,7,2,49,405,35,258,248,237,05323,sequim,98382,4378,2016
clallam,helen haller elementary,611,5,5,0,5,2,98,457,44,315,296,354,05323,sequim,98382,2722,2016
clallam,sequim community,128,4,1,0,1,2,13,104,4,73,55,60,05323,sequim,98382,1708,2016
clallam,sequim middle,619,12,15,1,16,2,56,492,41,310,309,261,05323,sequim,98382,4519,2016
clallam,sequim senior high,986,18,22,1,23,8,89,779,69,502,484,319,05323,sequim,98382,2471,2016
san juan,shaw island elementary,16,0,0,0,0,1,0,15,0,8,8,0,28010,shaw island,98286,3725,2016
mason,bordeaux elementary,562,27,2,2,4,1,71,410,49,313,249,383,23309,shelton,98584,3291,2016
mason,evergreen elementary,560,4,2,1,3,2,446,91,14,267,293,517,23309,shelton,98584,2745,2016
mason,mountain view elementary,663,13,3,1,4,1,118,477,50,349,314,461,23309,shelton,98584,3292,2016
mason,oakland bay junior high,669,24,5,2,7,6,154,432,46,378,291,415,23309,shelton,98584,4363,2016
mason,olympic middle,550,21,3,0,3,2,178,318,28,293,257,391,23309,shelton,98584,4586,2016
mason,shelton high,1067,47,11,0,11,9,214,705,81,552,515,552,23309,shelton,98584,3241,2016
king,albert einstein middle,687,7,111,6,117,50,92,347,74,351,336,212,17412,shoreline,98177,3674,2016
king,briarcrest elementary,472,1,60,1,61,47,83,217,63,218,254,191,17412,shoreline,98155,2990,2016
king,brookside elementary,491,1,34,2,36,14,47,310,83,261,230,73,17412,lake forest park,98155,3230,2016
king,cascade k-8 community,186,1,15,0,15,7,30,118,15,92,94,39,17412,shoreline,98155,1942,2016
king,early childhood education,30,0,2,0,2,3,2,21,2,22,8,13,17412,shoreline,98155,5287,2016
king,echo lake elementary,456,2,75,4,79,20,75,226,54,246,210,166,17412,shoreline,98133,3104,2016
king,handicapped contractual services,92,3,5,1,6,5,12,52,14,54,38,30,17412,shoreline,98155,1667,2016
king,highland terrace elementary,487,3,54,1,55,19,38,310,62,243,244,70,17412,shoreline,98133,3231,2016
king,home education exchange,134,1,5,0,5,3,9,110,6,67,67,11,17412,shoreline,98155,1771,2016
king,kellogg middle,655,3,88,2,90,59,83,340,80,326,329,214,17412,shoreline,98155,3387,2016
king,lake forest park elementary,529,3,39,4,43,30,63,334,56,264,265,154,17412,lake forest park,98155,2185,2016
king,melvin g syre elementary,522,3,25,0,25,17,49,361,67,278,244,72,17412,shoreline,98177,3527,2016
king,meridian park elementary,530,2,110,2,112,42,58,250,66,271,259,151,17412,shoreline,98133,3958,2016
king,parkwood elementary,427,2,73,10,83,41,75,189,37,234,193,156,17412,shoreline,98133,3489,2016
king,ridgecrest elementary,533,0,71,3,74,44,62,265,88,288,245,133,17412,shoreline,98155,2703,2016
king,shorecrest high,1347,2,193,5,198,107,145,761,134,697,650,330,17412,shoreline,98155,3343,2016
king,shorewood high,1633,8,271,8,279,131,202,849,164,862,771,405,17412,shoreline,98133,3921,2016
skamania,skamania elementary,76,0,0,0,0,0,6,68,2,30,46,42,30002,skamania,98648,3405,2016
king,skykomish elementary,27,0,0,0,0,0,4,23,0,15,12,23,17404,skykomish,98288,2512,2016
king,skykomish high,16,0,0,0,0,0,2,14,0,8,8,13,17404,skykomish,98288,2513,2016
snohomish,aim high,155,2,4,0,4,2,16,124,7,65,90,54,31201,snohomish,98290,4265,2016
snohomish,cascade view elementary,434,2,9,2,11,1,43,353,24,229,205,110,31201,snohomish,98290,4366,2016
snohomish,cathcart elementary,390,0,4,1,5,7,55,313,10,200,190,77,31201,snohomish,98296,3305,2016
snohomish,centennial middle,752,11,10,0,10,5,80,618,28,392,360,186,31201,snohomish,98290,4395,2016
snohomish,central elementary,275,2,0,2,2,1,57,191,22,142,133,130,31201,snohomish,98290,2446,2016
snohomish,dutch hill elementary,533,2,8,2,10,0,33,458,30,273,260,93,31201,snohomish,98290,4241,2016
snohomish,emerson elementary,345,0,3,1,4,0,79,243,19,159,186,165,31201,snohomish,98290,3005,2016
snohomish,glacier peak high,1767,11,109,2,111,29,150,1360,106,904,863,193,31201,snohomish,98296,5128,2016
snohomish,high school re entry,25,0,0,0,0,0,1,22,2,13,12,9,31201,snohomish,98290,3981,2016
snohomish,little cedars elementary,707,4,69,2,71,13,51,515,53,373,334,70,31201,snohomish,98290,5100,2016
snohomish,machias elementary,468,6,6,0,6,0,42,389,25,264,204,140,31201,snohomish,98290,2073,2016
snohomish,riverview elementary,528,0,10,0,10,3,75,411,29,271,257,140,31201,snohomish,98290,3561,2016
snohomish,seattle hill elementary,625,2,45,1,46,3,68,437,69,301,324,129,31201,everett,98208,4184,2016
snohomish,snohomish center,33,1,2,0,2,0,1,28,1,22,11,10,31201,snohomish,98290,1730,2016
snohomish,snohomish high,1747,8,28,3,31,12,158,1450,88,895,852,348,31201,snohomish,98290,2428,2016
snohomish,totem falls,443,3,27,1,28,7,30,361,14,239,204,38,31201,snohomish,98296,4383,2016
snohomish,valley view middle,792,3,55,2,57,10,79,599,44,407,385,101,31201,snohomish,98296,4145,2016
king,cascade view elementary,662,0,40,0,40,2,28,554,38,331,331,17,17410,snoqualmie,98065,5015,2016
king,chief kanim middle,762,2,55,4,59,4,43,617,37,406,356,70,17410,fall city,98024,4397,2016
king,edwin r opstad elementary,622,3,9,0,9,9,74,497,30,347,275,131,17410,north bend,98045,4308,2016
king,fall city elementary,644,1,49,1,50,2,36,520,35,345,299,59,17410,fall city,98024,2222,2016
king,mount si high,1849,15,63,5,68,19,91,1606,50,961,888,189,17410,snoqualmie,98065,2850,2016
king,north bend elementary,593,0,34,1,35,1,67,462,28,295,298,88,17410,north bend,98045,2287,2016
king,snoqualmie access,52,1,2,0,2,2,3,38,6,33,19,12,17410,snoqualmie,98065,5181,2016
king,snoqualmie elementary,735,4,61,1,62,6,56,554,53,407,328,97,17410,snoqualmie,98065,2288,2016
king,snoqualmie parent partnership program,77,0,0,0,0,1,7,69,0,45,32,1,17410,north bend,98045,5296,2016
king,svsd open doors,5,1,0,0,0,0,0,4,0,2,3,5,17410,snoqualmie,98065,5374,2016
king,twin falls middle,778,2,19,2,21,7,53,665,30,402,376,96,17410,north bend,98045,5135,2016
king,two rivers,102,3,0,0,0,0,8,88,3,55,47,43,17410,north bend,98045,1502,2016
grant,smokiam alternative high,41,0,0,0,0,0,8,32,1,25,16,29,13156,soap lake,98851,1518,2016
grant,soap lake elementary,211,0,1,0,1,0,72,136,2,108,103,197,13156,soap lake,98851,2694,2016
grant,soap lake middle & high,259,1,1,0,1,5,84,166,2,138,121,174,13156,soap lake,98851,3089,2016
pacific,chauncey davis elementary,326,6,12,1,13,0,140,130,37,179,147,251,25118,south bend,98586,2804,2016
pacific,south bend high,225,10,3,0,3,0,82,101,29,107,118,149,25118,south bend,98586,2214,2016
kitsap,burley glenwood elementary,546,5,4,8,12,3,51,427,48,274,272,266,18402,port orchard,98367,4029,2016
kitsap,cedar heights middle,713,10,35,19,54,9,82,487,71,363,350,295,18402,port orchard,98366,3680,2016
kitsap,discovery,212,6,1,0,1,6,24,149,26,122,90,110,18402,port orchard,98366,3899,2016
kitsap,east port orchard elementary,521,6,14,22,36,10,62,330,77,276,245,287,18402,port orchard,98366,2641,2016
kitsap,explorer academy,189,0,0,0,0,2,16,155,16,85,104,71,18402,port orchard,98366,1718,2016
kitsap,hidden creek elementary,526,7,20,8,28,3,69,357,62,274,252,213,18402,port orchard,98367,4348,2016
kitsap,madrona heights preschool program,75,1,1,0,1,0,11,52,10,54,21,45,18402,port orchard,98366,5072,2016
kitsap,manchester elementary,377,2,3,4,7,8,47,270,43,206,171,179,18402,port orchard,98366,4079,2016
kitsap,mullenix ridge elementary,513,4,9,2,11,3,45,390,60,271,242,136,18402,port orchard,98367,4350,2016
kitsap,olalla elementary,343,7,2,3,5,1,38,255,37,183,160,157,18402,port orchard,98359,2995,2016
kitsap,orchard heights elementary,749,4,12,12,24,14,76,524,107,409,340,378,18402,port orchard,98366,2650,2016
kitsap,sidney glen elementary,677,7,22,17,39,11,78,451,91,327,350,360,18402,port orchard,98366,4349,2016
kitsap,south colby elementary,392,3,8,1,9,1,27,319,33,200,192,96,18402,port orchard,98366,3110,2016
kitsap,south kitsap high,1947,17,77,30,107,32,169,1402,220,1038,909,583,18402,port orchard,98366,2272,2016
kitsap,sunnyslope elementary,499,0,34,3,37,6,60,332,64,236,263,168,18402,port orchard,98367,4141,2016
island,south whidbey academy,102,0,1,0,1,1,8,89,3,48,54,40,15206,langley,98260,1682,2016
island,south whidbey elementary,512,3,6,2,8,4,47,423,27,241,271,164,15206,langley,98260,4321,2016
island,south whidbey high,492,9,17,0,17,7,21,429,8,238,254,95,15206,langley,98260,4149,2016
island,south whidbey special services,10,1,0,0,0,0,0,9,0,8,2,2,15206,langley,98260,1683,2016
mason,southside elementary,190,5,5,0,5,1,20,142,17,84,106,67,23042,shelton,98584,2744,2016
spokane,adams elementary,337,4,10,0,10,8,48,202,65,163,174,238,32081,spokane,99223,2156,2016
spokane,alternative northeast community center preschool,24,0,0,0,0,0,5,18,1,19,5,14,32081,spokane,99207,1566,2016
spokane,arlington elementary,616,7,25,12,37,18,90,394,70,317,299,453,32081,spokane,99217,2381,2016
spokane,audubon elementary,427,6,4,0,4,15,51,291,60,213,214,355,32081,spokane,99205,2128,2016
spokane,balboa elementary,351,2,3,2,5,3,29,276,36,175,176,151,32081,spokane,99208,3357,2016
spokane,bemiss elementary,572,19,7,27,34,21,94,316,88,298,274,476,32081,spokane,99207,2155,2016
spokane,browne elementary,421,3,0,2,2,6,36,310,64,232,189,273,32081,spokane,99205,2218,2016
spokane,bryant center,686,1,6,1,7,5,56,568,49,358,328,182,32081,spokane,99201,3008,2016
spokane,chase middle,728,8,34,3,37,17,67,527,72,390,338,373,32081,spokane,99223,4457,2016
spokane,cooper elementary,535,6,22,21,43,21,65,318,82,274,261,410,32081,spokane,99217,2129,2016
spokane,daybreak alternative,4,0,0,0,0,0,0,2,2,0,4,0,32081,spokane,99202,1603,2016
spokane,eagle peak at pratt,78,2,0,0,0,1,9,49,17,66,12,96,32081,spokane valley,99212,1567,2016
spokane,ferris high,1770,5,76,14,90,44,151,1306,174,942,828,663,32081,spokane,99223,3412,2016
spokane,finch elementary,549,2,1,0,1,9,41,441,55,290,259,308,32081,spokane,99205,2312,2016
spokane,franklin elementary,396,3,14,0,14,6,46,268,59,199,197,187,32081,spokane,99223,2127,2016
spokane,garfield elementary,475,15,14,4,18,21,57,291,73,258,217,358,32081,spokane,99205,3727,2016
spokane,garry middle,583,13,14,16,30,31,87,330,92,299,284,476,32081,spokane,99207,3758,2016
spokane,glover middle,614,20,4,2,6,17,57,426,88,323,291,446,32081,spokane,99205,3258,2016
spokane,grant elementary,368,5,16,7,23,44,44,164,88,197,171,319,32081,spokane,99202,3729,2016
spokane,hamblen elementary,551,2,7,6,13,6,57,395,78,293,258,222,32081,spokane,99203,3007,2016
spokane,holmes elementary,357,5,5,7,12,10,57,207,66,183,174,340,32081,spokane,99201,2056,2016
spokane,hutton elementary,565,1,8,0,8,17,30,456,53,262,303,120,32081,spokane,99203,2258,2016
spokane,indian trail elementary,330,3,3,0,3,4,30,252,38,162,168,128,32081,spokane,99208,3506,2016
spokane,jefferson elementary,494,1,4,0,4,10,47,374,58,265,229,179,32081,spokane,99203,2111,2016
spokane,lewis & clark high,1895,23,88,37,125,82,166,1304,195,915,980,606,32081,spokane,99204,2172,2016
spokane,libby center,280,1,20,0,20,1,17,221,20,149,131,56,32081,spokane,99202,2401,2016
spokane,lidgerwood elementary,392,4,13,14,27,8,56,207,90,206,186,349,32081,spokane,99208,2952,2016
spokane,lincoln heights elementary,526,4,19,0,19,16,65,358,64,267,259,289,32081,spokane,99223,2951,2016
spokane,linwood elementary,484,2,0,21,21,10,46,317,88,232,252,342,32081,spokane,99208,3190,2016
spokane,logan elementary,433,16,11,16,27,21,67,218,84,214,219,391,32081,spokane,99207,3719,2016
spokane,longfellow elementary,520,10,7,5,12,11,57,325,105,255,265,432,32081,spokane,99207,3718,2016
spokane,madison elementary,363,2,5,2,7,3,33,272,46,186,177,275,32081,spokane,99205,2708,2016
spokane,moran prairie elementary,514,0,13,0,13,9,28,430,34,274,240,102,32081,spokane,99223,4389,2016
spokane,mullan road elementary,616,4,12,0,12,13,40,499,48,320,296,175,32081,spokane,99223,4035,2016
spokane,north central high,1368,32,26,21,47,44,138,934,173,693,675,686,32081,spokane,99205,2106,2016
spokane,on track academy,336,10,1,3,4,6,37,243,36,171,165,228,32081,spokane,99207,5250,2016
spokane,open doors youth re-engagement spokane,146,3,1,1,2,2,26,89,24,74,72,57,32081,spokane,99201,5344,2016
spokane,regal elementary,472,11,11,7,18,13,55,307,68,255,217,420,32081,spokane,99207,2096,2016
spokane,ridgeview elementary,363,3,5,3,8,3,51,247,51,173,190,245,32081,spokane,99205,2950,2016
spokane,rogers high,1578,36,63,73,136,75,186,927,218,847,731,1138,32081,spokane,99207,2479,2016
spokane,roosevelt elementary,542,4,23,10,33,31,70,327,77,273,269,343,32081,spokane,99204,2086,2016
spokane,sacajawea middle,787,5,22,4,26,24,47,592,93,382,405,257,32081,spokane,99203,3356,2016
spokane,salk middle,720,9,4,4,8,8,66,552,77,370,350,347,32081,spokane,99208,3413,2016
spokane,sccp images,48,2,2,0,2,2,1,36,5,33,15,22,32081,spokane,99217,1698,2016
spokane,shadle park high,1366,19,17,6,23,24,101,1052,147,707,659,605,32081,spokane,99205,3189,2016
spokane,shaw middle,591,19,29,28,57,25,81,327,82,309,282,513,32081,spokane,99207,3257,2016
spokane,sheridan elementary,427,10,39,3,42,15,63,237,60,249,178,370,32081,spokane,99202,2110,2016
spokane,spokane public montessori,421,7,5,0,5,6,33,313,57,210,211,120,32081,spokane,99205,5361,2016
spokane,spokane regional health district,339,7,1,2,3,3,14,303,9,203,136,0,32081,spokane,99201,5113,2016
spokane,stevens elementary,506,14,13,41,54,23,64,248,103,252,254,458,32081,spokane,99202,2108,2016
spokane,the community,135,1,0,0,0,3,3,116,12,59,76,72,32081,spokane,99205,5301,2016
spokane,westview elementary,472,0,4,9,13,1,47,334,77,251,221,332,32081,spokane,99205,3063,2016
spokane,whitman elementary,568,6,5,25,30,19,72,348,93,309,259,476,32081,spokane,99207,2191,2016
spokane,willard elementary,546,16,2,3,5,30,53,359,83,271,275,426,32081,spokane,99205,2109,2016
spokane,wilson elementary,376,2,6,0,6,4,22,301,41,192,184,62,32081,spokane,99203,2296,2016
spokane,woodridge elementary,471,9,8,4,12,3,40,358,49,242,229,138,32081,spokane,99208,4192,2016
lincoln,sprague elementary,41,1,0,0,0,0,2,38,0,19,22,28,22008,sprague,99032,3050,2016
lincoln,sprague high,28,1,0,0,0,0,2,25,0,13,15,10,22008,sprague,99032,2186,2016
whitman,st john elementary,79,0,0,0,0,0,6,68,5,43,36,32,38322,saint john,99171,3069,2016
whitman,st john/endicott high,82,0,4,1,5,0,1,75,1,39,43,35,38322,saint john,99171,3068,2016
snohomish,cedarhome elementary,503,2,7,1,8,4,41,422,26,259,244,89,31401,stanwood,98292,4513,2016
snohomish,elger bay elementary,291,1,0,0,0,2,27,246,15,161,130,100,31401,camano island,98282,4553,2016
snohomish,lincoln academy,14,0,0,0,0,1,4,9,0,8,6,8,31401,stanwood,98292,5108,2016
snohomish,lincoln hill high,135,0,0,2,2,1,15,112,5,59,76,48,31401,stanwood,98292,1707,2016
snohomish,port susan middle,500,7,8,0,8,2,39,419,25,235,265,139,31401,stanwood,98292,4512,2016
snohomish,saratoga,146,1,1,0,1,3,8,126,7,66,80,17,31401,stanwood,98292,5004,2016
snohomish,stanwood elementary,405,1,4,0,4,2,35,338,25,218,187,174,31401,stanwood,98292,3125,2016
snohomish,stanwood high,1393,14,11,4,15,14,103,1192,55,730,663,271,31401,stanwood,98292,2581,2016
snohomish,stanwood middle,472,3,9,0,9,5,55,370,30,234,238,128,31401,stanwood,98292,2400,2016
snohomish,twin city elementary,363,6,9,4,13,1,64,269,10,196,167,131,31401,stanwood,98292,4364,2016
snohomish,utsalady elementary,271,1,5,0,5,5,19,231,10,145,126,75,31401,camano island,98282,4551,2016
franklin,star elem,9,0,0,0,0,0,5,4,0,2,7,0,11054,richland,99352,2007,2016
columbia,starbuck,30,0,0,0,0,0,1,29,0,12,18,0,07035,starbuck,99359,2135,2016
chelan,stehekin elementary,8,0,0,0,0,0,0,8,0,3,5,0,04069,stehekin,98852,2265,2016
pierce,anderson island elementary,38,0,0,0,0,1,8,26,3,19,19,17,27001,steilacoom,98388,2040,2016
pierce,birth to three,14,0,0,0,0,0,2,11,1,7,7,4,27001,steilacoom,98388,5389,2016
pierce,cherrydale elementary,345,2,10,5,15,20,50,187,71,173,172,134,27001,steilacoom,98388,3446,2016
pierce,chloe clark elementary,602,1,46,8,54,54,98,297,98,329,273,69,27001,dupont,98327,4562,2016
pierce,futures program,6,0,0,2,2,0,2,1,1,3,3,1,27001,steilacoom,98388,5410,2016
pierce,pioneer middle,799,7,69,27,96,63,120,373,140,393,406,183,27001,dupont,98327,2237,2016
pierce,saltars point elementary,404,3,23,6,29,28,60,234,50,208,196,89,27001,steilacoom,98388,3827,2016
pierce,steilacoom high,921,2,83,22,105,74,139,463,138,488,433,185,27001,steilacoom,98388,4131,2016
whitman,steptoe elementary,43,2,0,0,0,0,0,41,0,21,22,9,38304,steptoe,99174,2115,2016
skamania,carson elementary,243,6,0,1,1,2,39,184,11,124,119,129,30303,stevenson,98648,2882,2016
skamania,preschool,19,0,0,0,0,0,4,15,0,13,6,14,30303,stevenson,98648,1765,2016
skamania,stevenson elementary,198,4,1,0,1,2,20,160,11,103,95,109,30303,stevenson,98648,2682,2016
skamania,stevenson high,318,7,2,1,3,3,44,246,15,168,150,128,30303,stevenson,98648,3119,2016
skamania,wind river middle,143,0,1,0,1,2,20,112,8,75,68,56,30303,stevenson,98648,3800,2016
snohomish,gold bar elementary,325,0,0,0,0,2,77,240,6,186,139,209,31311,gold bar,98251,4399,2016
snohomish,open doors youth reengagement sultan,4,1,0,0,0,0,0,3,0,2,2,2,31311,sultan,98296,5329,2016
snohomish,student services,19,0,0,0,0,0,2,17,0,12,7,7,31311,sultan,98294,1670,2016
snohomish,sultan elementary,544,2,10,1,11,4,105,397,25,274,270,313,31311,sultan,98294,2229,2016
snohomish,sultan middle,451,8,10,0,10,1,78,347,7,244,207,231,31311,sultan,98294,2105,2016
snohomish,sultan senior high,547,13,9,0,9,8,92,413,12,292,255,244,31311,sultan,98294,4274,2016
stevens,summit valley,61,0,0,0,0,0,1,57,3,32,29,48,33202,addy,99101,4394,2016
pierce,bonney lake elementary,522,4,8,1,9,7,50,402,50,255,267,196,27320,bonney lake,98390,3349,2016
pierce,bonney lake high,1333,15,28,5,33,19,157,1009,100,683,650,340,27320,bonney lake,98391,4585,2016
pierce,crestwood elementary,434,1,7,0,7,5,36,343,42,230,204,116,27320,bonney lake,98390,4435,2016
pierce,daffodil valley elementary,539,4,16,0,16,2,166,314,37,266,273,360,27320,sumner,98390,4541,2016
pierce,eismann elementary,538,3,14,0,14,8,48,425,40,257,281,60,27320,bonney lake,98391,3399,2016
pierce,emerald hills elementary,365,4,5,0,5,8,32,278,38,194,171,136,27320,bonney lake,98390,4250,2016
pierce,lakeridge middle,599,8,11,4,15,5,55,461,55,312,287,156,27320,bonney lake,98391,4132,2016
pierce,liberty ridge elementary,446,3,2,2,4,2,78,314,45,220,226,253,27320,sumner,98390,4402,2016
pierce,maple lawn elementary,612,2,10,7,17,2,109,417,65,324,288,242,27320,sumner,98390,2875,2016
pierce,mountain view middle,628,2,5,3,8,6,72,485,55,312,316,201,27320,bonney lake,98390,4502,2016
pierce,sumner high,1932,19,46,6,52,18,239,1469,135,974,958,478,27320,sumner,98390,3247,2016
pierce,sumner middle,701,5,15,1,16,5,139,468,68,344,357,295,27320,sumner,98390,3499,2016
pierce,sumner special services,18,0,0,0,0,0,0,18,0,11,7,13,27320,sumner,98390,1781,2016
pierce,victor falls elementary,563,6,9,1,10,4,36,464,43,284,279,139,27320,bonney lake,98391,4166,2016
yakima,chief kamiakin elementary,792,0,0,0,0,0,726,56,10,427,365,713,39201,sunnyside,98944,4000,2016
yakima,harrison middle,814,0,1,0,1,2,754,46,11,416,398,739,39201,sunnyside,98944,3313,2016
yakima,outlook elementary,643,1,0,0,0,1,608,30,3,342,301,581,39201,sunnyside,98944,2469,2016
yakima,pioneer elementary,751,0,1,0,1,0,686,54,10,397,354,676,39201,sunnyside,98944,4497,2016
yakima,shs graduation alliance,3,0,0,0,0,0,3,0,0,2,1,4,39201,sunnyside,98944,5352,2016
yakima,sierra vista middle,674,0,0,0,0,0,617,49,8,327,347,589,39201,sunnyside,98944,5049,2016
yakima,sun valley elementary,524,0,1,0,1,0,484,34,5,275,249,466,39201,sunnyside,98944,5137,2016
yakima,sunnyside high,1913,0,0,0,0,4,1744,149,16,996,917,1500,39201,sunnyside,98944,2959,2016
yakima,washington elementary,695,0,0,0,0,1,644,47,3,345,350,639,39201,sunnyside,98944,2717,2016
kitsap,chief kitsap academy,79,29,0,1,1,2,13,7,27,46,33,33,18902,poulsbo,98370,5319,2016
pierce,angelo giaudrone middle,632,13,79,16,95,159,127,214,24,307,325,490,27010,tacoma,98408,4575,2016
pierce,arlington,281,3,11,11,22,68,79,79,30,147,134,230,27010,tacoma,98409,2940,2016
pierce,baker,699,9,137,35,172,121,190,162,45,343,356,528,27010,tacoma,98408,3054,2016
pierce,birney,424,4,28,15,43,85,129,126,37,206,218,321,27010,tacoma,98408,3449,2016
pierce,blix elementary,492,7,56,18,74,76,173,135,27,253,239,423,27010,tacoma,98404,2094,2016
pierce,boze,386,2,75,16,91,66,138,63,26,198,188,317,27010,tacoma,98404,3646,2016
pierce,browns point,448,2,43,3,46,27,50,276,47,236,212,85,27010,tacoma,98422,2872,2016
pierce,bryant,449,5,15,7,22,62,49,258,53,234,215,212,27010,tacoma,98405,3397,2016
pierce,comm based trans program,47,1,7,0,7,11,2,25,1,25,22,31,27010,tacoma,98405,1585,2016
pierce,crescent heights,498,4,49,16,65,39,75,271,44,256,242,177,27010,tacoma,98422,4537,2016
pierce,day reporting,16,0,2,0,2,5,2,5,2,9,7,32,27010,tacoma,98406,1797,2016
pierce,delong,518,10,32,17,49,132,85,215,27,253,265,351,27010,tacoma,98405,2939,2016
pierce,downing,283,2,17,1,18,42,34,157,30,143,140,149,27010,tacoma,98406,2747,2016
pierce,edison,498,5,37,17,54,85,143,149,62,265,233,430,27010,tacoma,98409,2871,2016
pierce,fawcett,435,4,48,12,60,48,103,171,49,233,202,300,27010,tacoma,98404,2772,2016
pierce,fern hill,324,0,34,20,54,32,98,101,39,153,171,248,27010,tacoma,98444,2167,2016
pierce,first creek middle,759,16,144,26,170,180,233,127,33,381,378,677,27010,tacoma,98404,5170,2016
pierce,foss,911,8,116,29,145,227,185,278,67,449,462,549,27010,tacoma,98405,3880,2016
pierce,franklin,286,2,9,1,10,56,72,88,58,157,129,224,27010,tacoma,98405,2148,2016
pierce,fresh start,377,5,34,2,36,89,85,149,13,185,192,201,27010,tacoma,98405,5307,2016
pierce,geiger,426,3,22,3,25,38,69,230,61,202,224,190,27010,tacoma,98465,2746,2016
pierce,grant,368,2,6,3,9,40,40,245,32,192,176,132,27010,tacoma,98406,3053,2016
pierce,gray,606,5,68,35,103,155,139,167,37,305,301,467,27010,tacoma,98409,2377,2016
pierce,helen b. stafford elementary,518,5,121,21,142,68,138,96,69,257,261,415,27010,tacoma,98444,5066,2016
pierce,jason lee,591,9,24,18,42,179,66,269,26,299,292,360,27010,tacoma,98403,2338,2016
pierce,jefferson,300,2,8,1,9,40,42,175,32,145,155,168,27010,tacoma,98406,2103,2016
pierce,larchmont,408,4,55,13,68,78,104,118,36,214,194,322,27010,tacoma,98445,2036,2016
pierce,lincoln,1429,26,202,59,261,363,354,341,84,790,639,1019,27010,tacoma,98418,2215,2016
pierce,lister,525,6,69,33,102,132,113,118,54,265,260,508,27010,tacoma,98404,2771,2016
pierce,lowell,438,2,16,4,20,32,41,304,39,220,218,82,27010,tacoma,98403,2805,2016
pierce,lyon,361,2,35,4,39,61,99,118,42,189,172,300,27010,tacoma,98404,2336,2016
pierce,manitou park,653,10,40,24,64,168,198,122,91,334,319,510,27010,tacoma,98409,2252,2016
pierce,mann,466,7,22,13,35,86,99,159,80,254,212,352,27010,tacoma,98408,2941,2016
pierce,mason,844,8,57,6,63,82,64,606,21,436,408,248,27010,tacoma,98407,2376,2016
pierce,mccarver,386,5,28,6,34,151,52,87,57,193,193,339,27010,tacoma,98405,3453,2016
pierce,meeker,680,8,86,6,92,66,64,410,40,349,331,189,27010,tacoma,98422,3244,2016
pierce,mt tahoma,1560,15,252,70,322,316,370,461,76,819,741,991,27010,tacoma,98409,3398,2016
pierce,northeast tacoma,380,4,28,7,35,34,100,152,55,202,178,211,27010,tacoma,98422,2247,2016
pierce,oakland high,203,3,5,8,13,59,39,61,28,98,105,173,27010,tacoma,98409,4109,2016
pierce,pearl street center,11,1,0,0,0,2,1,7,0,5,6,12,27010,tacoma,98465,4283,2016
pierce,point defiance,441,7,21,3,24,45,47,286,32,221,220,194,27010,tacoma,98407,2169,2016
pierce,reed,460,1,31,22,53,106,159,75,66,226,234,396,27010,tacoma,98418,2806,2016
pierce,roosevelt,254,8,14,9,23,52,72,56,43,131,123,235,27010,tacoma,98404,2275,2016
pierce,science and math institute,486,5,41,5,46,55,44,331,5,261,225,172,27010,tacoma,98407,5169,2016
pierce,sheridan,604,7,75,22,97,98,248,95,59,306,298,478,27010,tacoma,98404,2168,2016
pierce,sherman,418,3,7,0,7,21,42,314,31,214,204,103,27010,tacoma,98407,2938,2016
pierce,skyline,391,3,14,4,18,64,52,211,43,204,187,234,27010,tacoma,98406,3498,2016
pierce,special services,63,2,2,0,2,16,5,37,1,45,18,39,27010,tacoma,98405,5192,2016
pierce,stadium,1557,28,167,24,191,215,168,892,63,771,786,449,27010,tacoma,98403,2084,2016
pierce,stanley,318,7,5,13,18,104,54,86,49,157,161,259,27010,tacoma,98405,2358,2016
pierce,stewart,321,9,49,4,53,65,72,114,8,179,142,272,27010,tacoma,98465,2359,2016
pierce,tacoma school of the arts,577,13,33,7,40,95,76,345,8,183,394,202,27010,tacoma,98402,1860,2016
pierce,truman,800,8,76,12,88,129,102,453,20,392,408,451,27010,tacoma,98407,3448,2016
pierce,washington elementary,462,0,15,1,16,21,39,347,39,238,224,90,27010,tacoma,98407,2083,2016
pierce,whitman,455,4,57,25,82,95,91,137,46,239,216,358,27010,tacoma,98408,2874,2016
pierce,whittier,500,0,25,3,28,82,72,242,76,235,265,221,27010,tacoma,98466,3452,2016
pierce,wilson,1239,12,93,13,106,213,110,733,65,647,592,496,27010,tacoma,98406,3246,2016
grays harbor,taholah elementary & middle,122,88,0,0,0,0,18,0,16,66,56,81,14077,taholah,98587,5032,2016
grays harbor,taholah high,64,48,0,0,0,0,4,0,12,30,34,43,14077,taholah,98587,3580,2016
king,glacier park elementary,989,1,42,14,56,16,85,721,110,507,482,80,17409,maple valley,98038,4453,2016
king,lake wilderness elementary,1187,2,54,9,63,17,115,857,133,619,568,178,17409,maple valley,98038,3286,2016
king,rock creek elementary,990,2,22,6,28,17,93,779,71,516,474,127,17409,maple valley,98038,4415,2016
king,shadow lake elementary,652,4,30,14,44,4,86,453,61,348,304,144,17409,maple valley,98038,3589,2016
king,tahoma senior high,1819,10,61,8,69,40,169,1416,115,956,863,191,17409,maple valley,98038,2849,2016
whitman,tekoa elementary,100,7,0,0,0,2,8,81,2,54,46,44,38265,tekoa,99033,2052,2016
whitman,tekoa high,94,8,0,0,0,0,3,83,0,50,44,47,38265,tekoa,99033,3418,2016
thurston,parkside elementary,288,0,1,0,1,0,28,235,24,171,117,153,34402,tenino,98589,2457,2016
thurston,tenino elementary,280,3,1,0,1,1,21,239,15,163,117,136,34402,tenino,98589,4238,2016
thurston,tenino high,356,7,0,1,1,3,21,321,3,181,175,139,34402,tenino,98589,3509,2016
thurston,tenino middle,282,4,1,1,2,2,12,257,5,145,137,139,34402,tenino,98589,3795,2016
kittitas,thorp elem & jr sr high,121,5,0,0,0,0,7,108,1,63,58,73,19400,thorp,98946,2514,2016
lewis,cowlitz prairie academy,37,3,1,0,1,1,2,28,2,15,22,28,21237,toledo,98591,5190,2016
lewis,toledo elementary,312,10,3,0,3,1,33,255,10,169,143,164,21237,toledo,98591,2998,2016
lewis,toledo high,249,4,2,0,2,2,32,191,18,132,117,102,21237,toledo,98591,2616,2016
lewis,toledo middle,161,0,0,1,1,0,17,131,12,79,82,87,21237,toledo,98591,3977,2016
okanogan,tonasket elementary,573,5,0,0,0,2,239,304,23,289,284,398,24404,tonasket,98855,3176,2016
okanogan,tonasket high,308,1,0,0,0,2,99,199,7,163,145,172,24404,tonasket,98855,2679,2016
okanogan,tonasket middle,258,1,2,0,2,0,99,147,9,138,120,166,24404,tonasket,98855,4196,2016
yakima,computer academy toppenish high,165,41,0,0,0,1,107,16,0,98,67,118,39202,toppenish,98948,1508,2016
yakima,garfield elementary,405,36,0,0,0,0,359,6,4,202,203,258,39202,toppenish,98948,2608,2016
yakima,kirkwood elementary,665,135,2,0,2,2,500,15,11,337,328,419,39202,toppenish,98948,4106,2016
yakima,lincoln elementary,419,50,0,0,0,0,353,9,7,205,214,252,39202,toppenish,98948,2635,2016
yakima,nw allprep,566,11,19,1,20,15,28,481,11,265,301,71,39202,vancouver,98684,5262,2016
yakima,toppenish high,898,96,1,0,1,0,771,26,4,432,466,450,39202,toppenish,98948,2900,2016
yakima,toppenish middle,853,123,0,0,0,2,705,18,5,464,389,467,39202,toppenish,98948,2264,2016
yakima,toppenish pre,49,10,0,0,0,3,35,1,0,30,19,35,39202,toppenish,98948,1831,2016
yakima,valley view elementary,390,14,0,0,0,0,366,8,2,206,184,268,39202,toppenish,98948,4588,2016
walla walla,touchet elem & high,225,2,0,0,0,0,99,117,7,124,101,128,36300,touchet,99360,2160,2016
cowlitz,toutle lake elementary,329,3,1,0,1,1,29,281,14,174,155,131,08130,toutle,98649,4264,2016
cowlitz,toutle lake high,300,5,5,0,5,3,22,258,7,154,146,107,08130,toutle,98649,2560,2016
klickitat,trout lake elementary,68,2,2,0,2,0,5,57,2,35,33,0,20400,trout lake,98650,3062,2016
klickitat,trout lake,138,4,4,0,4,0,24,95,11,65,73,0,20400,trout lake,98650,2676,2016
king,cascade view elementary,475,2,157,13,170,65,165,49,24,247,228,424,17406,tukwila,98168,3226,2016
king,foster senior high,896,9,277,34,311,184,236,109,47,478,418,600,17406,tukwila,98168,2848,2016
king,showalter middle,684,5,214,26,240,130,183,91,35,349,335,503,17406,tukwila,98168,2564,2016
king,thorndyke elementary,426,8,73,16,89,125,132,42,30,225,201,326,17406,tukwila,98168,3635,2016
king,tukwila elementary,560,1,120,13,133,104,170,83,69,270,290,380,17406,tukwila,98168,3488,2016
thurston,a g west black hills high,855,6,39,5,44,18,67,649,70,440,415,180,34033,tumwater,98512,4500,2016
thurston,black lake elementary,512,2,15,1,16,2,56,391,45,252,260,161,34033,olympia,98512,4205,2016
thurston,east olympia elementary,511,4,6,0,6,2,65,394,40,265,246,151,34033,olympia,98501,4365,2016
thurston,george washington bush middle,512,3,8,5,13,8,60,393,35,258,254,154,34033,tumwater,98512,4452,2016
thurston,littlerock elementary,334,4,7,3,10,7,32,249,32,173,161,137,34033,olympia,98512,2816,2016
thurston,michael t simmons elementary,699,2,19,3,22,17,78,512,68,388,311,285,34033,tumwater,98512,2552,2016
thurston,new market high,53,0,0,0,0,4,9,36,4,29,24,23,34033,tumwater,98501,5014,2016
thurston,peter g schmidt elementary,615,1,8,4,12,14,84,442,62,302,313,231,34033,tumwater,98501,3199,2016
thurston,secondary options,111,1,0,0,0,1,16,84,8,58,53,36,34033,olympia,98512,1713,2016
thurston,tumwater high,1239,8,24,10,34,20,132,945,100,635,604,280,34033,tumwater,98501,3362,2016
thurston,tumwater hill elementary,475,2,39,3,42,4,65,301,61,245,230,132,34033,tumwater,98512,4373,2016
thurston,tumwater middle,467,6,20,2,22,11,46,333,49,236,231,138,34033,tumwater,98512,3612,2016
yakima,union gap,651,11,5,0,5,1,504,119,11,344,307,583,39002,union gap,98903,2714,2016
pierce,chambers elementary,464,1,37,2,39,53,88,224,59,255,209,197,27083,university pla,98467,3792,2016
pierce,curtis junior high,981,6,124,9,133,99,109,477,157,518,463,336,27083,university place,98466,3179,2016
pierce,curtis senior high,1455,11,181,14,195,143,153,774,179,694,761,450,27083,university place,98466,3600,2016
pierce,drum intermediate,613,3,49,6,55,63,93,287,112,290,323,234,27083,university pla,98467,4325,2016
pierce,evergreen primary,495,0,41,6,47,43,71,239,95,256,239,199,27083,university place,98466,4447,2016
pierce,narrows view intermediate,694,5,59,4,63,46,111,370,99,343,351,276,27083,university pla,98466,3296,2016
pierce,sunset primary,410,1,22,5,27,34,58,210,80,242,168,141,27083,university place,98466,3601,2016
pierce,university place primary,507,3,18,4,22,36,83,257,106,259,248,238,27083,university pla,98466,2223,2016
stevens,columbia virtual academy,425,5,19,3,22,10,47,314,27,204,221,0,33070,valley,99181,1932,2016
stevens,paideia high,51,0,0,0,0,0,7,40,4,29,22,30,33070,valley,99181,5223,2016
stevens,valley early learning center,5,0,0,0,0,0,0,5,0,3,2,1,33070,valley,99181,5357,2016
stevens,valley,223,6,0,1,1,2,17,173,24,119,104,171,33070,valley,99181,2405,2016
clark,alki middle,684,2,34,3,37,10,64,522,49,356,328,173,06037,vancouver,98685,4406,2016
clark,benjamin franklin elementary,373,1,44,0,44,9,35,224,60,180,193,75,06037,vancouver,98663,3080,2016
clark,chinook elementary,699,3,25,3,28,2,69,542,55,350,349,141,06037,vancouver,98685,4405,2016
clark,columbia river high,1211,10,49,7,56,18,135,921,71,605,606,269,06037,vancouver,98665,3423,2016
clark,discovery middle,643,3,7,18,25,36,234,305,40,325,318,468,06037,vancouver,98663,4503,2016
clark,dwight d eisenhower elementary,559,3,27,3,30,9,96,370,51,290,269,218,06037,vancouver,98665,3733,2016
clark,early childhood education center,186,1,5,1,6,4,52,104,19,122,64,151,06037,vancouver,98668,2636,2016
clark,felida elementary,681,1,23,2,25,8,63,537,47,333,348,98,06037,vancouver,98685,4075,2016
clark,fir grove childrens center,60,2,0,0,0,2,10,44,2,54,6,48,06037,vancouver,98661,1574,2016
clark,fort vancouver high,1545,7,65,77,142,67,557,702,70,758,787,1029,06037,vancouver,98661,2179,2016
clark,fruit valley elementary,291,3,4,7,11,12,139,108,18,143,148,242,06037,vancouver,98680,2637,2016
clark,gaiser middle,909,3,28,21,49,51,248,496,62,440,469,512,06037,vancouver,98665,3902,2016
clark,gate program,29,1,3,0,3,0,3,20,2,20,9,11,06037,vancouver,98661,1738,2016
clark,george c marshall elementary,383,3,6,19,25,6,122,197,30,188,195,263,06037,vancouver,98661,3424,2016
clark,harney elementary,665,4,8,10,18,14,262,315,52,320,345,416,06037,vancouver,98661,2643,2016
clark,harry s truman elementary,592,1,27,16,43,13,130,337,68,287,305,350,06037,vancouver,98661,3735,2016
clark,hazel dell elementary,488,1,12,2,14,11,162,263,37,263,225,317,06037,vancouver,98665,2690,2016
clark,hough elementary,317,0,4,1,5,5,75,204,28,151,166,192,06037,vancouver,98660,2610,2016
clark,hudson's bay high,1229,16,27,21,48,34,350,710,71,653,576,685,06037,vancouver,98663,3081,2016
clark,jason lee middle,588,3,29,4,33,15,128,368,41,311,277,306,06037,vancouver,98665,3543,2016
clark,jefferson middle,813,3,20,2,22,19,99,622,48,406,407,226,06037,vancouver,98685,4591,2016
clark,lake shore elementary,411,1,14,1,15,5,48,318,24,225,186,105,06037,vancouver,98665,3017,2016
clark,lewis and clark high,78,0,1,0,1,0,13,58,6,39,39,61,06037,vancouver,98661,3932,2016
clark,lincoln elementary,404,4,8,6,14,6,92,256,32,213,191,254,06037,vancouver,98660,2318,2016
clark,martin luther king elementary,497,3,4,33,37,23,236,151,47,241,256,435,06037,vancouver,98661,3734,2016
clark,mcloughlin middle,914,2,34,49,83,30,455,289,55,462,452,723,06037,vancouver,98661,3146,2016
clark,minnehaha elementary,543,0,20,7,27,12,109,357,38,284,259,308,06037,vancouver,98663,2723,2016
clark,open doors vancouver,2,0,0,0,0,0,0,2,0,2,0,27,06037,vancouver,98668,5342,2016
clark,peter s ogden elementary,517,4,20,16,36,16,212,205,44,266,251,418,06037,vancouver,98662,2644,2016
clark,roosevelt elementary,693,1,19,37,56,12,326,247,51,358,335,563,06037,vancouver,98661,4410,2016
clark,sacajawea elementary,431,1,6,0,6,10,92,284,38,218,213,245,06037,vancouver,98685,4034,2016
clark,salmon creek elementary,512,1,24,2,26,9,51,380,45,259,253,160,06037,vancouver,98685,2964,2016
clark,sarah j anderson elementary,765,6,17,8,25,15,311,363,45,404,361,444,06037,vancouver,98686,3016,2016
clark,skyview high,2009,7,97,15,112,55,244,1439,152,1083,926,431,06037,vancouver,98685,4504,2016
clark,vancouver home connection,247,0,0,0,0,5,18,215,9,108,139,109,06037,vancouver,98668,3556,2016
clark,vancouver itech preparatory,363,4,11,6,17,8,47,259,28,248,115,94,06037,vancouver,98668,5271,2016
clark,vancouver school of arts and academics,602,5,14,3,17,9,67,460,44,189,413,122,06037,vancouver,98663,1689,2016
clark,vancouver virtual learning academy,404,5,1,11,12,8,96,256,27,231,173,237,06037,vancouver,98668,5149,2016
clark,walnut grove elementary,766,6,34,10,44,23,183,453,57,371,395,498,06037,vancouver,98661,2828,2016
clark,washington elementary,385,1,5,12,17,11,176,150,30,201,184,311,06037,vancouver,98663,3565,2016
king,chautauqua elementary,557,0,4,0,4,7,81,403,62,295,262,149,17402,vashon,98070,4468,2016
king,family link,41,0,5,0,5,0,1,30,5,22,19,14,17402,vashon,98070,1822,2016
king,mcmurray middle,363,1,7,1,8,4,39,289,22,206,157,70,17402,vashon,98070,3667,2016
king,student link,24,0,1,0,1,0,4,17,2,9,15,4,17402,vashon,98070,1938,2016
king,vashon island high,596,6,21,0,21,6,53,456,54,306,290,106,17402,vashon,98070,2419,2016
wahkiakum,julius a wendt elementary/john c thomas middle,323,4,0,2,2,2,24,276,15,164,159,205,35200,cathlamet,98612,2893,2016
wahkiakum,wahkiakum high,135,0,6,0,6,3,11,114,1,63,72,66,35200,cathlamet,98612,3467,2016
grant,developmental pre-school,4,0,0,0,0,0,4,0,0,4,0,3,13073,mattawa,99349,1981,2016
grant,mattawa elementary,441,5,0,0,0,0,421,13,2,227,214,345,13073,mattawa,99349,3152,2016
grant,mattawa elementary pre-school,7,0,0,0,0,0,7,0,0,6,1,4,13073,mattawa,99349,5120,2016
grant,morris schott elementary,284,0,0,0,0,0,283,1,0,151,133,238,13073,mattawa,99349,4222,2016
grant,saddle mountain elementary,537,1,0,0,0,0,522,12,2,291,246,434,13073,mattawa,99349,4490,2016
grant,sentinel tech alt,28,0,0,0,0,0,26,2,0,14,14,31,13073,mattawa,99349,1835,2016
grant,wahluke high,586,5,0,0,0,0,557,21,3,273,313,430,13073,mattawa,99349,4254,2016
grant,wahluke junior high,483,2,0,0,0,0,461,19,1,238,245,408,13073,mattawa,99349,5144,2016
walla walla,preston hall middle,67,0,1,0,1,0,8,55,3,41,26,35,36401,waitsburg,99361,2174,2016
walla walla,waitsburg elementary,118,1,3,0,3,0,19,91,4,68,50,74,36401,waitsburg,99361,2712,2016
walla walla,waitsburg high,100,0,1,0,1,0,6,86,7,56,44,33,36401,waitsburg,99361,2386,2016
walla walla,alternative education program,108,0,1,0,1,2,30,74,1,63,45,41,36140,walla walla,99362,2407,2016
walla walla,berney elementary,422,0,6,1,7,1,73,315,26,235,187,191,36140,walla walla,99362,2074,2016
walla walla,blue ridge elementary,345,0,2,0,2,4,266,64,9,182,163,339,36140,walla walla,99362,4193,2016
walla walla,edison elementary school - walla walla,436,1,4,0,4,3,245,171,12,215,221,336,36140,walla walla,99362,2528,2016
walla walla,garrison middle,600,3,5,2,7,5,261,305,19,297,303,328,36140,walla walla,99362,3510,2016
walla walla,green park elementary,425,2,3,0,3,3,182,217,18,202,223,292,36140,walla walla,99362,2078,2016
walla walla,lincoln high,180,1,0,0,0,1,43,129,6,91,89,158,36140,walla walla,99362,4071,2016
walla walla,pioneer middle,673,2,12,1,13,4,251,380,23,330,343,386,36140,walla walla,99362,2780,2016
walla walla,prospect point elementary,435,1,4,0,4,2,75,338,15,235,200,139,36140,walla walla,99362,2159,2016
walla walla,sharpstein elementary,461,3,5,0,5,2,210,224,17,241,220,267,36140,walla walla,99362,3728,2016
walla walla,walla walla high,1819,11,31,5,36,23,620,1076,53,888,931,798,36140,walla walla,99362,3468,2016
yakima,adams elementary,336,67,7,0,7,0,247,7,8,187,149,312,39207,wapato,98951,4518,2016
yakima,satus elementary,671,123,3,0,3,0,504,15,26,358,313,631,39207,wapato,98951,2757,2016
yakima,wapato high,808,145,13,1,14,1,586,39,23,388,420,631,39207,wapato,98951,3141,2016
yakima,wapato middle,807,183,16,1,17,0,550,30,27,409,398,718,39207,wapato,98951,2131,2016
grant,warden elementary,472,0,0,0,0,0,386,82,4,226,246,345,13146,warden,98857,2792,2016
grant,warden high,327,0,2,0,2,0,259,61,5,180,147,198,13146,warden,98857,3273,2016
grant,warden middle,183,0,0,0,0,0,142,38,3,89,94,126,13146,warden,98857,3909,2016
clark,canyon creek middle,244,1,5,2,7,1,15,208,12,135,109,57,06112,washougal,98671,4549,2016
clark,cape horn skye elementary,404,2,1,1,2,5,27,349,19,210,194,110,06112,washougal,98671,3270,2016
clark,gause elementary,610,1,2,0,2,4,72,489,42,330,280,197,06112,washougal,98671,2911,2016
clark,hathaway elementary,420,2,0,0,0,1,57,326,34,207,213,267,06112,washougal,98671,2509,2016
clark,jemtegaard middle,479,1,10,0,10,4,62,368,34,241,238,203,06112,washougal,98671,4207,2016
clark,washougal high,961,8,25,1,26,8,80,788,51,498,463,278,06112,washougal,98671,3147,2016
clark,washougal special services,24,0,0,0,0,0,1,22,1,18,6,14,06112,washougal,98671,1899,2016
adams,washtucna elementary/high,41,0,0,0,0,0,4,36,1,25,16,30,01109,washtucna,99371,3075,2016
douglas,waterville elementary,99,2,0,0,0,1,10,83,3,49,50,57,09209,waterville,98858,2161,2016
douglas,waterville high,181,2,1,0,1,0,53,118,7,88,93,100,09209,waterville,98858,2162,2016
stevens,wellpinit elementary,201,159,0,0,0,1,9,4,28,105,96,167,33049,wellpinit,99040,2549,2016
stevens,wellpinit high,88,64,0,0,0,0,11,6,7,48,40,47,33049,wellpinit,99040,2550,2016
stevens,wellpinit middle,75,53,0,0,0,0,8,3,11,38,37,56,33049,wellpinit,99040,4232,2016
chelan,abraham lincoln elementary,522,2,0,0,0,3,390,122,5,274,248,415,04246,wenatchee,98801,3209,2016
chelan,columbia elementary,464,1,2,0,2,4,330,115,12,241,223,417,04246,wenatchee,98801,2301,2016
chelan,foothills middle,625,1,11,0,11,2,242,347,22,331,294,340,04246,wenatchee,98801,4432,2016
chelan,john newbery elementary,540,2,8,0,8,2,216,294,18,278,262,322,04246,wenatchee,98801,4423,2016
chelan,lewis and clark elementary,463,0,3,0,3,1,331,122,6,239,224,390,04246,wenatchee,98801,2279,2016
chelan,mission view elementary,524,4,1,0,1,1,383,130,5,288,236,441,04246,wenatchee,98801,2347,2016
chelan,open doors re-engagement wenatchee,102,3,0,0,0,0,52,46,1,59,43,56,04246,wenatchee,98807,5316,2016
chelan,orchard middle,390,2,2,0,2,3,234,138,11,200,190,293,04246,wenatchee,98801,3370,2016
chelan,pioneer middle,656,3,3,0,3,0,321,309,20,335,321,419,04246,wenatchee,98801,3210,2016
chelan,skill source,8,0,0,0,0,0,1,7,0,3,5,2,04246,wenatchee,98801,1612,2016
chelan,sunnyslope elementary,315,0,8,1,9,0,62,230,14,148,167,90,04246,wenatchee,98801,3208,2016
chelan,valley academy of learning,171,0,1,0,1,3,8,153,6,88,83,29,04246,wenatchee,98801,1742,2016
chelan,washington elementary,621,1,5,0,5,6,181,405,23,335,286,303,04246,wenatchee,98801,2907,2016
chelan,wenatchee high,2203,6,16,2,18,16,988,1121,54,1110,1093,1201,04246,wenatchee,98801,2134,2016
chelan,westside high,243,3,1,2,3,2,103,126,6,130,113,160,04246,wenatchee,98801,1613,2016
spokane,centennial middle,641,3,9,0,9,11,56,517,45,349,292,331,32363,spokane,99212,3538,2016
spokane,dishman hills high,298,12,1,2,3,9,29,233,12,157,141,235,32363,spokane,99206,1628,2016
spokane,millwood kindergarten center,52,0,0,0,0,1,6,42,3,30,22,33,32363,spokane,99212,2711,2016
spokane,ness elementary,368,1,0,0,0,3,40,297,27,208,160,250,32363,spokane,99206,3196,2016
spokane,orchard center elementary,316,10,2,1,3,10,22,243,28,171,145,214,32363,spokane,99212,3129,2016
spokane,pasadena park elementary,409,7,12,1,13,7,17,349,16,203,206,155,32363,spokane,99212,3194,2016
spokane,re-engagement,6,0,0,0,0,0,0,6,0,4,2,0,32363,spokane,99212,5356,2016
spokane,seth woodard elementary,351,3,3,2,5,4,43,268,28,189,162,182,32363,spokane,99212,2956,2016
spokane,spokane valley high,106,0,0,0,0,0,6,92,8,49,57,49,32363,spokane,99212,1838,2016
spokane,spokane valley transition,168,2,0,1,1,4,9,139,13,77,91,99,32363,spokane,99212,1842,2016
spokane,west valley city,215,1,0,0,0,1,12,189,12,84,131,66,32363,spokane,99212,1755,2016
spokane,west valley high,850,8,20,1,21,17,59,684,60,420,430,358,32363,spokane,99212,3195,2016
yakima,ahtanum valley elementary,253,9,0,0,0,3,81,148,12,130,123,150,39208,yakima,98908,2822,2016
yakima,apple valley elementary,323,1,7,0,7,4,82,216,13,163,160,111,39208,yakima,98908,3699,2016
yakima,children's village,19,0,0,0,0,0,8,11,0,13,6,0,39208,yakima,98902,5096,2016
yakima,cottonwood elementary,429,3,17,1,18,5,110,282,11,225,204,139,39208,yakima,98908,4448,2016
yakima,mountainview elementary,180,1,0,0,0,1,48,119,11,92,88,121,39208,yakima,98908,2758,2016
yakima,summitview elementary,320,0,3,0,3,2,140,158,17,140,180,167,39208,yakima,98908,3207,2016
yakima,west valley high,1079,10,32,4,36,8,220,778,27,568,511,334,39208,yakima,98908,3074,2016
yakima,west valley high school freshman campus,406,1,10,1,11,6,116,262,10,219,187,174,39208,yakima,98908,5221,2016
yakima,west valley jr high,850,9,16,3,19,9,252,544,17,431,419,359,39208,yakima,98908,4040,2016
yakima,west valley middle,766,10,19,1,20,4,216,487,29,400,366,344,39208,yakima,98908,4506,2016
yakima,west valley preschool,39,0,1,0,1,1,8,29,0,24,15,2,39208,yakima,98903,5008,2016
yakima,wide hollow elementary,374,3,22,2,24,4,142,189,12,189,185,226,39208,yakima,98908,2505,2016
lewis,white pass elementary,208,2,0,0,0,1,16,187,2,106,102,153,21303,randle,98377,3555,2016
lewis,white pass jr. sr. high,228,3,1,0,1,2,11,208,3,114,114,134,21303,randle,98377,2859,2016
pierce,elk ridge elementary,362,1,3,0,3,0,33,303,22,194,168,108,27416,buckley,98321,2190,2016
pierce,foothills elementary,513,2,3,1,4,6,68,419,14,266,247,203,27416,buckley,98321,4309,2016
pierce,glacier middle,781,9,5,1,6,6,75,642,43,398,383,236,27416,buckley,98321,3458,2016
pierce,mountain meadow elementary,495,2,5,1,6,2,47,399,39,257,238,133,27416,buckley,98321,4471,2016
pierce,white river high,1206,11,10,3,13,4,100,1002,76,635,571,261,27416,buckley,98321,4569,2016
pierce,white river reengagement program,5,0,0,0,0,0,0,5,0,3,2,6,27416,buckley,98321,5338,2016
pierce,white river special ed services,6,0,0,0,0,0,1,5,0,6,0,7,27416,buckley,98321,5045,2016
pierce,wilkeson elementary,255,3,2,0,2,1,19,216,14,136,119,80,27416,wilkeson,98396,4170,2016
klickitat,columbia high,385,4,2,0,2,3,121,252,3,206,179,136,20405,white salmon,98672,2330,2016
klickitat,hulan l whitson elem,420,3,1,0,1,1,133,265,17,227,193,211,20405,white salmon,98672,2997,2016
klickitat,wallace & priscilla stevenson intermediate,276,1,0,1,1,0,94,173,7,149,127,118,20405,white salmon,98672,5368,2016
klickitat,wayne m henkle middle,195,1,2,0,2,0,70,117,5,97,98,97,20405,white salmon,98672,3394,2016
klickitat,white salmon academy,15,1,1,0,1,0,4,9,0,8,7,9,20405,white salmon,98672,5077,2016
lincoln,wilbur elementary,126,5,0,1,1,3,7,100,10,65,61,54,22200,wilbur,99185,3290,2016
lincoln,wilbur secondary,157,20,0,2,2,0,8,119,8,89,68,50,22200,wilbur,99185,3289,2016
pacific,willapa elementary,164,0,2,0,2,0,17,138,7,70,94,83,25160,menlo,98561,3444,2016
pacific,willapa valley middle-high,176,4,0,0,0,0,26,134,12,94,82,70,25160,menlo,98561,2542,2016
grant,wilson creek elementary,78,0,0,0,0,0,16,61,1,43,35,42,13167,wilson creek,98860,2472,2016
grant,wilson creek high,78,1,0,0,0,1,11,65,0,41,37,41,13167,wilson creek,98860,2473,2016
lewis,winlock middle,143,0,1,0,1,0,40,98,4,85,58,115,21232,winlock,98596,4369,2016
lewis,winlock miller elementary,292,1,0,0,0,0,79,189,23,160,132,244,21232,winlock,98596,2290,2016
lewis,winlock senior high,202,3,2,0,2,2,52,134,9,113,89,130,21232,winlock,98596,3597,2016
lewis,winolequa learning academy,27,0,0,0,0,0,4,23,0,17,10,36,21232,winlock,98596,1829,2016
grays harbor,wishkah valley elementary/high,151,3,0,0,0,1,2,145,0,66,85,80,14117,aberdeen,98520,3375,2016
klickitat,wishram high and elementary,78,10,0,0,0,0,8,51,9,54,24,68,20094,wishram,98673,2605,2016
cowlitz,lewis river academy,51,2,1,0,1,0,11,36,1,25,26,19,08404,woodland,98674,5246,2016
cowlitz,team high,72,0,0,0,0,2,5,62,3,39,33,35,08404,woodland,98674,1795,2016
cowlitz,woodland high,691,7,2,0,2,6,106,550,20,359,332,252,08404,woodland,98674,3546,2016
cowlitz,woodland intermediate,472,3,1,0,1,2,120,337,9,237,235,227,08404,woodland,98674,5408,2016
cowlitz,woodland middle,685,0,3,1,4,5,132,534,10,365,320,330,08404,woodland,98674,5409,2016
cowlitz,woodland primary,327,0,3,0,3,3,78,235,8,181,146,156,08404,woodland,98674,5407,2016
cowlitz,yale elementary,38,0,0,0,0,0,2,36,0,23,15,20,08404,ariel,98603,3513,2016
yakima,adams elementary,707,4,2,0,2,3,674,24,0,362,345,659,39007,yakima,98901,2592,2016
yakima,barge-lincoln elementary,623,4,0,0,0,1,575,33,10,326,297,588,39007,yakima,98901,3138,2016
yakima,davis high,2164,15,13,0,13,30,1793,246,67,1070,1094,1345,39007,yakima,98902,2116,2016
yakima,discovery lab,205,3,0,0,0,1,107,81,13,96,109,88,39007,yakima,98902,3023,2016
yakima,early childhood center,155,0,0,0,0,1,111,43,0,99,56,92,39007,yakima,98902,5019,2016
yakima,eisenhower high,2126,16,26,0,26,18,1402,596,68,1066,1060,1124,39007,yakima,98908,3206,2016
yakima,franklin middle,859,6,0,1,1,5,649,166,32,440,419,631,39007,yakima,98902,2410,2016
yakima,garfield elementary,552,3,0,0,0,5,513,27,4,279,273,515,39007,yakima,98902,2176,2016
yakima,gilbert elementary,579,10,2,0,2,5,377,167,18,290,289,416,39007,yakima,98908,2818,2016
yakima,hoover elementary,748,3,2,1,3,4,637,92,9,414,334,675,39007,yakima,98902,2715,2016
yakima,lewis & clark middle,843,8,2,2,4,5,708,101,17,422,421,632,39007,yakima,98902,3615,2016
yakima,martin luther king jr elementary,601,3,0,0,0,3,551,39,5,301,300,522,39007,yakima,98903,3817,2016
yakima,mcclure elementary school yakima,618,1,2,0,2,4,445,150,16,312,306,461,39007,yakima,98902,2899,2016
yakima,mckinley elementary,470,1,1,0,1,4,370,73,21,228,242,409,39007,yakima,98902,2177,2016
yakima,nob hill elementary,497,3,2,0,2,3,244,230,15,253,244,254,39007,yakima,98902,2819,2016
yakima,ridgeview elementary,643,2,1,0,1,6,529,99,6,323,320,515,39007,yakima,98903,2433,2016
yakima,robertson elementary,540,12,1,0,1,2,378,137,10,267,273,424,39007,yakima,98902,3264,2016
yakima,roosevelt elementary,550,9,2,2,4,8,429,86,14,283,267,450,39007,yakima,98902,2529,2016
yakima,stanton academy,325,10,0,0,0,4,245,56,10,173,152,244,39007,yakima,98902,4093,2016
yakima,washington middle,761,6,2,0,2,4,717,24,8,371,390,640,39007,yakima,98901,2314,2016
yakima,whitney elementary yakima,544,7,7,0,7,7,341,164,18,257,287,337,39007,yakima,98908,3312,2016
yakima,wilson middle,842,5,8,0,8,6,577,211,35,425,417,500,39007,yakima,98908,3368,2016
yakima,yakima online,118,0,2,0,2,2,53,56,5,52,66,75,39007,yakima,98902,5153,2016
yakima,yakima open doors,88,1,0,1,1,2,57,23,4,44,44,71,39007,yakima,98901,5355,2016
yakima,yakima satellite alternative programs,48,0,0,0,0,1,23,23,1,25,23,44,39007,yakima,98902,5224,2016
thurston,fort stevens elementary,576,4,11,5,16,3,84,393,76,297,279,307,34002,yelm,98597,4346,2016
thurston,lackamas elementary,305,1,3,1,4,2,39,224,35,169,136,144,34002,yelm,98597,5018,2016
thurston,mckenna elementary,482,1,2,1,3,1,57,370,50,239,243,234,34002,yelm,98597,2260,2016
thurston,mill pond elementary,563,12,10,8,18,16,85,375,57,299,264,232,34002,yelm,98597,4451,2016
thurston,ridgeline middle,613,2,3,4,7,3,75,470,56,309,304,230,34002,yelm,98597,5052,2016
thurston,southworth elementary,572,25,10,15,25,4,109,345,64,331,241,241,34002,yelm,98597,3848,2016
thurston,yelm extension,144,2,0,0,0,2,17,111,12,57,87,75,34002,yelm,98597,1627,2016
thurston,yelm high school 12,1244,14,23,13,36,27,163,913,91,646,598,399,34002,yelm,98597,2633,2016
thurston,yelm middle,683,11,15,5,20,16,90,477,69,314,369,322,34002,yelm,98597,2481,2016
thurston,yelm prairie elementary,526,12,3,1,4,1,76,381,52,287,239,221,34002,yelm,98597,4224,2016
yakima,hilton elementary,396,18,2,0,2,0,213,143,20,198,198,240,39205,zillah,98953,2783,2016
yakima,zillah high,436,20,1,1,2,1,185,218,10,221,215,183,39205,zillah,98953,2240,2016
yakima,zillah intermediate,304,14,0,0,0,1,155,121,13,175,129,177,39205,zillah,98953,4221,2016
yakima,zillah middle,221,10,1,0,1,0,116,87,7,131,90,127,39205,zillah,98953,4481,2016
grays harbor,a j west elementary,407,11,4,0,4,2,167,194,29,206,201,290,14005,aberdeen,98520,2834,2017
grays harbor,central park elementary,158,1,3,0,3,1,25,115,13,85,73,78,14005,aberdeen,98520,3216,2017
grays harbor,harbor high,136,7,2,1,3,2,42,74,8,62,74,93,14005,aberdeen,98520,3857,2017
grays harbor,hopkins elementary,58,0,0,1,1,0,17,34,6,32,26,60,14005,aberdeen,98520,3154,2017
grays harbor,j m weatherwax high,899,39,27,6,33,9,236,551,31,463,436,492,14005,aberdeen,98520,3476,2017
grays harbor,mcdermoth elementary,381,7,2,0,2,1,128,205,38,187,194,272,14005,aberdeen,98520,2449,2017
grays harbor,miller junior high,478,30,13,0,13,7,131,273,24,225,253,333,14005,aberdeen,98520,2305,2017
grays harbor,robert gray elementary,345,8,2,1,3,1,141,166,26,165,180,254,14005,aberdeen,98520,2763,2017
grays harbor,stevens elementary,497,17,15,0,15,6,174,244,41,263,234,363,14005,aberdeen,98520,2971,2017
lewis,adna elementary,273,5,1,0,1,3,20,243,1,143,130,66,21226,adna,98522,2227,2017
lewis,adna middle/high,372,1,3,0,3,0,24,331,13,198,174,90,21226,adna,98522,2441,2017
lincoln,almira elementary,109,0,0,0,0,1,7,98,3,49,60,39,22017,almira,99103,2860,2017
skagit,anacortes high,776,9,39,2,41,6,69,635,16,403,373,154,29103,anacortes,98221,2467,2017
skagit,anacortes middle,425,2,14,0,14,8,44,344,13,212,213,110,29103,anacortes,98221,2707,2017
skagit,cap sante high,67,1,0,1,1,2,9,53,1,29,38,39,29103,anacortes,98221,5176,2017
skagit,fidalgo elementary,448,2,16,0,16,2,48,367,13,226,222,126,29103,anacortes,98221,3182,2017
skagit,island view elementary,492,4,10,0,10,5,62,399,12,251,241,163,29103,anacortes,98221,3252,2017
skagit,mount erie elementary,480,2,16,1,17,4,38,402,17,239,241,113,29103,anacortes,98221,3057,2017
skagit,whitney elementary anacortes,137,2,3,0,3,1,20,111,0,80,57,33,29103,anacortes,98221,3404,2017
snohomish,arlington high,1622,19,35,12,47,22,173,1307,54,820,802,387,31016,arlington,98223,2523,2017
snohomish,arlington special educ,44,1,0,0,0,0,5,38,0,28,16,19,31016,arlington,98223,2277,2017
snohomish,eagle creek elementary,598,8,2,0,2,1,129,419,39,318,280,277,31016,arlington,98223,4327,2017
snohomish,haller middle,679,10,17,4,21,9,102,495,42,344,335,166,31016,arlington,98223,5010,2017
snohomish,kent prairie elementary,621,4,4,1,5,1,70,475,66,332,289,231,31016,arlington,98223,4436,2017
snohomish,pioneer elementary,578,6,5,0,5,5,90,416,56,279,299,159,31016,arlington,98223,4573,2017
snohomish,post middle,595,7,12,0,12,4,58,482,32,324,271,215,31016,arlington,98223,3124,2017
snohomish,presidents elementary,535,5,3,0,3,2,75,408,42,295,240,197,31016,arlington,98223,4154,2017
snohomish,weston high,117,0,1,1,2,2,12,99,2,67,50,57,31016,arlington,98223,4287,2017
asotin,asotin elementary,283,1,3,0,3,1,13,254,11,142,141,93,02420,asotin,99402,2507,2017
asotin,asotin jr sr high,382,3,4,0,4,0,26,324,25,186,196,92,02420,asotin,99402,2434,2017
king,alpac elementary,578,1,55,12,67,19,163,251,77,296,282,340,17408,pacific,98047,3825,2017
king,arthur jacobsen elementary,575,0,82,2,84,37,130,271,53,279,296,282,17408,auburn,98092,5082,2017
king,auburn mountainview high,1517,13,164,25,189,151,247,806,111,737,780,571,17408,auburn,98092,5037,2017
king,auburn riverside high,1639,7,174,41,215,85,425,792,115,780,859,545,17408,auburn,98092,4474,2017
king,auburn senior high,1696,46,105,88,193,149,507,665,136,900,796,927,17408,auburn,98002,2795,2017
king,cascade middle,726,3,66,30,96,78,182,311,56,359,367,405,17408,auburn,98002,2394,2017
king,chinook elementary,505,62,17,26,43,35,203,107,55,282,223,367,17408,auburn,98092,3439,2017
king,dick scobee elementary,533,1,29,25,54,52,160,195,71,266,267,392,17408,auburn,98002,2932,2017
king,evergreen heights elementary,507,0,83,14,97,46,99,189,76,255,252,238,17408,auburn,98001,3745,2017
king,gildo rey elementary,617,2,28,38,66,21,349,126,53,317,300,460,17408,auburn,98002,3669,2017
king,hazelwood elementary,560,7,40,10,50,18,169,268,48,287,273,261,17408,auburn,98092,4347,2017
king,ilalko elementary,607,3,61,21,82,23,195,215,89,295,312,328,17408,auburn,98092,4417,2017
king,lake view elementary,423,2,10,1,11,5,69,295,41,225,198,160,17408,auburn,98092,4120,2017
king,lakeland hills elementary,725,7,88,2,90,39,141,355,93,376,349,152,17408,auburn,98092,5051,2017
king,lea hill elementary,452,2,45,13,58,83,70,175,64,226,226,285,17408,auburn,98092,3525,2017
king,mt baker middle,1002,6,107,33,140,62,330,386,78,515,487,474,17408,auburn,98002,4462,2017
king,olympic middle,765,29,44,45,89,57,270,250,70,409,356,530,17408,auburn,98002,3169,2017
king,pioneer elementary,499,0,15,45,60,15,314,78,32,270,229,413,17408,auburn,98002,3227,2017
king,rainier middle,899,7,100,10,110,74,183,463,62,463,436,414,17408,auburn,98092,4385,2017
king,special ed,106,4,3,1,4,10,31,50,7,64,42,34,17408,auburn,98002,1915,2017
king,terminal park elementary,481,1,27,47,74,53,117,165,71,240,241,329,17408,auburn,98002,2659,2017
king,washington elementary,523,1,18,38,56,41,196,149,80,266,257,390,17408,auburn,98002,2326,2017
king,west auburn senior high,199,7,5,8,13,15,51,87,26,96,103,139,17408,auburn,98001,2702,2017
kitsap,bainbridge high,1306,8,48,0,48,5,88,1039,118,668,638,78,18303,bainbridge island,98110,2395,2017
kitsap,bainbridge special education services,22,1,0,0,0,0,2,16,3,16,6,0,18303,bainbridge island,98110,1939,2017
kitsap,capt johnston blakely elem,342,5,7,0,7,1,11,290,28,187,155,16,18303,bainbridge island,98110,3552,2017
kitsap,capt. charles wilkes elem,394,0,8,0,8,1,22,336,27,214,180,17,18303,bainbridge island,98110,3043,2017
kitsap,eagle harbor high,113,0,6,0,6,0,9,94,4,65,48,9,18303,bainbridge island,98110,1935,2017
kitsap,mosaic home education partnership,54,0,1,0,1,1,6,41,5,29,25,7,18303,bainbridge island,98110,1841,2017
kitsap,odyssey multiage program,125,0,2,0,2,2,2,111,8,66,59,5,18303,bainbridge island,98110,1699,2017
kitsap,ordway elementary,374,1,9,2,11,3,48,274,37,187,187,46,18303,bainbridge island,98110,4062,2017
kitsap,sakai intermediate,549,3,22,0,22,4,44,427,49,295,254,41,18303,bainbridge island,98110,4542,2017
kitsap,woodward middle,604,3,21,1,22,3,57,473,46,301,303,46,18303,bainbridge island,98110,4505,2017
pierce,bates technical high,270,6,9,5,14,31,22,183,14,209,61,0,27931,tacoma,98405,5950,2017
clark,amboy middle,579,4,3,0,3,1,11,549,11,297,282,168,06119,battle ground,98604,2671,2017
clark,battle ground high,2189,5,21,6,27,11,176,1873,97,1157,1032,548,06119,battle ground,98604,2415,2017
clark,cam academy,556,0,14,0,14,0,26,490,26,263,293,74,06119,battle ground,98604,1836,2017
clark,captain strong,715,1,4,2,6,1,70,598,39,396,319,272,06119,battle ground,98604,4352,2017
clark,chief umtuch middle,580,1,5,0,5,2,68,477,27,315,265,208,06119,battle ground,98604,5133,2017
clark,daybreak middle,481,2,4,4,8,4,43,403,21,250,231,174,06119,battle ground,98604,5089,2017
clark,daybreak primary,514,0,6,3,9,10,45,428,22,283,231,219,06119,battle ground,98604,5090,2017
clark,glenwood heights primary,723,1,39,4,43,5,79,566,29,374,349,287,06119,vancouver,98662,3018,2017
clark,homelink river,957,8,14,0,14,8,56,807,64,446,511,226,06119,battle ground,98604,1875,2017
clark,laurin middle,625,2,32,4,36,4,63,484,36,316,309,232,06119,battle ground,98604,3545,2017
clark,maple grove k-8,490,1,10,3,13,2,51,398,25,261,229,228,06119,battle ground,98604,5291,2017
clark,open doors battle ground,20,0,0,1,1,1,0,17,1,11,9,3,06119,battle ground,98604,5360,2017
clark,pleasant valley middle,511,3,32,5,37,5,84,347,35,260,251,171,06119,vancouver,98686,3997,2017
clark,pleasant valley primary,596,2,28,11,39,10,71,429,45,302,294,232,06119,battle ground,98604,3996,2017
clark,prairie high,1556,11,68,6,74,11,206,1163,91,809,747,409,06119,battle ground,98604,4104,2017
clark,preschool infant other,37,0,0,0,0,0,3,34,0,20,17,27,06119,battle ground,98604,4108,2017
clark,summit view high,349,1,1,1,2,2,17,320,7,151,198,164,06119,battle ground,98604,4450,2017
clark,tukes valley middle,499,0,3,0,3,0,48,426,22,243,256,164,06119,battle ground,98604,5131,2017
clark,tukes valley primary,638,1,1,0,1,3,48,555,30,344,294,190,06119,battle ground,98642,5132,2017
clark,yacolt primary,825,2,2,0,2,0,19,783,19,441,384,288,06119,yacolt,98675,2910,2017
king,ardmore elementary,446,0,158,1,159,30,111,118,28,225,221,183,17405,bellevue,98008,3633,2017
king,bellevue big picture,365,0,74,1,75,9,20,225,36,208,157,44,17405,bellevue,98007,5240,2017
king,bellevue high,1634,1,486,3,489,30,112,833,169,907,727,158,17405,bellevue,98004,2701,2017
king,bennett elementary,418,0,134,0,134,13,25,212,34,220,198,27,17405,bellevue,98008,3705,2017
king,central educational services,80,0,11,0,11,4,12,45,8,57,23,18,17405,bellevue,98009,5281,2017
king,cherry crest elementary,564,0,300,0,300,5,17,201,41,306,258,13,17405,bellevue,98005,3742,2017
king,chinook middle,978,0,300,4,304,15,78,486,95,499,479,94,17405,bellevue,98006,3338,2017
king,clyde hill elementary,666,1,289,0,289,5,37,274,60,357,309,32,17405,bellevue,98007,2847,2017
king,eastgate elementary,448,2,159,0,159,9,32,192,54,242,206,66,17405,bellevue,98006,3036,2017
king,enatai elementary,592,0,177,2,179,19,63,268,63,317,275,103,17405,bellevue,98007,2846,2017
king,grad alliance program,8,0,1,0,1,0,3,4,0,4,4,5,17405,bellevue,98005,5325,2017
king,highland middle,501,1,88,1,89,23,149,200,39,261,240,218,17405,bellevue,98006,3166,2017
king,interlake senior high,1653,3,568,2,570,62,264,614,140,860,793,377,17405,bellevue,98008,3588,2017
king,international,578,1,219,0,219,3,18,272,65,277,301,36,17405,bellevue,98005,3522,2017
king,jing mei elementary,328,0,197,0,197,3,10,41,77,158,170,14,17405,bellevue,98006,5308,2017
king,lake hills elementary,514,1,107,2,109,18,208,141,37,259,255,283,17405,bellevue,98007,3225,2017
king,medina elementary,543,0,265,0,265,1,22,210,45,278,265,9,17405,medina,98039,3436,2017
king,newport heights elementary,622,0,221,2,223,29,43,257,70,334,288,119,17405,bellevue,98006,3437,2017
king,newport senior high,1790,1,853,2,855,38,98,653,145,923,867,229,17405,bellevue,98006,3486,2017
king,odle middle,964,1,531,1,532,18,119,225,69,521,443,207,17405,bellevue,98007,3631,2017
king,phantom lake elementary,394,1,102,0,102,11,74,160,46,236,158,116,17405,bellevue,98008,3168,2017
king,puesta del sol elementary,571,0,70,1,71,6,128,297,69,278,293,37,17405,bellevue,98006,3224,2017
king,sammamish senior high,1058,4,217,3,220,58,195,499,82,521,537,373,17405,bellevue,98005,3282,2017
king,sherwood forest elementary,436,0,95,3,98,35,136,124,43,233,203,198,17405,bellevue,98008,3339,2017
king,somerset elementary,722,0,509,0,509,5,22,133,53,360,362,36,17405,bellevue,98006,3789,2017
king,spiritridge elementary,674,0,332,0,332,14,40,224,64,365,309,49,17405,bellevue,98008,3634,2017
king,stevenson elementary,576,0,329,4,333,15,164,48,16,297,279,238,17405,bellevue,98007,3100,2017
king,tillicum middle,654,0,135,2,137,17,83,357,60,321,333,98,17405,bellevue,98008,3435,2017
king,tyee middle,1001,0,529,1,530,24,58,278,111,541,460,115,17405,bellevue,98006,3283,2017
king,woodridge elementary,653,2,291,6,297,22,49,240,43,350,303,110,17405,bellevue,98005,3167,2017
whatcom,alderwood elementary,236,2,19,0,19,3,101,102,9,123,113,226,37501,bellingham,98225,3200,2017
whatcom,bellingham family partnership program,160,0,2,0,2,1,5,139,13,80,80,26,37501,bellingham,98225,5366,2017
whatcom,bellingham high,1081,13,34,1,35,13,163,787,70,547,534,277,37501,bellingham,98225,2553,2017
whatcom,bellingham re-engagement program,81,0,1,0,1,1,15,58,6,40,41,57,37501,bellingham,98225,5340,2017
whatcom,birchwood elementary,331,3,12,7,19,5,136,144,24,169,162,215,37501,bellingham,98225,2431,2017
whatcom,carl cozier elementary,293,6,9,8,17,9,43,196,22,143,150,175,37501,bellingham,98229,2817,2017
whatcom,columbia elementary,287,2,10,0,10,5,18,232,20,159,128,51,37501,bellingham,98225,2365,2017
whatcom,cordata elementary,428,2,67,3,70,23,93,197,43,226,202,275,37501,bellingham,98226,5239,2017
whatcom,fairhaven middle,631,5,39,0,39,5,57,483,42,328,303,113,37501,bellingham,98225,2066,2017
whatcom,geneva elementary,461,4,3,1,4,7,38,383,25,256,205,121,37501,bellingham,98229,2262,2017
whatcom,happy valley elementary,432,3,14,2,16,4,58,317,34,222,210,131,37501,bellingham,98225,3134,2017
whatcom,kulshan middle,544,6,20,1,21,13,97,366,41,282,262,234,37501,bellingham,98229,4442,2017
whatcom,lowell elementary,305,2,14,0,14,7,22,246,14,158,147,68,37501,bellingham,98225,2225,2017
whatcom,northern heights elementary,376,4,32,3,35,15,53,227,42,207,169,125,37501,bellingham,98226,4571,2017
whatcom,options high,105,2,0,0,0,4,18,67,14,47,58,68,37501,bellingham,98225,1647,2017
whatcom,parkview elementary,295,2,1,0,1,4,38,219,31,154,141,112,37501,bellingham,98225,3202,2017
whatcom,roosevelt elementary,398,5,10,0,10,6,117,237,23,206,192,217,37501,bellingham,98226,2067,2017
whatcom,sehome high,1192,15,76,4,80,19,122,879,77,618,574,240,37501,bellingham,98225,3576,2017
whatcom,shuksan middle,648,13,84,4,88,13,171,315,48,321,327,371,37501,bellingham,98225,3201,2017
whatcom,silver beach elementary,457,3,16,0,16,2,34,357,45,238,219,74,37501,bellingham,98226,2175,2017
whatcom,squalicum high,1362,13,135,5,140,25,264,811,109,713,649,515,37501,bellingham,98226,4515,2017
whatcom,sunnyland elementary,305,3,21,2,23,1,58,198,22,169,136,162,37501,bellingham,98225,2387,2017
whatcom,visions (seamar youth center),28,3,0,0,0,0,5,17,3,0,28,11,37501,bellingham,98225,1799,2017
whatcom,wade king elementary,419,0,20,0,20,8,31,322,38,211,208,77,37501,bellingham,98229,5125,2017
whatcom,whatcom middle,685,4,23,0,23,5,55,551,47,384,301,164,37501,bellingham,98225,2075,2017
adams,benge elementary,13,0,0,0,0,0,0,13,0,8,5,0,01122,benge,99105,3142,2017
pierce,acceleration academy,227,5,8,8,16,32,30,121,23,128,99,72,27403,spanaway,98387,5372,2017
pierce,bethel high,1674,33,81,55,136,142,226,1040,97,874,800,691,27403,spanaway,98387,2807,2017
pierce,bethel middle,654,10,30,38,68,48,119,340,69,345,309,385,27403,spanaway,98387,3250,2017
pierce,camas prairie elementary,604,8,39,31,70,60,88,298,80,338,266,350,27403,spanaway,98387,4296,2017
pierce,cedarcrest middle,613,8,47,42,89,79,103,265,69,319,294,385,27403,spanaway,98387,4186,2017
pierce,centennial elementary bethel,482,2,8,12,20,18,62,325,55,261,221,291,27403,graham,98338,4331,2017
pierce,challenger high,259,6,9,3,12,17,39,171,14,128,131,155,27403,spanaway,98387,1510,2017
pierce,chester h thompson elementary,578,5,9,51,60,50,180,195,88,257,321,415,27403,tacoma,98445,3649,2017
pierce,clover creek elementary,737,3,35,37,72,62,137,358,105,392,345,358,27403,tacoma,98446,2576,2017
pierce,cougar mountain middle,594,12,25,8,33,19,69,426,35,313,281,272,27403,graham,98338,4578,2017
pierce,elk plain school of choice,594,3,21,2,23,44,84,361,79,292,302,164,27403,spanaway,98397,2877,2017
pierce,evergreen elementary,520,5,37,48,85,47,113,190,80,274,246,352,27403,spanaway,98387,4099,2017
pierce,frederickson elementary,647,2,19,12,31,44,195,299,76,322,325,329,27403,puyallup,98375,5159,2017
pierce,frontier middle,707,15,27,8,35,27,77,506,47,364,343,262,27403,graham,98338,4407,2017
pierce,graham elementary,710,2,12,9,21,26,88,469,104,375,335,252,27403,graham,98338,4297,2017
pierce,graham kapowsin high,1951,29,88,28,116,132,280,1251,143,1005,946,630,27403,graham,98338,5033,2017
pierce,kapowsin elementary,407,3,2,3,5,3,29,320,47,228,179,171,27403,graham,98338,2748,2017
pierce,liberty middle,696,6,34,26,60,51,101,406,72,364,332,296,27403,spanaway,98387,5206,2017
pierce,naches trail elementary,578,13,20,20,40,39,85,301,100,296,282,265,27403,tacoma,98446,4102,2017
pierce,nelson elementary,544,3,7,10,17,17,95,350,62,269,275,213,27403,graham,98338,5160,2017
pierce,north star elementary,467,3,18,14,32,20,64,285,63,230,237,269,27403,graham,98338,4538,2017
pierce,pioneer valley elementary,455,2,13,24,37,34,65,242,75,252,203,176,27403,spanaway,98387,4381,2017
pierce,rocky ridge elementary,479,5,7,6,13,10,84,326,41,240,239,288,27403,graham,98338,4227,2017
pierce,roy elementary,308,2,3,3,6,4,25,237,34,167,141,185,27403,roy,98580,2543,2017
pierce,shining mountain elementary,739,3,27,36,63,38,185,321,129,398,341,441,27403,spanaway,98387,4103,2017
pierce,spanaway elementary,360,5,8,11,19,30,74,149,83,187,173,269,27403,spanaway,98387,2399,2017
pierce,spanaway lake high,1587,21,132,85,217,253,299,673,124,830,757,811,27403,spanaway,98387,4158,2017
pierce,spanaway middle,679,17,39,32,71,101,149,258,83,342,337,452,27403,tacoma,98445,3751,2017
pierce,thompson preschool,252,1,7,7,14,12,41,158,26,158,94,169,27403,tacoma,98445,1560,2017
klickitat,bickleton elementary & high,95,0,0,0,0,0,35,58,2,51,44,11,20203,bickleton,99322,3392,2017
whatcom,blaine elementary,491,3,23,2,25,10,53,365,35,246,245,238,37503,blaine,98230,2713,2017
whatcom,blaine high,705,6,21,11,32,7,100,515,45,370,335,303,37503,blaine,98230,3136,2017
whatcom,blaine home connections,74,3,0,0,0,0,4,62,5,36,38,6,37503,blaine,98230,5021,2017
whatcom,blaine middle,470,9,15,4,19,13,60,352,17,260,210,246,37503,blaine,98230,3796,2017
whatcom,blaine primary,498,3,18,1,19,8,62,376,30,265,233,276,37503,blaine,98230,4476,2017
whatcom,point roberts primary,14,0,0,0,0,0,1,12,1,5,9,2,37503,point roberts,98281,4459,2017
lewis,boistfort elem,102,3,0,1,1,0,14,82,2,62,40,56,21234,curtis,98538,2516,2017
kitsap,armin jahr elementary,428,3,18,11,29,30,111,178,77,223,205,310,18100,bremerton,98310,3641,2017
kitsap,bremerton high,1223,17,74,22,96,64,217,627,202,650,573,638,18100,bremerton,98337,3109,2017
kitsap,bremerton home link program,37,0,0,0,0,2,5,29,1,20,17,15,18100,bremerton,98312,1749,2017
kitsap,career & academic re-engagement center,55,0,1,1,2,4,9,36,4,36,19,53,18100,bremerton,98312,5395,2017
kitsap,crownhill elementary,424,2,9,3,12,21,99,227,63,236,188,244,18100,bremerton,98312,3108,2017
kitsap,kitsap lake elementary,423,4,16,6,22,13,60,265,59,205,218,188,18100,bremerton,98312,4421,2017
kitsap,mountain view middle,828,8,33,18,51,55,147,445,122,428,400,530,18100,bremerton,98310,4441,2017
kitsap,naval avenue elementary,366,0,7,7,14,26,104,170,52,174,192,208,18100,bremerton,98312,3171,2017
kitsap,renaissance alternative high,134,3,0,1,1,4,17,77,32,72,62,85,18100,bremerton,98312,1737,2017
kitsap,special services,51,0,1,1,2,2,7,36,4,30,21,28,18100,bremerton,98312,5161,2017
kitsap,west hills s.t.e.m. academy,651,7,21,10,31,45,124,344,100,379,272,448,18100,bremerton,98312,2613,2017
okanogan,brewster alternative,19,0,0,0,0,0,15,4,0,13,6,15,24111,brewster,98812,5272,2017
okanogan,brewster high,246,3,0,0,0,0,218,24,1,133,113,217,24111,brewster,98812,2800,2017
okanogan,brewster middle,206,2,0,0,0,0,181,22,1,117,89,186,24111,brewster,98812,4223,2017
douglas,bridgeport aurora high,16,0,0,0,0,0,13,3,0,9,7,19,09075,bridgeport,98813,1900,2017
douglas,bridgeport elementary,372,1,1,1,2,0,352,15,2,174,198,346,09075,bridgeport,98813,2562,2017
douglas,bridgeport high,231,2,1,0,1,1,200,25,2,136,95,190,09075,bridgeport,98813,2788,2017
douglas,bridgeport middle,245,0,0,1,1,0,229,14,1,114,131,225,09075,bridgeport,98813,4213,2017
jefferson,brinnon elementary,57,2,0,2,2,2,5,44,2,36,21,55,16046,brinnon,98320,2836,2017
skagit,allen elementary,469,2,8,3,11,3,276,150,21,243,226,354,29100,bow,98232,3603,2017
skagit,bay view elementary,537,4,12,1,13,3,141,356,19,286,251,177,29100,burlington,98233,4412,2017
skagit,becc,36,0,1,0,1,1,19,12,3,19,17,43,29100,burlington,98233,1650,2017
skagit,burlington edison high,1102,10,28,4,32,10,375,646,26,572,530,410,29100,burlington,98233,2362,2017
skagit,burlington-edison alternative,60,2,1,0,1,1,29,27,0,26,34,35,29100,burlington,98233,1928,2017
skagit,edison elementary - burlington/edison,469,2,7,1,8,4,72,361,21,254,215,115,29100,edison,98232,2379,2017
skagit,lucille umbarger elementary,701,7,10,0,10,5,364,286,27,365,336,440,29100,burlington,98233,3251,2017
skagit,west view elementary,385,1,4,0,4,3,272,92,13,195,190,252,29100,burlington,98233,2946,2017
clark,camas high,2184,11,156,6,162,24,163,1660,164,1106,1078,234,06117,camas,98607,4567,2017
clark,dorothy fox,471,3,38,0,38,6,35,340,49,245,226,44,06117,camas,98607,4182,2017
clark,grass valley elementary,580,1,55,3,58,9,50,412,50,304,276,66,06117,camas,98607,5158,2017
clark,hayes freedom high,155,1,2,0,2,2,6,133,11,68,87,58,06117,camas,98607,5104,2017
clark,helen baller elem,604,6,27,0,27,3,50,465,53,303,301,100,06117,camas,98607,2725,2017
clark,liberty middle,786,1,28,1,29,5,74,618,59,402,384,135,06117,camas,98607,5054,2017
clark,papermaker preschool,58,0,5,0,5,1,8,43,1,37,21,13,06117,camas,98607,5055,2017
clark,prune hill elem,517,2,65,2,67,1,50,345,52,250,267,58,06117,camas,98607,4563,2017
clark,skyridge middle,903,2,93,5,98,8,75,649,71,452,451,78,06117,camas,98607,4508,2017
clark,woodburn elementary,481,0,17,0,17,1,52,369,42,259,222,131,06117,camas,98607,5309,2017
clallam,cape flattery preschool,10,4,0,0,0,0,3,0,3,8,2,0,05401,sekiu,98381,1787,2017
clallam,clallam bay high & elementary,128,16,0,0,0,0,32,53,27,58,70,82,05401,clallam bay,98326,3422,2017
clallam,neah bay elementary,181,109,0,0,0,0,29,8,35,82,99,155,05401,neah bay,98357,2594,2017
clallam,neah bay junior/ senior high,177,105,0,0,0,0,27,8,37,90,87,117,05401,neah bay,98357,3145,2017
thurston,gravity high,381,26,5,5,10,18,50,277,0,200,181,0,34801,tumwater,98512,5305,2017
pierce,carbonado historical school 19,175,0,0,0,0,0,6,163,6,92,83,50,27019,carbonado,98323,2466,2017
chelan,beaver valley,33,0,1,0,1,0,0,32,0,18,15,2,04228,leavenworth,98826,4566,2017
chelan,cascade high,435,2,6,0,6,1,125,295,6,208,227,152,04228,leavenworth,98826,3564,2017
chelan,cascade home-link,18,0,0,0,0,1,1,16,0,6,12,0,04228,leavenworth,98826,5418,2017
chelan,icicle river middle,287,3,0,0,0,0,84,195,5,148,139,121,04228,leavenworth,98826,4403,2017
chelan,cashmere high,495,3,3,0,3,3,163,312,11,245,250,192,04222,cashmere,98815,3268,2017
chelan,cashmere middle,480,2,4,0,4,2,189,263,20,236,244,228,04222,cashmere,98815,2315,2017
chelan,vale elementary,636,0,3,0,3,3,276,338,16,336,300,299,04222,cashmere,98815,2787,2017
cowlitz,castle rock elementary,614,7,4,2,6,1,46,513,41,329,285,321,08401,castle rock,98611,2762,2017
cowlitz,castle rock high,414,9,2,1,3,0,41,336,25,221,193,183,08401,castle rock,98611,2281,2017
cowlitz,castle rock middle,254,2,0,1,1,1,20,218,12,134,120,126,08401,castle rock,98611,3969,2017
klickitat,centerville elementary,86,0,0,1,1,1,7,76,1,45,41,36,20215,centerville,98613,2251,2017
kitsap,brownsville elementary,436,0,10,4,14,7,38,280,97,236,200,98,18401,bremerton,98311,2994,2017
kitsap,central kitsap high,1490,5,109,19,128,41,186,901,229,712,778,270,18401,silverdale,98383,2615,2017
kitsap,central kitsap middle,714,3,46,7,53,27,78,431,122,369,345,181,18401,silverdale,98383,3237,2017
kitsap,clear creek elementary,496,4,13,1,14,18,95,301,64,262,234,232,18401,silverdale,98383,4016,2017
kitsap,cottonwood elementary,308,2,17,6,23,6,45,163,69,169,139,103,18401,bremerton,98311,4014,2017
kitsap,cougar valley elementary,470,3,7,0,7,18,53,325,64,227,243,122,18401,silverdale,98383,4341,2017
kitsap,emerald heights elementary,451,0,28,8,36,9,60,274,72,235,216,84,18401,silverdale,98383,4444,2017
kitsap,esquire hills elementary,338,1,19,11,30,12,39,182,74,199,139,157,18401,bremerton,98311,4015,2017
kitsap,fairview middle,696,0,50,18,68,37,118,344,129,348,348,274,18401,bremerton,98310,3791,2017
kitsap,green mountain elementary,369,0,0,0,0,5,27,293,44,193,176,115,18401,bremerton,98312,4393,2017
kitsap,klahowya secondary,1079,6,22,7,29,5,89,842,108,543,536,219,18401,silverdale,98383,4509,2017
kitsap,olympic high,1201,5,96,20,116,55,166,588,271,636,565,353,18401,bremerton,98311,4100,2017
kitsap,pinecrest elementary,369,0,7,0,7,20,69,178,95,186,183,145,18401,bremerton,98311,4527,2017
kitsap,ridgetop middle,713,3,52,15,67,18,116,393,116,361,352,202,18401,silverdale,98383,4249,2017
kitsap,silver ridge elementary,355,1,13,5,18,9,50,196,81,172,183,97,18401,silverdale,98383,4372,2017
kitsap,silverdale elementary,387,3,15,7,22,9,41,243,69,218,169,129,18401,silverdale,98383,4101,2017
kitsap,woodlands elementary,371,3,25,8,33,17,64,182,72,197,174,182,18401,bremerton,98311,4135,2017
spokane,adams elementary,524,8,19,4,23,8,60,401,24,277,247,261,32356,spokane valley,99037,3259,2017
spokane,bowdish middle,471,5,6,0,6,8,31,392,29,255,216,230,32356,spokane valley,99206,3260,2017
spokane,broadway elementary,499,9,3,24,27,20,82,333,28,264,235,381,32356,spokane valley,99206,2892,2017
spokane,central valley early learning center,89,2,2,1,3,2,7,69,6,63,26,69,32356,spokane valley,99206,5043,2017
spokane,central valley high,2124,16,55,20,75,23,141,1773,96,1132,992,554,32356,spokane valley,99037,3065,2017
spokane,chester elementary,410,2,3,3,6,7,25,362,8,209,201,99,32356,spokane valley,99206,3929,2017
spokane,cvsd open doors programs,29,0,0,2,2,0,3,24,0,12,17,12,32356,spokane valley,99016,5328,2017
spokane,evergreen middle,737,3,14,3,17,10,52,624,31,379,358,221,32356,spokane valley,99206,3890,2017
spokane,greenacres elementary,635,7,5,4,9,1,38,558,22,328,307,202,32356,spokane valley,99016,2157,2017
spokane,greenacres middle,771,1,13,1,14,7,53,658,38,377,394,195,32356,spokane valley,99016,3573,2017
spokane,horizon middle,484,2,4,0,4,1,28,425,24,259,225,114,32356,spokane valley,99206,4185,2017
spokane,i-tracc,86,1,0,0,0,0,8,68,9,44,42,55,32356,spokane valley,99037,5166,2017
spokane,liberty lake elementary,677,3,16,4,20,7,43,585,19,338,339,133,32356,liberty lake,99019,4529,2017
spokane,mcdonald elementary,362,9,3,3,6,15,26,297,9,221,141,203,32356,spokane valley,99216,3127,2017
spokane,mica peak high,101,2,4,1,5,0,2,86,6,54,47,63,32356,spokane valley,99037,3918,2017
spokane,north pines middle,517,7,9,19,28,12,61,380,29,260,257,355,32356,spokane valley,99206,2776,2017
spokane,opportunity elementary,437,10,8,3,11,17,57,327,15,237,200,300,32356,spokane valley,99206,2113,2017
spokane,ponderosa elementary,418,3,2,2,4,8,23,372,8,226,192,119,32356,spokane valley,99206,4098,2017
spokane,progress elementary,422,5,6,7,13,7,44,336,17,204,218,226,32356,spokane valley,99037,2953,2017
spokane,school to life,27,0,0,0,0,0,0,26,1,15,12,18,32356,spokane valley,99037,5003,2017
spokane,south pines elementary,419,5,4,2,6,18,43,332,15,223,196,187,32356,spokane valley,99206,3307,2017
spokane,spokane valley learning academy,74,0,0,0,0,1,1,72,0,24,50,23,32356,spokane valley,99216,1964,2017
spokane,summit,349,1,5,0,5,1,7,324,11,168,181,63,32356,spokane valley,99216,3465,2017
spokane,sunrise elementary,563,4,10,0,10,7,34,489,19,299,264,101,32356,spokane valley,99206,4160,2017
spokane,university elementary,329,7,2,3,5,10,31,266,10,169,160,173,32356,spokane valley,99206,3064,2017
spokane,university high,1790,20,20,13,33,36,122,1481,98,950,840,615,32356,spokane valley,99216,3415,2017
lewis,centralia high,1081,10,10,4,14,11,319,696,31,551,530,600,21401,centralia,98531,2166,2017
lewis,centralia middle,474,2,4,0,4,9,149,283,24,250,224,352,21401,centralia,98531,3240,2017
lewis,early learning center,52,1,1,0,1,0,10,39,0,36,16,40,21401,centralia,98531,5463,2017
lewis,edison elementary,368,0,4,0,4,1,132,199,20,176,192,275,21401,centralia,98531,2244,2017
lewis,fords prairie elementary,376,0,1,1,2,3,136,226,8,207,169,279,21401,centralia,98531,2704,2017
lewis,futurus high,69,0,0,0,0,1,21,40,7,30,39,56,21401,centralia,98531,5359,2017
lewis,jefferson lincoln elementary,375,2,0,0,0,1,157,200,13,188,187,313,21401,centralia,98531,3172,2017
lewis,oakview elementary,424,2,0,2,2,3,143,258,15,219,205,292,21401,centralia,98531,2291,2017
lewis,washington elementary,387,3,2,0,2,1,172,195,14,190,197,309,21401,centralia,98531,2768,2017
lewis,chehalis middle,632,3,5,1,6,5,123,456,39,324,308,295,21302,chehalis,98532,4311,2017
lewis,lewis county alternative,29,1,0,0,0,2,5,18,3,15,14,21,21302,chehalis,98532,5369,2017
lewis,olympic elementary,387,0,3,0,3,1,84,280,19,215,172,216,21302,longview,98632,2726,2017
lewis,w f west high,954,7,21,1,22,6,148,728,43,468,486,327,21302,chehalis,98532,2799,2017
spokane,betz elementary,405,3,11,1,12,7,55,315,13,211,194,215,32360,cheney,99004,2954,2017
spokane,birth to three,44,0,1,0,1,2,6,33,2,24,20,17,32360,cheney,99004,5126,2017
spokane,cheney high,1265,15,29,3,32,16,129,988,85,665,600,479,32360,cheney,99004,3610,2017
spokane,cheney middle,486,11,8,1,9,5,54,375,32,274,212,218,32360,cheney,99004,2447,2017
spokane,cheney open doors,11,1,0,0,0,0,1,7,2,5,6,5,32360,cheney,99004,5396,2017
spokane,homeworks,76,0,0,0,0,0,6,70,0,37,39,7,32360,cheney,99004,5035,2017
spokane,phil snowdon elementary,485,10,7,2,9,8,42,392,24,253,232,239,32360,cheney,99004,5294,2017
spokane,salnave elementary,373,5,2,0,2,10,43,293,20,192,181,223,32360,cheney,99004,3761,2017
spokane,sunset elementary,440,18,14,19,33,12,46,299,32,237,203,297,32360,airway heights,99001,2814,2017
spokane,three springs high,32,3,0,0,0,0,1,25,3,11,21,30,32360,cheney,99004,1769,2017
spokane,westwood middle,556,15,10,4,14,14,56,415,42,292,264,256,32360,spokane,99224,5269,2017
spokane,windsor elementary,523,3,3,2,5,6,41,429,39,279,244,229,32360,spokane,99224,3309,2017
stevens,gess elementary,338,2,2,1,3,3,14,301,15,192,146,228,33036,chewelah,99109,2664,2017
stevens,jenkins junior/senior high,392,1,3,0,3,3,10,369,6,199,193,189,33036,chewelah,99109,2404,2017
jefferson,chimacum creek primary,232,1,0,0,0,0,21,192,18,126,106,131,16049,chimacum,98325,4552,2017
jefferson,chimacum elementary,201,1,1,0,1,1,10,163,25,117,84,110,16049,chimacum,98325,2697,2017
jefferson,chimacum high,322,7,8,0,8,4,21,263,19,152,170,110,16049,chimacum,98325,3275,2017
jefferson,chimacum middle,214,2,4,0,4,2,25,165,16,107,107,105,16049,chimacum,98325,4261,2017
jefferson,open doors reengagement program,13,0,0,0,0,0,1,12,0,9,4,11,16049,chimacum,98325,5397,2017
jefferson,pi program,78,1,0,1,1,0,9,63,4,36,42,27,16049,chimacum,98325,1724,2017
asotin,charles francis adams high,832,25,9,2,11,11,54,706,25,412,420,316,02250,clarkston,99403,2299,2017
asotin,educational opportunity center,79,1,0,0,0,1,5,67,5,37,42,58,02250,clarkston,99403,1617,2017
asotin,educational opportunity center reengagement,8,0,0,0,0,0,1,7,0,3,5,6,02250,clarkston,99403,5413,2017
asotin,grantham elementary,282,4,0,0,0,4,22,231,21,159,123,233,02250,clarkston,99403,2962,2017
asotin,heights elementary,374,2,2,0,2,4,21,323,22,173,201,129,02250,clarkston,99403,4384,2017
asotin,highland elementary,324,4,4,0,4,2,45,249,20,157,167,246,02250,clarkston,99403,3266,2017
asotin,lincoln middle,413,7,6,0,6,8,30,349,13,212,201,234,02250,clarkston,99403,2501,2017
asotin,parkway elementary,349,8,3,0,3,10,28,291,9,174,175,246,02250,clarkston,99403,2823,2017
asotin,special services,65,0,2,0,2,1,1,59,2,39,26,24,02250,clarkston,99403,3616,2017
kittitas,cle elum roslyn elementary,400,3,3,0,3,1,37,339,17,204,196,175,19404,cle elum,98922,2328,2017
kittitas,cle elum roslyn high,272,0,5,0,5,1,28,222,16,144,128,78,19404,cle eum,98922,2329,2017
kittitas,swiftwater learning center,32,0,0,0,0,0,2,24,6,19,13,12,19404,cle elum,98922,1987,2017
kittitas,walter strom middle,184,2,3,0,3,1,22,150,6,102,82,66,19404,cle elum,98922,2570,2017
pierce,alfaretta house,144,0,0,4,4,15,48,55,22,83,61,39,27400,lakewood,98499,1825,2017
pierce,beachwood elementary,329,6,10,9,19,38,68,161,37,173,156,133,27400,jblm lewis north,98433,3454,2017
pierce,carter lake elementary,498,1,15,5,20,59,111,258,49,271,227,170,27400,jblm mcchord field,98439,3457,2017
pierce,clover park high,1197,5,80,100,180,168,473,240,131,608,589,886,27400,lakewood,98499,2425,2017
pierce,cpsd open doors program,177,1,2,11,13,28,57,54,24,95,82,114,27400,lakewood,98499,5411,2017
pierce,custer elementary,315,0,17,16,33,69,65,131,17,174,141,242,27400,lakewood,98498,2943,2017
pierce,dower elementary,293,2,12,16,28,53,76,74,60,164,129,268,27400,lakewood,98499,3455,2017
pierce,evergreen elementary,470,0,13,13,26,50,125,219,49,263,207,312,27400,jblm lewis main,98433,4396,2017
pierce,four heroes elementary,718,2,22,50,72,37,403,121,83,355,363,620,27400,lakewood,98499,5387,2017
pierce,harrison prep,675,2,46,12,58,79,211,227,97,313,362,330,27400,lakewood,98499,5027,2017
pierce,hillside elementary,554,3,14,23,37,79,164,235,35,270,284,364,27400,jblm lewis main,98433,3298,2017
pierce,hudtloff middle,718,5,32,22,54,74,272,215,97,388,330,445,27400,lakewood,98498,3248,2017
pierce,idlewild elementary,502,3,26,2,28,30,93,256,91,262,240,169,27400,lakewood,98498,3117,2017
pierce,lake louise elementary,388,0,4,24,28,35,100,123,102,196,192,302,27400,lakewood,98498,3351,2017
pierce,lakes high,1401,6,87,41,128,198,302,581,186,724,677,566,27400,lakewood,98498,3456,2017
pierce,lakeview hope academy,701,2,18,41,59,99,368,100,73,359,342,539,27400,lakewood,98499,2652,2017
pierce,lochburn middle,601,3,37,58,95,109,217,103,74,315,286,516,27400,lakewood,98499,3602,2017
pierce,mann middle,402,6,6,22,28,44,86,171,67,216,186,184,27400,lakewood,98498,3297,2017
pierce,meriwether elementary,330,1,11,7,18,24,86,151,50,152,178,110,27400,jblm lewis north,98433,5364,2017
pierce,oakbrook elementary,342,2,23,8,31,41,71,147,50,171,171,177,27400,lakewood,98498,3763,2017
pierce,park lodge elementary,477,4,10,22,32,63,210,82,86,237,240,383,27400,lakewood,98499,2189,2017
pierce,rainier elementary,533,3,19,13,32,73,153,214,58,280,253,254,27400,jblm lewis main,98433,5365,2017
pierce,special education services/relife,19,0,0,0,0,6,4,7,2,14,5,13,27400,lakewood,98499,1882,2017
pierce,tillicum elementary,351,2,10,35,45,34,131,96,43,190,161,321,27400,lakewood,98498,2651,2017
pierce,transition day students,9,0,0,0,0,1,1,7,0,4,5,5,27400,lakewood,98499,5297,2017
pierce,tyee park elementary,454,2,6,31,37,48,203,82,82,225,229,384,27400,lakewood,98499,3249,2017
pierce,woodbrook middle,491,2,25,23,48,66,153,164,58,256,235,343,27400,lakewood,98439,3500,2017
whitman,colfax high,296,0,2,0,2,1,11,264,18,158,138,89,38300,colfax,99111,3366,2017
whitman,leonard m jennings elementary,308,2,1,0,1,0,14,269,22,165,143,92,38300,colfax,99111,2894,2017
walla walla,college place high,336,2,3,2,5,8,113,197,11,180,156,131,36250,college place,99362,5362,2017
walla walla,davis elementary,692,2,6,2,8,9,322,332,19,339,353,428,36250,college place,99324,2114,2017
walla walla,john sager middle,326,2,4,1,5,5,135,173,6,176,150,189,36250,college place,99324,3541,2017
whitman,colton,154,0,3,0,3,0,4,142,5,85,69,30,38306,colton,99113,2588,2017
stevens,columbia alternative,3,0,0,0,0,0,0,3,0,3,0,0,33206,hunters,99137,5283,2017
stevens,columbia high and elementary,153,35,1,0,1,0,13,83,21,88,65,104,33206,hunters,99137,3508,2017
walla walla,columbia elementary,361,3,0,0,0,2,149,203,4,181,180,212,36400,burbank,99323,3613,2017
walla walla,columbia high,261,3,1,0,1,1,77,170,9,131,130,95,36400,burbank,99323,4049,2017
walla walla,columbia middle,168,0,0,0,0,3,63,99,3,85,83,83,36400,burbank,99323,3012,2017
stevens,colville junior high,387,8,3,1,4,1,14,340,20,196,191,178,33115,colville,99114,3831,2017
stevens,colville senior high,569,12,4,0,4,5,25,490,33,284,285,221,33115,colville,99114,3310,2017
stevens,fort colville elementary,398,7,3,0,3,2,25,351,10,193,205,216,33115,colville,99114,4180,2017
stevens,hofstetter elementary,375,3,1,0,1,0,19,337,15,191,184,224,33115,colville,99114,2957,2017
stevens,panorama,92,1,0,0,0,0,3,86,2,46,46,65,33115,colville,99114,1594,2017
skagit,concrete elementary,284,12,2,0,2,0,28,241,1,149,135,197,29011,concrete,98237,2577,2017
skagit,concrete high,256,3,1,1,2,0,21,224,6,134,122,128,29011,concrete,98237,2810,2017
skagit,special services,6,1,0,0,0,0,0,5,0,4,2,5,29011,concrete,98237,5087,2017
skagit,twin cedars high,10,0,0,0,0,0,0,10,0,4,6,15,29011,concrete,98237,1605,2017
skagit,conway,430,0,3,0,3,5,47,372,3,220,210,111,29317,mount vernon,98274,2578,2017
grays harbor,cosmopolis elementary,144,0,0,0,0,0,16,114,14,71,73,82,14099,cosmopolis,98537,3326,2017
grant,almira coulee hartline high,79,0,0,0,0,0,4,75,0,43,36,25,13151,coulee city,99115,2968,2017
grant,coulee city elementary,79,0,0,0,0,1,4,72,2,48,31,35,13151,coulee city,99115,2693,2017
island,coupeville elementary,433,0,2,0,2,4,70,296,61,210,223,141,15204,coupeville,98239,3664,2017
island,coupeville high,304,0,5,0,5,5,40,224,30,152,152,84,15204,coupeville,98239,2625,2017
island,coupeville middle,231,0,5,1,6,1,29,170,25,96,135,62,15204,coupeville,98239,4004,2017
island,open den,28,1,0,1,1,1,2,21,2,16,12,15,15204,coupeville,98239,5412,2017
clallam,crescent,216,4,0,0,0,0,10,180,22,113,103,104,05313,joyce,98343,3473,2017
clallam,homeconnection,84,0,3,0,3,0,0,80,1,38,46,34,05313,joyce,98343,5030,2017
lincoln,creston elementary,45,1,0,0,0,0,2,40,2,33,12,17,22073,creston,99117,2862,2017
lincoln,creston jr-sr high,46,0,0,0,0,0,1,43,2,27,19,15,22073,creston,99117,2863,2017
ferry,curlew elem & high,181,5,0,0,0,5,11,150,10,90,91,99,10050,curlew,99118,2006,2017
pend oreille,bess herian elementary,102,25,0,0,0,0,7,45,25,57,45,70,26059,cusick,99119,2770,2017
pend oreille,cusick jr sr high,138,47,3,0,3,0,11,66,11,75,63,74,26059,cusick,99119,2423,2017
kittitas,damman elementary,34,0,0,0,0,1,0,28,5,20,14,0,19007,ellensburg,98926,2077,2017
snohomish,darrington elementary,278,10,1,0,1,0,24,224,19,131,147,136,31330,darrington,98241,3609,2017
lincoln,davenport elementary,262,4,3,0,3,0,11,237,7,123,139,163,22207,davenport,99122,2668,2017
lincoln,davenport senior high,347,8,3,0,3,1,9,322,4,167,180,169,22207,davenport,99122,3173,2017
columbia,dayton elementary,201,2,1,0,1,0,35,157,6,100,101,119,07002,dayton,99328,2830,2017
columbia,dayton high,142,5,4,0,4,0,17,114,2,74,68,63,07002,dayton,99328,2302,2017
columbia,dayton middle,84,4,2,0,2,1,12,63,2,41,43,43,07002,dayton,99328,4011,2017
spokane,arcadia elementary,453,18,0,0,0,5,28,400,2,247,206,247,32414,deer park,99006,2173,2017
spokane,deer park elementary,411,7,0,1,1,5,23,374,1,214,197,218,32414,deer park,99006,2430,2017
spokane,deer park high,657,20,4,0,4,13,23,585,12,339,318,278,32414,deer park,99006,4123,2017
spokane,deer park home link program,504,7,3,1,4,6,23,462,2,253,251,82,32414,deer park,99006,1852,2017
spokane,deer park middle,477,9,6,0,6,7,33,421,1,241,236,249,32414,deer park,99006,3261,2017
pierce,dieringer heights elementary,494,2,34,0,34,11,38,367,42,260,234,57,27343,lake tapps,98391,4548,2017
pierce,lake tapps elementary,438,2,25,4,29,7,43,311,46,237,201,55,27343,lake tapps,98391,3683,2017
pierce,north tapps middle,504,0,31,2,33,3,47,375,46,252,252,48,27343,lake tapps,98391,4416,2017
walla walla,dixie elementary,23,1,0,0,0,0,0,22,0,10,13,16,36101,dixie,99329,2278,2017
spokane,children first,26,0,0,0,0,4,3,18,1,21,5,14,32361,spokane valley,99216,1937,2017
spokane,continuous curriculum,506,0,14,0,14,2,27,431,32,234,272,131,32361,spokane,99216,1712,2017
spokane,east farms,429,3,4,10,14,7,45,328,32,227,202,254,32361,newman lake,99025,4097,2017
spokane,east valley high,1120,15,13,12,25,14,108,899,59,585,535,496,32361,spokane valley,99216,3360,2017
spokane,east valley middle,484,7,3,6,9,5,46,378,39,232,252,281,32361,spokane valley,99216,5346,2017
spokane,ev online,111,0,0,1,1,2,11,94,3,57,54,34,32361,spokane valley,99216,5432,2017
spokane,ev parent partnership,197,0,0,0,0,3,25,165,4,106,91,55,32361,spokane valley,99216,5433,2017
spokane,otis orchards,426,8,8,2,10,2,32,344,30,215,211,247,32361,otis orchards,99027,2955,2017
spokane,trent,480,7,3,13,16,14,82,297,64,273,207,391,32361,spokane valley,99206,2653,2017
spokane,trentwood,459,8,8,3,11,1,40,363,36,235,224,284,32361,spokane valley,99216,3128,2017
yakima,east valley central middle,701,13,5,0,5,8,326,340,9,366,335,401,39090,yakima,98901,4055,2017
yakima,east valley elementary,581,4,1,1,2,3,290,263,19,313,268,380,39090,yakima,98901,4487,2017
yakima,east valley high,887,11,9,2,11,9,380,468,8,477,410,411,39090,yakima,98901,2344,2017
yakima,moxee elementary,515,3,2,0,2,2,317,175,16,246,269,301,39090,moxee,98936,2530,2017
yakima,terrace heights elementary,533,0,8,0,8,7,213,284,21,270,263,304,39090,yakima,98901,2821,2017
douglas,cascade elementary,511,0,4,0,4,0,196,298,13,264,247,221,09206,east wenatchee,98802,3659,2017
douglas,clovis point,620,1,1,3,4,0,347,250,18,327,293,407,09206,east wenatchee,98802,4590,2017
douglas,eastmont junior high,928,5,5,1,6,2,412,476,27,446,482,522,09206,east wenatchee,98802,3372,2017
douglas,eastmont senior high,1450,7,15,2,17,8,610,762,46,761,689,676,09206,east wenatchee,98802,2727,2017
douglas,grant elementary,502,1,6,2,8,0,253,229,11,260,242,283,09206,east wenatchee,98802,2966,2017
douglas,kenroy elementary,468,1,3,0,3,0,213,240,11,235,233,283,09206,east wenatchee,98802,3212,2017
douglas,rock island elementary,216,0,0,0,0,0,149,63,4,125,91,181,09206,rock island,98850,2563,2017
kittitas,easton,113,5,0,0,0,2,30,72,4,48,65,75,19028,easton,98925,3554,2017
pierce,columbia crest a-stem academy,200,0,3,0,3,1,14,164,18,97,103,100,27404,ashford,98304,2808,2017
pierce,eatonville developmental pre-school,5,0,0,0,0,0,0,5,0,2,3,3,27404,eatonville,98328,5079,2017
pierce,eatonville elementary,364,6,3,1,4,1,32,304,17,180,184,186,27404,eatonville,98328,2205,2017
pierce,eatonville high,653,4,3,3,6,4,42,565,32,324,329,217,27404,eatonville,98328,2206,2017
pierce,eatonville middle,388,3,2,5,7,5,25,321,27,219,169,154,27404,eatonville,98328,4230,2017
pierce,mt. rainier parent partnership,62,1,1,0,1,0,9,47,4,34,28,15,27404,eatonville,98328,5300,2017
pierce,new beginnings,8,0,0,0,0,0,1,5,2,2,6,8,27404,eatonville,98328,5332,2017
pierce,weyerhaeuser elementary,276,1,1,0,1,1,11,240,22,142,134,122,27404,eatonville,98328,2361,2017
snohomish,alderwood middle,762,3,153,9,162,50,182,299,66,397,365,326,31015,lynnwood,98037,3560,2017
snohomish,beverly elementary,588,7,64,14,78,37,136,267,63,287,301,231,31015,lynnwood,98037,3302,2017
snohomish,brier elementary,440,2,30,3,33,12,60,281,52,231,209,82,31015,brier,98036,3536,2017
snohomish,brier terrace middle,628,3,95,9,104,21,96,316,88,344,284,184,31015,brier,98036,3650,2017
snohomish,cedar valley community,469,3,41,1,42,41,251,102,30,251,218,379,31015,lynnwood,98036,3409,2017
snohomish,cedar way elementary,486,2,61,6,67,42,87,224,64,247,239,243,31015,mtlk terrace,98043,3304,2017
snohomish,challenge elementary,336,0,95,0,95,17,22,168,34,178,158,33,31015,mtlk terrace,98043,1520,2017
snohomish,chase lake elementary,356,1,25,3,28,36,91,166,34,191,165,206,31015,edmonds,98020,3534,2017
snohomish,college place elementary,489,4,40,4,44,66,204,124,47,253,236,341,31015,lynnwood,98036,3691,2017
snohomish,college place middle,520,1,45,3,48,51,148,218,54,287,233,234,31015,lynnwood,98036,3754,2017
snohomish,contracted schools,125,1,10,0,10,12,25,62,15,76,49,42,31015,lynnwood,98036,1830,2017
snohomish,early childhood center,147,1,9,0,9,17,39,64,17,113,34,86,31015,lynnwood,98036,3185,2017
snohomish,edmonds career access program,258,0,13,0,13,10,72,135,28,139,119,63,31015,lynnwood,98036,5358,2017
snohomish,edmonds elearning academy,81,1,5,2,7,2,12,54,5,33,48,39,31015,lynnwood,98036,1519,2017
snohomish,edmonds elementary,364,4,15,0,15,18,34,252,41,199,165,72,31015,edmonds,98020,3606,2017
snohomish,edmonds heights k-12,591,1,35,1,36,11,68,400,75,294,297,92,31015,edmonds,98020,1966,2017
snohomish,edmonds woodway high,1644,12,246,2,248,104,285,831,164,812,832,450,31015,edmonds,98026,3123,2017
snohomish,hazelwood elementary,506,3,83,0,83,37,102,234,47,279,227,177,31015,lynnwood,98036,3607,2017
snohomish,hilltop elementary,518,1,80,3,83,18,48,311,57,269,249,82,31015,lynnwood,98036,3689,2017
snohomish,lynndale elementary,413,3,36,3,39,31,110,184,46,215,198,206,31015,lynnwood,98036,3122,2017
snohomish,lynnwood elementary,602,4,108,4,112,41,151,228,66,326,276,296,31015,lynnwood,98037,3503,2017
snohomish,lynnwood high,1406,4,300,13,313,98,314,558,119,700,706,580,31015,bothell,98012,3755,2017
snohomish,maplewood parent coop,450,0,36,1,37,24,24,325,40,232,218,30,31015,edmonds,98026,1685,2017
snohomish,martha lake elementary,500,5,115,13,128,34,105,189,39,245,255,226,31015,lynnwood,98037,2887,2017
snohomish,meadowdale elementary,499,1,75,1,76,42,114,212,54,258,241,231,31015,lynnwood,98037,3504,2017
snohomish,meadowdale high,1625,8,248,12,260,97,295,838,127,859,766,513,31015,lynnwood,98037,3464,2017
snohomish,meadowdale middle,767,6,92,7,99,57,178,352,75,420,347,309,31015,lynnwood,98037,3353,2017
snohomish,mountlake terrace elementary,425,0,38,9,47,16,122,196,44,223,202,210,31015,mountlake terrace,98043,3254,2017
snohomish,mountlake terrace high,1317,7,145,8,153,52,209,748,148,680,637,344,31015,mtlk terrace,98043,3303,2017
snohomish,oak heights elementary,615,1,101,3,104,31,119,296,64,287,328,228,31015,lynnwood,98037,3608,2017
snohomish,scriber lake high,270,0,10,2,12,10,67,160,21,150,120,139,31015,edmonds,98020,3854,2017
snohomish,seaview elementary,388,0,19,2,21,8,47,256,56,214,174,94,31015,edmonds,98020,3461,2017
snohomish,sherwood elementary,484,4,21,0,21,27,78,298,56,238,246,125,31015,edmonds,98020,3605,2017
snohomish,spruce elementary,565,3,99,9,108,68,149,184,53,308,257,295,31015,lynnwood,98037,3410,2017
snohomish,terrace park elementary,334,2,39,8,47,21,71,154,39,163,171,126,31015,mtlk terrace,98043,2888,2017
snohomish,unassigned,82,0,7,0,7,1,16,54,4,52,30,9,31015,lynnwood,98036,1558,2017
snohomish,westgate elementary,491,3,37,5,42,38,81,260,67,249,242,177,31015,edmonds,98020,3186,2017
spokane,newesd 101 open doors,87,6,0,0,0,10,12,57,2,55,32,15,32801,spokane,99202,5434,2017
spokane,structural alt confinement,26,4,0,2,2,5,1,14,0,18,8,31,32801,spokane,99205,3507,2017
clark,esd 112 open doors reengagement,107,2,1,2,3,2,24,72,4,65,42,0,06801,vancouver,98661,5398,2017
kittitas,ellensburg developmental preschool,65,0,0,0,0,1,18,43,3,43,22,0,19401,ellensburg,98926,1924,2017
kittitas,ellensburg high,969,9,16,2,18,10,158,755,19,490,479,271,19401,ellensburg,98926,2996,2017
kittitas,k-12 ellensburg learning center,19,1,0,0,0,0,2,16,0,9,10,4,19401,ellensburg,98926,5097,2017
kittitas,lincoln elementary,518,5,13,2,15,2,107,388,1,261,257,199,19401,ellensburg,98926,2741,2017
kittitas,morgan middle,739,7,17,2,19,11,140,550,12,362,377,266,19401,ellensburg,98926,2453,2017
kittitas,mt. stuart elementary,506,5,7,0,7,8,100,383,3,273,233,291,19401,ellensburg,98926,3596,2017
kittitas,valley view elementary,515,2,3,0,3,5,79,409,17,269,246,183,19401,ellensburg,98936,4411,2017
grays harbor,east grays harbor high,34,1,0,0,0,0,4,23,6,12,22,11,14068,elma,98541,1629,2017
grays harbor,east grays harbor open doors,9,0,0,0,0,0,1,7,1,7,2,15,14068,elma,98541,5416,2017
grays harbor,elma elementary,615,9,5,0,5,4,153,400,44,319,296,395,14068,elma,98541,3217,2017
grays harbor,elma high,465,4,3,0,3,2,65,345,46,229,236,223,14068,elma,98541,2137,2017
grays harbor,elma middle,312,1,4,0,4,1,66,211,29,163,149,168,14068,elma,98541,4245,2017
whitman,endicott/st john elem and middle,100,0,0,0,0,0,6,90,4,61,39,63,38308,endicott,99125,2207,2017
chelan,entiat middle and high,185,0,2,1,3,0,63,111,8,91,94,113,04127,entiat,98822,3317,2017
chelan,paul rumburg elementary,154,0,0,0,0,0,59,94,1,92,62,103,04127,entiat,98822,2688,2017
king,black diamond elementary,282,1,1,2,3,0,54,203,21,140,142,101,17216,black diamond,98010,3430,2017
king,byron kibler elementary,438,1,3,2,5,0,87,331,14,212,226,169,17216,enumclaw,98022,2980,2017
king,enumclaw middle,455,2,2,3,5,4,58,370,16,226,229,155,17216,enumclaw,98022,4210,2017
king,enumclaw sr high,1339,25,6,3,9,10,162,1084,49,711,628,331,17216,enumclaw,98022,3330,2017
king,southwood elementary,302,4,3,0,3,4,35,243,13,151,151,101,17216,enumclaw,98022,3739,2017
king,special ed,23,0,1,0,1,2,2,16,2,14,9,7,17216,enumclaw,98022,1523,2017
king,sunrise elementary,419,3,4,4,8,1,70,324,13,225,194,146,17216,enumclaw,98022,4289,2017
king,thunder mountain middle,461,6,3,1,4,4,83,343,21,242,219,134,17216,enumclaw,98022,4550,2017
king,westwood elementary,333,6,1,0,1,4,58,249,15,171,162,90,17216,enumclaw,98022,3585,2017
grant,beezley springs elementary,30,0,1,0,1,0,13,16,0,15,15,24,13165,ephrata,98823,4229,2017
grant,columbia ridge elementary,482,0,0,1,1,1,186,287,7,244,238,329,13165,ephrata,98823,2793,2017
grant,ephrata high,718,1,9,0,9,4,214,477,13,378,340,299,13165,ephrata,98823,2920,2017
grant,ephrata middle,363,1,6,0,6,1,87,263,5,182,181,185,13165,ephrata,98823,3373,2017
grant,grant elementary,472,0,1,0,1,3,143,316,9,246,226,278,13165,ephrata,98823,3092,2017
grant,parkway,374,1,1,0,1,4,117,238,13,197,177,221,13165,ephrata,98823,2695,2017
lewis,evaline elementary,51,0,0,0,0,0,7,42,2,30,21,29,21036,winlock,98596,2355,2017
snohomish,cascade high,1804,20,235,28,263,90,375,969,87,949,855,737,31002,everett,98203,3407,2017
snohomish,cedar wood elementary,719,1,232,2,234,14,61,351,58,383,336,71,31002,bothell,98012,4382,2017
snohomish,eisenhower middle,863,4,113,9,122,46,189,451,51,428,435,359,31002,everett,98208,3752,2017
snohomish,emerson elementary,652,0,70,7,77,46,236,241,52,324,328,448,31002,everett,98208,3184,2017
snohomish,everett high,1494,17,103,52,155,72,262,909,79,754,740,635,31002,everett,98201,2126,2017
snohomish,everett reengagement academy,42,0,2,0,2,3,10,23,4,22,20,26,31002,everett,98213,5330,2017
snohomish,evergreen middle,1008,5,98,14,112,48,273,518,52,498,510,589,31002,everett,98203,3253,2017
snohomish,forest view elementary,722,2,182,0,182,15,54,414,55,370,352,57,31002,everett,98208,5091,2017
snohomish,garfield elementary,434,5,12,14,26,15,119,217,52,213,221,305,31002,everett,98201,2065,2017
snohomish,gateway middle,896,1,189,3,192,16,75,525,87,436,460,94,31002,everett,98208,4437,2017
snohomish,hawthorne elementary school - everett,472,3,32,41,73,40,150,170,36,248,224,434,31002,everett,98201,2883,2017
snohomish,heatherwood middle,965,6,167,4,171,34,134,541,79,513,452,248,31002,mill creek,98012,4334,2017
snohomish,henry m. jackson high,2197,10,419,9,428,67,270,1273,149,1100,1097,366,31002,mill creek,98012,4438,2017
snohomish,jackson elementary,353,1,9,4,13,13,76,208,42,179,174,228,31002,everett,98201,2751,2017
snohomish,jefferson elementary,579,3,64,2,66,25,96,356,33,281,298,224,31002,everett,98208,3533,2017
snohomish,lowell elementary - everett,502,3,43,3,46,21,146,239,47,251,251,353,31002,everett,98203,2811,2017
snohomish,madison elementary,432,0,36,19,55,21,173,157,26,222,210,329,31002,everett,98203,2669,2017
snohomish,mill creek elementary,676,0,136,2,138,22,72,388,56,363,313,67,31002,mill creek,98012,4316,2017
snohomish,monroe elementary,580,1,50,3,53,35,108,326,57,311,269,244,31002,everett,98208,3686,2017
snohomish,north middle,721,9,44,38,82,47,149,388,46,374,347,452,31002,everett,98201,2364,2017
snohomish,nw learning center,2,0,0,0,0,0,1,1,0,2,0,0,31002,everett,98213,1663,2017
snohomish,penny creek elementary,752,3,136,3,139,29,84,434,63,379,373,164,31002,everett,98208,4530,2017
snohomish,port gardner,122,0,3,0,3,1,7,105,6,57,65,15,31002,everett,98201,1907,2017
snohomish,sequoia high,197,5,2,1,3,15,31,120,23,87,110,128,31002,everett,98201,4137,2017
snohomish,silver firs elementary,499,3,68,4,72,16,71,298,39,276,223,88,31002,everett,98208,4298,2017
snohomish,silver lake elementary - everett,645,4,96,6,102,26,172,293,48,326,319,309,31002,everett,98208,2545,2017
snohomish,special services,171,0,14,1,15,9,32,101,14,102,69,23,31002,everett,98213,3903,2017
snohomish,view ridge elementary,575,0,28,2,30,15,88,402,40,301,274,220,31002,everett,98203,3002,2017
snohomish,whittier elementary,496,5,22,0,22,25,64,330,50,253,243,177,31002,everett,98201,2752,2017
snohomish,woodside elementary,685,0,78,4,82,16,182,328,77,354,331,221,31002,bothell,98012,4125,2017
clark,49th street academy,105,1,9,0,9,11,14,66,4,81,24,70,06114,vancouver,98682,1646,2017
clark,burnt bridge creek elementary,470,3,16,11,27,10,80,296,54,249,221,218,06114,vancouver,98682,4299,2017
clark,burton elementary,431,2,10,10,20,7,129,247,26,217,214,272,06114,vancouver,98682,3736,2017
clark,cascade middle,913,6,38,28,66,25,235,500,81,486,427,541,06114,vancouver,98684,3785,2017
clark,columbia valley elementary,581,1,53,5,58,23,111,333,55,307,274,228,06114,vancouver,98683,4587,2017
clark,covington middle,1065,7,37,27,64,25,301,595,73,553,512,661,06114,vancouver,98662,3320,2017
clark,crestline elementary,544,1,11,13,24,16,219,233,51,270,274,366,06114,vancouver,98683,3822,2017
clark,early childhood center,137,1,5,1,6,5,47,69,9,101,36,92,06114,vancouver,98682,1530,2017
clark,ellsworth elementary,443,1,14,5,19,10,158,199,56,221,222,272,06114,vancouver,98664,3148,2017
clark,endeavour elementary,736,2,35,34,69,14,209,367,75,378,358,408,06114,vancouver,98684,5136,2017
clark,evergreen high,1739,10,81,55,136,62,354,1058,119,903,836,808,06114,vancouver,98684,2724,2017
clark,fircrest elementary,497,3,25,23,48,8,115,291,32,265,232,310,06114,vancouver,98684,3971,2017
clark,fishers landing elementary,663,1,112,1,113,16,58,406,69,334,329,111,06114,vancouver,98683,4499,2017
clark,frontier middle,804,4,51,15,66,19,137,528,50,409,395,351,06114,vancouver,98682,4498,2017
clark,harmony elementary,661,1,33,13,46,20,68,471,55,345,316,176,06114,vancouver,98684,4380,2017
clark,hearthwood elementary,399,1,14,5,19,12,72,253,42,216,183,208,06114,vancouver,98684,4163,2017
clark,heritage high,1879,17,91,42,133,62,436,1123,108,1001,878,884,06114,vancouver,98682,4523,2017
clark,home choice academy,148,0,5,0,5,1,11,121,10,69,79,49,06114,vancouver,98682,1926,2017
clark,illahee elementary,601,1,90,9,99,15,76,352,58,293,308,160,06114,camas,98607,4560,2017
clark,image elementary,706,2,31,15,46,20,147,408,83,354,352,394,06114,vancouver,98682,3994,2017
clark,legacy high,195,2,0,2,2,6,21,144,20,81,114,102,06114,vancouver,98684,4042,2017
clark,marrion elementary,545,1,5,8,13,8,217,255,51,278,267,390,06114,vancouver,98664,3618,2017
clark,mill plain elementary,460,4,15,19,34,13,139,224,46,221,239,284,06114,vancouver,98684,2829,2017
clark,mountain view high,1940,13,197,22,219,78,451,1025,154,1038,902,688,06114,vancouver,98683,4162,2017
clark,open doors evergreen,6,1,1,0,1,1,0,3,0,3,3,0,06114,vancouver,98682,5435,2017
clark,orchards elementary,544,4,14,13,27,9,158,297,49,285,259,403,06114,vancouver,98662,2912,2017
clark,pacific middle,985,6,60,14,74,20,171,626,88,518,467,368,06114,vancouver,98684,4209,2017
clark,pioneer elementary,715,1,35,12,47,20,222,387,38,359,356,372,06114,vancouver,98682,4445,2017
clark,riverview elementary,479,2,23,3,26,19,106,271,55,248,231,217,06114,vancouver,98684,3995,2017
clark,shahala middle,1125,1,180,7,187,37,169,628,103,594,531,285,06114,vancouver,98683,4561,2017
clark,sifton elementary,481,1,15,7,22,4,130,289,35,235,246,296,06114,vancouver,98682,3149,2017
clark,silver star elementary,477,2,11,5,16,7,71,343,38,252,225,269,06114,vancouver,98662,3823,2017
clark,sunset elementary,560,5,26,8,34,14,101,367,39,299,261,310,06114,vancouver,98662,3970,2017
clark,union high,2024,11,219,29,248,62,271,1286,146,1056,968,505,06114,camas,98607,5111,2017
clark,wyeast middle,868,10,23,16,39,26,281,440,72,465,403,472,06114,vancouver,98683,4051,2017
clark,york elementary,538,2,24,0,24,7,93,368,44,273,265,200,06114,vancouver,98682,4579,2017
stevens,evergreen,28,9,0,0,0,0,0,13,6,14,14,18,33205,gifford,99131,3197,2017
king,excel public charter,187,0,16,2,18,58,17,67,27,108,79,74,17906,kent,98031,5377,2017
king,adelaide elementary,398,1,27,35,62,35,129,108,63,215,183,266,17210,federal way,98023,3519,2017
king,birth to three development center,120,0,10,8,18,10,47,28,17,80,40,60,17210,federal way,98093,5279,2017
king,brigadoon elementary,368,3,20,7,27,42,92,139,65,196,172,188,17210,federal way,98023,3700,2017
king,camelot elementary,327,4,40,11,51,23,63,139,47,171,156,197,17210,auburn,98001,3547,2017
king,career academy at truman high,108,4,7,10,17,13,29,30,15,45,63,72,17210,federal way,98003,5163,2017
king,decatur high,1392,8,129,67,196,213,335,513,127,731,661,592,17210,federal way,98023,3766,2017
king,employment transition program,44,0,6,2,8,8,5,21,2,34,10,26,17210,federal way,98023,1950,2017
king,enterprise elementary,436,6,54,21,75,44,105,138,68,231,205,255,17210,federal way,98023,4470,2017
king,federal way high,1566,7,171,123,294,223,520,346,176,813,753,867,17210,federal way,98003,2417,2017
king,federal way public academy,312,0,58,5,63,22,45,136,46,145,167,85,17210,federal way,98003,1789,2017
king,federal way public school eceap,10,0,0,0,0,0,8,1,1,7,3,11,17210,federal way,98003,5218,2017
king,federal way public schools headstart,4,0,0,0,0,0,3,1,0,3,1,7,17210,federal way,98003,5219,2017
king,federal way running start home,2,0,0,0,0,0,0,2,0,2,0,0,17210,federal way,98003,5107,2017
king,gateway to college,30,0,1,2,3,4,10,10,3,20,10,12,17210,federal way,98003,5255,2017
king,green gables elementary,430,0,34,11,45,53,66,194,72,210,220,151,17210,federal way,98023,4426,2017
king,illahee middle,768,4,125,37,162,108,172,222,100,402,366,393,17210,federal way,98003,3898,2017
king,internet academy,207,2,9,2,11,14,28,131,21,86,121,86,17210,federal way,98003,1759,2017
king,kilo middle,566,2,56,12,68,35,211,185,65,278,288,371,17210,auburn,98001,3701,2017
king,lake dolloff elementary,468,3,57,22,79,79,104,115,88,259,209,329,17210,auburn,98001,3738,2017
king,lake grove elementary,422,5,21,28,49,53,147,94,74,203,219,336,17210,federal way,98023,3568,2017
king,lakeland elementary,409,4,42,17,59,31,71,205,39,198,211,200,17210,auburn,98001,2841,2017
king,lakota middle,761,2,82,44,126,88,195,249,101,397,364,399,17210,federal way,98023,3381,2017
king,mark twain elementary,586,0,66,65,131,109,243,57,46,292,294,481,17210,federal way,98003,3627,2017
king,meredith hill elementary,492,1,79,11,90,34,121,198,48,270,222,220,17210,auburn,98001,4480,2017
king,mirror lake elementary,360,1,31,29,60,72,122,58,47,187,173,356,17210,federal way,98003,3159,2017
king,nautilus k-8,553,3,50,41,91,54,145,190,70,280,273,314,17210,federal way,98003,3625,2017
king,olympic view elementary,409,2,18,18,36,40,228,54,49,231,178,362,17210,federal way,98023,3432,2017
king,open doors youth reengagement (1418),179,3,13,12,25,35,48,45,23,92,87,133,17210,federal way,98003,5348,2017
king,panther lake elementary,474,3,51,53,104,89,126,85,67,251,223,337,17210,federal way,98003,3329,2017
king,rainier view elementary,524,0,32,21,53,117,134,138,82,286,238,378,17210,federal way,98003,4422,2017
king,sacajawea middle,718,3,96,59,155,66,250,158,86,377,341,483,17210,federal way,98003,3626,2017
king,sequoyah middle,584,1,73,23,96,96,136,178,77,280,304,389,17210,auburn,98001,5029,2017
king,sherwood forest elementary,451,3,77,16,93,36,109,149,61,245,206,229,17210,federal way,98023,4374,2017
king,silver lake elementary school - federal way,465,0,32,44,76,97,151,84,57,234,231,328,17210,federal way,98023,4343,2017
king,star lake elementary,425,4,50,24,74,65,116,95,71,232,193,239,17210,kent,98031,3160,2017
king,sunnycrest elementary,606,2,50,27,77,96,266,86,79,309,297,538,17210,kent,98032,3567,2017
king,support,89,1,4,1,5,7,24,29,23,60,29,35,17210,federal way,98003,1951,2017
king,thomas jefferson high,1765,4,337,43,380,228,451,528,174,869,896,883,17210,auburn,98001,3584,2017
king,todd beamer high,1688,10,228,80,308,226,341,610,193,851,837,765,17210,federal way,98003,4570,2017
king,totem middle,673,3,85,46,131,107,241,106,85,334,339,472,17210,kent,98031,3431,2017
king,twin lakes elementary,372,1,22,20,42,58,98,109,64,208,164,246,17210,federal way,98023,3628,2017
king,valhalla elementary,597,1,79,21,100,36,275,122,63,290,307,430,17210,auburn,98001,3582,2017
king,wildwood elementary,591,0,31,38,69,67,340,60,55,303,288,513,17210,federal way,98003,3583,2017
king,woodmont k-8,489,4,55,18,73,67,140,145,60,227,262,293,17210,des moines,98198,3328,2017
whatcom,beach elem,31,1,0,0,0,0,2,25,3,15,16,9,37502,lummi island,98262,2263,2017
whatcom,cascadia elementary,479,7,27,0,27,1,116,299,29,244,235,228,37502,ferndale,98248,5207,2017
whatcom,central elementary,328,1,11,3,14,1,73,209,30,168,160,176,37502,ferndale,98248,2458,2017
whatcom,custer elem,334,6,5,0,5,2,62,251,8,163,171,181,37502,custer,98240,2607,2017
whatcom,eagleridge elementary,507,110,8,0,8,2,97,230,60,272,235,286,37502,ferndale,98248,4482,2017
whatcom,ferndale high,1435,91,57,1,58,15,262,924,85,749,686,524,37502,ferndale,98248,2488,2017
whatcom,ferndale re-engagement,44,10,2,0,2,0,6,25,1,23,21,22,37502,ferndale,98248,5464,2017
whatcom,ferndale special services,37,12,0,0,0,0,11,13,1,21,16,0,37502,ferndale,98248,5084,2017
whatcom,horizon middle,452,49,12,1,13,6,87,266,31,262,190,220,37502,ferndale,98248,4554,2017
whatcom,skyline elementary,420,74,10,0,10,10,55,238,33,219,201,202,37502,ferndale,98248,4130,2017
whatcom,vista middle,619,43,28,4,32,10,127,370,37,297,322,289,37502,ferndale,98248,3762,2017
whatcom,windward high,124,7,2,0,2,2,10,96,7,50,74,41,37502,ferndale,98248,5245,2017
pierce,columbia junior high,591,3,58,28,86,18,106,316,62,305,286,227,27417,tacoma,98424,4582,2017
pierce,discovery primary,603,3,32,34,66,27,107,278,122,328,275,266,27417,milton,98354,2878,2017
pierce,endeavour intermediate,583,5,43,33,76,28,136,253,85,286,297,311,27417,milton,98354,2809,2017
pierce,fife high,824,7,73,33,106,25,151,435,100,431,393,253,27417,tacoma,98424,2773,2017
pierce,hedden elementary,563,3,38,13,51,23,101,301,84,283,280,202,27417,edgewood,98372,4557,2017
pierce,surprise lake middle,551,3,53,30,83,23,115,258,69,262,289,230,27417,milton,98354,3798,2017
benton,finley elementary,388,1,0,0,0,1,177,194,15,201,187,300,03053,kennewick,99337,3078,2017
benton,finley middle,211,0,0,0,0,1,103,100,7,118,93,153,03053,kennewick,99337,4031,2017
benton,river view high,330,1,4,0,4,3,135,175,12,180,150,223,03053,kennewick,99337,2367,2017
pierce,brookdale elementary,463,7,33,31,64,30,111,161,90,233,230,354,27402,tacoma,98444,3180,2017
pierce,central avenue elementary,496,6,46,8,54,20,95,244,77,267,229,332,27402,tacoma,98446,2398,2017
pierce,christensen elementary,461,2,19,51,70,74,137,113,65,213,248,379,27402,tacoma,98444,3301,2017
pierce,collins elementary,396,4,28,5,33,9,87,212,51,183,213,222,27402,tacoma,98446,2257,2017
pierce,elmhurst elementary,461,4,20,20,40,60,92,154,111,256,205,338,27402,tacoma,98445,3532,2017
pierce,franklin pierce high,1197,8,100,42,142,102,295,535,115,613,584,644,27402,tacoma,98445,2876,2017
pierce,gates secondary,125,3,2,10,12,13,28,53,16,55,70,98,27402,tacoma,98444,4063,2017
pierce,harvard elementary,395,3,28,12,40,18,235,62,37,219,176,335,27402,tacoma,98445,3000,2017
pierce,james sales elementary,482,4,12,31,43,58,158,136,83,257,225,425,27402,tacoma,98444,2945,2017
pierce,midland elementary,577,7,36,38,74,54,165,177,100,284,293,468,27402,tacoma,98445,2340,2017
pierce,morris ford middle,929,6,73,35,108,73,248,380,114,500,429,649,27402,tacoma,98445,3300,2017
pierce,perry g keithley middle,747,8,30,65,95,102,198,223,121,362,385,602,27402,tacoma,98444,3401,2017
pierce,washington high,1021,13,57,99,156,167,206,338,141,507,514,683,27402,tacoma,98444,3648,2017
spokane,freeman elementary,350,2,3,1,4,2,13,321,8,199,151,84,32358,rockford,99030,3794,2017
spokane,freeman high,335,3,7,0,7,7,25,285,8,167,168,58,32358,rockford,99030,3192,2017
spokane,freeman middle,194,1,3,1,4,3,8,176,2,106,88,47,32358,rockford,99030,4593,2017
whitman,garfield at palouse high,33,1,0,0,0,0,2,29,1,17,16,10,38302,palouse,99161,1962,2017
whitman,garfield elementary,57,0,0,0,0,0,0,57,0,30,27,26,38302,garfield,99130,2895,2017
whitman,garfield middle,26,0,0,0,0,0,3,22,1,14,12,11,38302,garfield,99130,2896,2017
klickitat,glenwood elementary,39,2,0,0,0,1,9,21,6,23,16,18,20401,glenwood,98619,3047,2017
klickitat,glenwood secondary,36,1,0,0,0,0,3,26,6,19,17,10,20401,glenwood,98619,3048,2017
klickitat,goldendale high,312,15,2,0,2,1,54,233,7,161,151,135,20404,goldendale,98620,2856,2017
klickitat,goldendale middle,293,12,3,0,3,3,42,223,10,167,126,162,20404,goldendale,98620,3393,2017
klickitat,goldendale primary,324,12,3,1,4,1,46,239,22,161,163,219,20404,goldendale,98620,2677,2017
klickitat,goldendale support service center,15,3,0,0,0,0,3,9,0,11,4,4,20404,goldendale,98620,5012,2017
grant,lake roosevelt alternative,7,5,0,0,0,0,0,1,1,4,3,9,13301,coulee dam,99116,5336,2017
grant,lake roosevelt elementary,394,130,1,2,3,1,43,118,99,208,186,285,13301,coulee dam,99116,2802,2017
grant,lake roosevelt jr/sr high,326,147,0,1,1,2,34,83,59,171,155,207,13301,coulee dam,99116,2801,2017
yakima,contract learning center,33,0,0,0,0,0,25,8,0,10,23,25,39200,grandview,98930,1776,2017
yakima,grandview high,932,0,1,0,1,0,859,69,3,462,470,637,39200,grandview,98930,2555,2017
yakima,grandview middle,805,0,0,0,0,0,747,55,3,407,398,587,39200,grandview,98930,3071,2017
yakima,mcclure elementary,691,2,0,0,0,1,651,36,1,365,326,591,39200,grandview,98930,2345,2017
yakima,smith elementary,626,0,1,0,1,0,585,36,4,334,292,524,39200,grandview,98930,3013,2017
yakima,step up to college open doors high,17,0,0,0,0,0,16,1,0,7,10,11,39200,grandview,98930,5399,2017
yakima,thompson elementary,588,0,0,0,0,1,523,64,0,288,300,472,39200,grandview,98930,2756,2017
yakima,granger high,444,13,0,0,0,0,406,17,8,238,206,340,39204,granger,98932,3314,2017
yakima,granger middle,480,13,0,0,0,0,449,16,2,252,228,403,39204,granger,98932,2531,2017
yakima,roosevelt elementary,599,17,0,0,0,1,557,16,8,300,299,537,39204,granger,98932,4535,2017
snohomish,crossroads high,149,3,0,0,0,3,15,117,11,83,66,106,31332,granite falls,98252,5171,2017
snohomish,granite falls high,563,8,6,3,9,5,42,476,23,304,259,159,31332,granite falls,98252,2580,2017
snohomish,granite falls middle,402,11,2,1,3,5,36,332,15,214,188,170,31332,granite falls,98252,4113,2017
snohomish,granite falls open doors,79,5,0,0,0,3,11,52,8,39,40,64,31332,granite falls,98252,5349,2017
snohomish,monte cristo elementary,430,9,2,0,2,11,39,351,18,225,205,197,31332,granite falls,98252,4479,2017
snohomish,mountain way elementary,435,12,1,0,1,7,45,358,12,231,204,231,31332,granite falls,98252,4330,2017
mason,grapeview elementary & middle,221,2,2,0,2,1,17,180,19,119,102,99,23054,grapeview,98546,2145,2017
spokane,great northern elementary,48,1,0,0,0,0,0,45,2,26,22,11,32312,spokane,99224,2097,2017
pierce,destiny middle,270,7,5,11,16,73,69,60,45,139,131,199,27904,tacoma,98404,5378,2017
clark,green mountain,154,0,2,0,2,0,4,144,4,75,79,60,06103,woodland,98674,2484,2017
thurston,griffin,647,8,12,1,13,10,61,505,50,331,316,116,34324,olympia,98502,2406,2017
lincoln,harrington elementary,68,2,0,0,0,0,2,59,5,42,26,43,22204,harrington,99134,2743,2017
lincoln,harrington high,44,0,0,0,0,0,3,40,1,25,19,23,22204,harrington,99134,3113,2017
yakima,highland high,345,2,0,0,0,3,249,82,9,172,173,252,39203,cowiche,98923,4559,2017
yakima,highland junior high,181,0,0,0,0,0,145,35,1,82,99,155,39203,cowiche,98923,2718,2017
yakima,marcus whitman-cowiche elementary,361,0,2,0,2,0,281,75,3,191,170,298,39203,cowiche,98923,3072,2017
yakima,tieton intermediate,280,0,0,0,0,1,202,69,8,150,130,237,39203,tieton,98947,3073,2017
king,beverly park elem at glendale,431,8,46,27,73,74,201,52,23,214,217,346,17401,seattle,98168,2765,2017
king,big picture,191,1,6,3,9,15,60,91,15,89,102,98,17401,burien,98148,5028,2017
king,bow lake elementary,728,1,106,50,156,182,263,81,45,363,365,557,17401,seatac,98188,2982,2017
king,cascade middle,541,5,105,26,131,59,275,51,20,284,257,449,17401,seattle,98146,3163,2017
king,cedarhurst elementary,635,3,112,24,136,56,292,108,40,328,307,474,17401,burien,98168,2926,2017
king,chinook middle,560,1,108,39,147,100,212,74,26,291,269,413,17401,seatac,98188,3098,2017
king,choice academy,148,0,11,1,12,13,39,71,13,60,88,44,17401,seattle,98148,1539,2017
king,des moines elementary,379,1,37,3,40,69,83,148,38,189,190,200,17401,des moines,98198,2418,2017
king,gregory heights elementary,699,5,61,24,85,45,241,284,39,384,315,365,17401,burien,98166,2844,2017
king,hazel valley elementary,696,12,99,22,121,66,355,96,46,363,333,562,17401,burien,98146,2699,2017
king,highline high,1292,16,195,57,252,88,568,302,66,674,618,720,17401,burien,98148,2325,2017
king,highline home school center,28,0,2,0,2,4,3,19,0,16,12,1,17401,burien,98148,5371,2017
king,highline open doors 1418,357,3,30,6,36,85,128,86,19,174,183,89,17401,burien,98146,5370,2017
king,hilltop elementary,613,1,108,30,138,57,326,54,37,301,312,506,17401,seattle,98168,3165,2017
king,madrona elementary,694,2,37,53,90,173,359,44,26,379,315,474,17401,seatac,98198,3278,2017
king,marvista elementary,634,6,42,14,56,88,132,320,32,321,313,231,17401,normandy park,98166,3097,2017
king,mcmicken heights elementary,555,0,97,43,140,146,144,96,29,299,256,421,17401,seatac,98188,2734,2017
king,midway elementary,715,3,54,50,104,109,380,70,49,351,364,521,17401,des moines,98198,2984,2017
king,mount rainier high,1672,12,242,81,323,207,443,577,110,849,823,771,17401,des moines,98198,3279,2017
king,mount view elementary,674,2,100,16,116,64,408,63,21,342,332,466,17401,seattle,98146,2144,2017
king,new start,86,1,1,3,4,4,42,25,10,50,36,66,17401,seattle,98146,1972,2017
king,north hill elementary,598,5,47,14,61,62,123,278,69,301,297,277,17401,des moines,98148,2983,2017
king,pacific middle,603,9,64,30,94,82,197,168,53,319,284,357,17401,des moines,98198,3333,2017
king,parkside elementary,636,7,72,35,107,109,173,189,51,329,307,419,17401,des moines,98198,3335,2017
king,puget sound high,101,3,7,1,8,8,46,34,2,54,47,78,17401,burien,98148,5172,2017
king,raisbeck aviation high,410,1,86,1,87,29,37,239,17,255,155,56,17401,tukwila,98108,3553,2017
king,seahurst elementary,558,8,47,14,61,56,299,99,35,286,272,413,17401,burien,98166,3382,2017
king,shorewood elementary,599,5,111,6,117,54,153,217,53,314,285,320,17401,burien,98146,2842,2017
king,southern heights elementary,303,5,61,18,79,20,140,28,31,178,125,250,17401,seattle,98168,3032,2017
king,sylvester middle,703,11,127,26,153,61,276,160,42,354,349,462,17401,burien,98166,2927,2017
king,valley view early childhood center,254,1,18,2,20,35,93,90,15,166,88,91,17401,seatac,98188,5119,2017
king,white center heights elementary,626,11,159,15,174,163,184,73,21,326,300,465,17401,seattle,98146,2639,2017
clark,hockinson heights elementary,791,4,18,0,18,8,45,676,40,394,397,164,06098,brush prairie,98606,5311,2017
clark,hockinson high,663,5,15,0,15,4,28,601,10,368,295,93,06098,brush prairie,98606,4568,2017
clark,hockinson middle,424,1,11,1,12,4,16,384,7,210,214,74,06098,brush prairie,98606,3319,2017
grays harbor,central elementary,240,13,1,0,1,1,51,156,18,129,111,131,14028,hoquiam,98550,2972,2017
grays harbor,emerson elementary,240,13,2,0,2,11,48,155,11,117,123,172,14028,hoquiam,98550,2268,2017
grays harbor,hoquiam high,494,22,7,1,8,7,86,343,28,264,230,236,14028,hoquiam,98550,3622,2017
grays harbor,hoquiam homelink,58,0,0,0,0,0,7,48,3,25,33,45,14028,hoquiam,98550,5191,2017
grays harbor,hoquiam middle,371,24,3,0,3,5,47,269,23,193,178,227,14028,hoquiam,98550,2391,2017
grays harbor,lincoln elementary,234,18,2,0,2,1,45,160,8,123,111,189,14028,hoquiam,98550,3621,2017
ferry,inchelium elementary,109,83,0,0,0,0,3,5,18,47,62,90,10070,inchelium,99138,4215,2017
ferry,inchelium high,64,53,2,0,2,0,0,2,7,32,32,46,10070,inchelium,99138,2603,2017
ferry,inchelium middle,50,42,0,0,0,0,1,0,7,24,26,36,10070,inchelium,99138,4214,2017
snohomish,index elementary,36,0,0,0,0,0,0,33,3,16,20,9,31063,index,98256,2948,2017
king,apollo elementary,669,0,205,0,205,12,83,303,66,339,330,108,17411,renton,98059,3746,2017
king,beaver lake middle,836,0,268,3,271,2,56,454,53,438,398,36,17411,issaquah,98029,4460,2017
king,briarwood elementary,672,1,149,4,153,10,52,396,60,331,341,72,17411,renton,98059,3440,2017
king,cascade ridge elementary,538,0,203,0,203,5,29,249,52,296,242,5,17411,sammamish,98075,4565,2017
king,challenger elementary,569,0,182,0,182,4,52,273,58,279,290,37,17411,issaquah,98029,4300,2017
king,clark elementary,750,2,180,0,180,16,85,380,87,366,384,133,17411,issaquah,98027,2738,2017
king,cougar ridge elementary,573,2,219,0,219,4,30,274,44,306,267,13,17411,bellevue,98006,4375,2017
king,creekside elementary,710,0,189,1,190,5,44,421,50,362,348,12,17411,sammamish,98075,5201,2017
king,discovery elementary,581,0,292,0,292,6,41,205,37,295,286,4,17411,issaquah,98075,4376,2017
king,endeavour elementary,669,1,232,0,232,2,46,339,49,331,338,48,17411,issaquah,98029,4493,2017
king,gibson ek high,114,1,16,0,16,1,9,84,3,48,66,11,17411,issaquah,98027,5437,2017
king,grand ridge elementary,765,0,255,0,255,21,41,375,73,409,356,38,17411,issaquah,98029,5056,2017
king,issaquah high,2332,8,518,6,524,47,203,1432,118,1184,1148,181,17411,issaquah,98027,3385,2017
king,issaquah middle,930,6,184,2,186,24,101,552,61,452,478,121,17411,issaquah,98027,3038,2017
king,issaquah special services,93,0,15,0,15,4,10,57,7,56,37,6,17411,issaquah,98027,1624,2017
king,issaquah valley elementary,637,0,69,0,69,11,107,391,59,323,314,124,17411,issaquah,98027,3673,2017
king,liberty sr high,1298,3,245,7,252,31,129,815,68,657,641,131,17411,renton,98059,3962,2017
king,maple hills elementary,422,2,5,1,6,10,30,325,49,206,216,50,17411,renton,98059,3637,2017
king,maywood middle,1136,1,258,4,262,19,122,655,77,546,590,157,17411,renton,98059,3636,2017
king,newcastle elementary,619,0,195,0,195,11,47,278,88,296,323,30,17411,newcastle,98059,4592,2017
king,pacific cascade middle,993,0,316,4,320,15,53,546,59,508,485,46,17411,issaquah,98029,5200,2017
king,pine lake middle,936,1,352,2,354,10,52,474,45,459,477,37,17411,sammamish,98075,3879,2017
king,skyline high,2203,5,668,9,677,38,146,1251,86,1173,1030,76,17411,sammamish,98075,4495,2017
king,sunny hills elementary,634,1,217,4,221,6,38,313,55,312,322,29,17411,sammamish,98075,3386,2017
king,sunset elementary,633,1,127,4,131,12,46,387,56,327,306,49,17411,bellevue,98008,3228,2017
franklin,kahlotus elem & high,51,0,0,0,0,0,8,39,4,20,31,32,11056,kahlotus,99335,3214,2017
cowlitz,kalama elem,457,5,6,2,8,1,27,414,2,236,221,159,08402,kalama,98625,2915,2017
ferry,keller elementary,28,27,0,0,0,0,0,0,1,14,14,19,10003,keller,99140,2602,2017
cowlitz,barnes elementary,359,4,1,3,4,2,75,262,12,189,170,276,08458,kelso,98626,3323,2017
cowlitz,beacon hill elementary,503,0,7,2,9,1,71,385,37,236,267,265,08458,longview,98632,3578,2017
cowlitz,butler acres elementary,392,5,3,4,7,0,51,311,18,203,189,205,08458,kelso,98626,3082,2017
cowlitz,carrolls elementary,146,3,7,0,7,0,10,114,12,70,76,47,08458,carrolls,98609,2913,2017
cowlitz,catlin elementary,310,2,5,5,10,0,62,210,26,177,133,251,08458,kelso,98626,2691,2017
cowlitz,coweeman middle,584,12,7,6,13,2,103,425,29,287,297,306,08458,kelso,98626,3322,2017
cowlitz,huntington middle,562,3,4,8,12,0,106,407,34,282,280,328,08458,kelso,98626,2916,2017
cowlitz,kelso high,1591,33,15,11,26,4,253,1159,116,803,788,730,08458,kelso,98626,2266,2017
cowlitz,kelso virtual academy,38,0,0,0,0,0,4,29,5,12,26,31,08458,kelso,98626,5194,2017
cowlitz,loowit high,28,1,0,0,0,0,2,23,2,13,15,19,08458,kelso,98626,1934,2017
cowlitz,rose valley elementary,129,1,0,1,1,1,11,114,1,61,68,37,08458,kelso,98626,2596,2017
cowlitz,special education,16,0,0,0,0,1,2,13,0,10,6,20,08458,kelso,98626,5076,2017
cowlitz,wallace elementary,372,2,3,16,19,5,117,210,19,202,170,335,08458,kelso,98626,2624,2017
benton,amistad elementary,495,0,7,1,8,15,327,137,8,257,238,496,03017,kennewick,99336,4418,2017
benton,canyon view elementary,551,1,0,0,0,16,221,289,24,268,283,366,03017,kennewick,99337,4072,2017
benton,cascade elementary,595,0,0,0,0,4,130,430,31,327,268,234,03017,kennewick,99337,4202,2017
benton,chinook middle,793,2,22,3,25,15,219,494,38,415,378,341,03017,kennewick,99338,5439,2017
benton,cottonwood elementary,710,0,7,2,9,6,54,615,26,377,333,84,03017,kennewick,99338,5220,2017
benton,desert hills middle,820,5,18,0,18,12,114,638,33,401,419,170,03017,kennewick,99338,4028,2017
benton,eastgate elementary,578,1,2,0,2,9,448,112,6,313,265,522,03017,kennewick,99336,2824,2017
benton,edison elementary school - kennewick,594,6,2,0,2,18,329,222,17,287,307,422,03017,kennewick,99336,3315,2017
benton,hawthorne elementary school - kennewick,552,1,6,4,10,10,300,204,27,281,271,397,03017,kennewick,99336,3077,2017
benton,highlands middle,746,4,8,2,10,21,409,278,24,375,371,535,03017,kennewick,99336,3267,2017
benton,horse heaven hills middle,806,0,6,0,6,5,249,503,43,416,390,370,03017,kennewick,99337,4429,2017
benton,kamiakin high,1740,9,37,3,40,24,486,1146,35,943,797,534,03017,kennewick,99336,3731,2017
benton,keewaydin discovery center,200,0,0,0,0,3,79,116,2,134,66,92,03017,kennewick,99336,2000,2017
benton,kennewick high,1637,13,61,2,63,55,799,664,43,882,755,1026,03017,kennewick,99336,2826,2017
benton,legacy high,229,3,2,2,4,3,81,134,4,129,100,116,03017,kennewick,99336,1884,2017
benton,lincoln elementary,591,0,6,0,6,12,181,360,32,288,303,346,03017,kennewick,99338,4181,2017
benton,mid-columbia parent partnership,337,2,3,0,3,3,32,295,2,176,161,68,03017,kennewick,99336,1941,2017
benton,park middle,739,0,37,2,39,30,484,157,29,411,328,651,03017,kennewick,99336,3472,2017
benton,phoenix high,57,0,0,0,0,0,18,39,0,29,28,33,03017,kennewick,99338,5106,2017
benton,ridge view elementary,617,3,21,0,21,7,85,452,49,314,303,120,03017,kennewick,99338,4446,2017
benton,sage crest elementary,487,0,10,0,10,6,82,359,30,269,218,194,03017,kennewick,99338,5438,2017
benton,southgate elementary,497,0,7,1,8,16,153,305,15,261,236,273,03017,kennewick,99337,4073,2017
benton,southridge high,1710,8,25,7,32,33,561,1018,58,857,853,703,03017,kennewick,99338,4484,2017
benton,sunset view elementary,566,3,16,0,16,22,96,394,35,274,292,223,03017,kennewick,99336,4136,2017
benton,vista elementary,571,3,9,0,9,15,176,328,40,292,279,394,03017,kennewick,99336,3369,2017
benton,washington elementary,482,0,1,1,2,16,237,205,22,255,227,382,03017,kennewick,99337,3144,2017
benton,westgate elementary,500,1,47,3,50,42,173,222,12,264,236,427,03017,kennewick,99336,2825,2017
king,birth to age 2,150,0,22,2,24,15,33,53,25,85,65,0,17415,kent,98030,5150,2017
king,carriage crest elementary,472,2,91,2,93,32,69,222,54,237,235,99,17415,renton,98058,4353,2017
king,cedar heights middle,663,6,52,13,65,58,114,362,58,359,304,278,17415,covington,98042,4440,2017
king,cedar valley elementary,284,6,8,0,8,24,90,135,21,154,130,163,17415,covington,98042,3676,2017
king,covington elementary,575,4,75,0,75,45,137,264,50,308,267,276,17415,covington,98042,3388,2017
king,crestwood elementary,485,2,28,1,29,17,83,309,45,236,249,109,17415,covington,98042,4126,2017
king,east hill elementary,553,0,117,22,139,124,151,79,60,268,285,334,17415,kent,98031,2851,2017
king,emerald park elementary,487,1,150,18,168,68,76,116,58,249,238,266,17415,kent,98031,4545,2017
king,fairwood elementary,373,1,50,1,51,33,66,158,64,173,200,157,17415,renton,98058,3678,2017
king,george t. daniel elementary,535,2,93,12,105,106,152,119,51,294,241,380,17415,kent,98030,4413,2017
king,glenridge elementary,461,0,159,12,171,73,66,107,44,230,231,222,17415,kent,98031,4489,2017
king,grass lake elementary,407,1,15,1,16,12,66,282,30,198,209,118,17415,kent,98042,3708,2017
king,horizon elementary,468,2,70,11,81,50,75,217,43,235,233,224,17415,kent,98042,4345,2017
king,igrad,376,3,37,14,51,41,107,145,29,199,177,189,17415,kent,98030,5275,2017
king,jenkins creek elementary,426,5,33,6,39,27,85,223,47,221,205,183,17415,covington,98042,4301,2017
king,kent elementary,735,1,56,76,132,59,387,100,56,374,361,539,17415,kent,98032,4520,2017
king,kent mountain view academy,304,1,61,2,63,23,37,143,37,145,159,66,17415,des moines,98198,3014,2017
king,kent phoenix academy,278,3,16,6,22,42,79,102,30,106,172,166,17415,kent,98030,5098,2017
king,kent-meridian high,2082,5,437,86,523,396,634,405,119,1097,985,1269,17415,kent,98030,2797,2017
king,kentlake high,1504,9,125,28,153,115,245,853,129,777,727,529,17415,kent,98042,4492,2017
king,kentridge high,2262,9,571,39,610,248,286,877,232,1160,1102,641,17415,kent,98031,3640,2017
king,kentwood high,2072,16,470,49,519,192,375,813,157,1119,953,748,17415,covington,98042,4128,2017
king,lake youngs elementary,495,1,107,4,111,23,79,231,50,263,232,121,17415,kent,98042,3550,2017
king,martin sortun elementary,689,1,221,12,233,92,115,195,53,345,344,345,17415,kent,98030,4294,2017
king,mattson middle,633,5,87,9,96,36,114,320,62,347,286,246,17415,covington,98042,4127,2017
king,meadow ridge elementary,530,3,145,9,154,75,111,150,37,298,232,411,17415,kent,98030,4465,2017
king,meeker middle,608,0,172,16,188,89,139,146,46,325,283,389,17415,renton,98058,3764,2017
king,meridian elementary,646,1,123,6,129,58,119,271,68,349,297,308,17415,kent,98042,2565,2017
king,meridian middle,597,1,156,22,178,83,131,149,55,311,286,351,17415,kent,98031,3233,2017
king,mill creek middle,825,2,139,46,185,139,288,134,77,420,405,608,17415,kent,98032,5016,2017
king,millennium elementary,602,1,116,18,134,91,157,175,44,309,293,437,17415,kent,98030,4581,2017
king,neely o brien elementary,769,2,137,45,182,120,270,103,92,397,372,529,17415,kent,98032,4356,2017
king,northwood middle,649,2,144,7,151,58,69,288,81,317,332,177,17415,renton,98058,4485,2017
king,panther lake elementary,676,0,130,19,149,105,206,135,81,348,328,461,17415,kent,98031,5178,2017
king,park orchard elementary,533,4,99,11,110,74,204,85,56,290,243,338,17415,kent,98031,3491,2017
king,pine tree elementary,424,1,66,21,87,77,103,109,47,220,204,292,17415,kent,98030,3593,2017
king,regional justice center,12,0,1,3,4,6,0,1,1,12,0,16,17415,kent,98030,1807,2017
king,ridgewood elementary,495,1,123,4,127,31,58,208,70,270,225,80,17415,renton,98058,4293,2017
king,sawyer woods elementary,461,1,24,2,26,7,39,327,61,235,226,85,17415,black diamond,98010,4466,2017
king,scenic hill elementary,608,1,47,22,69,112,260,106,60,316,292,359,17415,kent,98030,3389,2017
king,soos creek elementary,400,1,76,21,97,34,71,143,54,218,182,205,17415,kent,98031,3707,2017
king,springbrook elementary,545,4,99,35,134,73,213,88,33,293,252,398,17415,kent,98031,3677,2017
king,sunrise elementary,629,0,209,8,217,59,80,195,78,301,328,213,17415,kent,98042,4420,2017
king,the outreach program,63,0,13,0,13,11,8,22,9,37,26,48,17415,kent,98030,5440,2017
stevens,columbia virtual academy - kettle falls,232,4,1,1,2,5,29,175,17,97,135,47,33212,kettle falls,99141,5180,2017
stevens,kettle falls elementary,297,5,1,0,1,2,16,259,14,155,142,179,33212,kettle falls,99141,2385,2017
stevens,kettle falls high,220,6,2,2,4,0,14,193,3,119,101,101,33212,kettle falls,99141,4206,2017
stevens,kettle falls middle,223,3,2,0,2,1,14,195,8,108,115,139,33212,kettle falls,99141,3198,2017
benton,kiona-benton city high,456,1,1,0,1,4,172,270,8,239,217,246,03052,benton city,99320,2904,2017
benton,kiona-benton city middle,320,1,2,0,2,0,134,172,11,174,146,222,03052,benton city,99320,3961,2017
benton,kiona-benton city primary,233,0,1,0,1,0,91,135,6,126,107,163,03052,benton city,99320,2759,2017
benton,kiona-benton intermediate,348,3,1,0,1,0,151,186,7,177,171,263,03052,benton city,99320,4217,2017
kittitas,kittitas b-5 special ed program,11,0,0,0,0,0,1,10,0,9,2,4,19403,kittitas,98934,5086,2017
kittitas,kittitas elementary,239,0,1,0,1,0,49,186,3,106,133,107,19403,kittitas,98934,2569,2017
kittitas,kittitas high,367,0,5,0,5,2,91,264,5,199,168,133,19403,kittitas,98934,2766,2017
klickitat,klickitat elem & high,73,0,0,0,0,0,2,64,7,42,31,51,20402,klickitat,98628,3494,2017
clark,la center elementary,720,0,3,2,5,3,44,647,21,371,349,205,06101,la center,98629,2558,2017
clark,la center high,558,2,8,0,8,3,24,516,5,286,272,95,06101,la center,98629,4431,2017
clark,la center home school academy,12,0,0,0,0,0,1,11,0,7,5,0,06101,la center,98629,5326,2017
clark,la center middle,387,3,2,0,2,2,23,346,11,208,179,86,06101,la center,98629,3371,2017
skagit,la conner elementary,241,102,1,0,1,0,21,99,18,124,117,161,29311,la conner,98257,2522,2017
skagit,la conner high,191,63,5,1,6,2,24,93,3,97,94,86,29311,la conner,98257,2276,2017
skagit,la conner middle,145,52,0,0,0,0,10,79,4,70,75,64,29311,la conner,98257,3900,2017
whitman,lacrosse elementary,25,0,0,0,0,0,0,23,2,13,12,6,38126,lacrosse,99143,2087,2017
whitman,lacrosse high,35,1,1,0,1,0,2,29,2,14,21,13,38126,lacrosse,99143,2088,2017
chelan,chelan high,451,0,1,0,1,1,235,208,6,239,212,250,04129,chelan,98816,4260,2017
chelan,chelan middle,320,0,0,0,0,2,164,149,5,171,149,194,04129,chelan,98816,2317,2017
chelan,chelan school of innovation,34,2,0,0,0,1,16,14,1,23,11,24,04129,chelan,98816,1940,2017
chelan,holden village community,7,0,0,0,0,2,0,3,2,5,2,0,04129,chelan,98816,3861,2017
chelan,lake chelan preschool,4,0,0,0,0,0,4,0,0,4,0,4,04129,chelan,98816,1675,2017
chelan,morgen owings elementary,624,0,4,0,4,1,369,247,3,340,284,418,04129,chelan,98816,2689,2017
snohomish,cavelero mid high,1286,4,45,9,54,21,174,915,118,682,604,324,31004,lake stevens,98258,5099,2017
snohomish,early learning center,134,0,4,0,4,4,20,89,17,93,41,32,31004,lake stevens,98258,5441,2017
snohomish,glenwood elementary,563,1,3,2,5,8,42,452,55,290,273,104,31004,lake stevens,98258,4391,2017
snohomish,highland elementary,668,4,14,1,15,11,65,525,48,332,336,133,31004,lake stevens,98258,4534,2017
snohomish,hillcrest elementary,809,3,32,2,34,18,169,519,66,402,407,240,31004,lake stevens,98258,2885,2017
snohomish,homelink,106,0,0,0,0,1,9,87,9,45,61,23,31004,lake stevens,98258,1753,2017
snohomish,lake stevens middle,621,0,24,3,27,9,110,421,54,326,295,190,31004,lake stevens,98258,3408,2017
snohomish,lake stevens sr high,1937,14,81,9,90,36,242,1417,138,1029,908,409,31004,lake stevens,98258,2426,2017
snohomish,mt. pilchuck elementary,668,3,12,5,17,10,76,509,53,354,314,228,31004,lake stevens,98258,2884,2017
snohomish,north lake middle,770,5,38,2,40,11,89,551,74,394,376,201,31004,lake stevens,98258,4139,2017
snohomish,skyline elementary,526,0,16,0,16,9,100,350,51,270,256,201,31004,lake stevens,98258,4392,2017
snohomish,sunnycrest elementary,757,1,33,1,34,20,96,530,76,405,352,163,31004,lake stevens,98258,3753,2017
king,lake washington technical academy,322,1,17,1,18,11,44,221,22,191,131,0,17937,kirkland,98034,5953,2017
king,alcott elementary,807,1,481,1,482,7,33,250,34,413,394,35,17414,redmond,98053,4256,2017
king,audubon elementary,594,0,294,0,294,4,32,232,32,285,309,16,17414,redmond,98052,3548,2017
king,bell elementary,394,0,47,0,47,14,63,241,29,201,193,106,17414,kirkland,98033,3592,2017
king,blackwell elementary,535,0,202,0,202,2,36,265,30,275,260,15,17414,sammamish,98074,4532,2017
king,carson elementary,453,0,131,0,131,7,24,258,33,234,219,10,17414,sammamish,98074,5139,2017
king,community,71,0,11,0,11,1,3,49,7,35,36,3,17414,kirkland,98033,3856,2017
king,contractual schools,24,0,1,0,1,2,3,18,0,22,2,5,17414,redmond,98073,1649,2017
king,dickinson elementary,571,1,177,0,177,18,79,256,40,313,258,90,17414,redmond,98053,4018,2017
king,discovery,73,0,21,0,21,0,3,43,6,34,39,0,17414,kirkland,98034,1658,2017
king,eastlake high,1783,5,263,4,267,18,130,1244,118,900,883,70,17414,sammamish,98074,4439,2017
king,einstein elementary,434,0,112,0,112,25,104,158,35,224,210,137,17414,redmond,98052,4424,2017
king,emerson high,51,2,2,1,3,0,9,35,2,19,32,19,17414,kirkland,98033,3855,2017
king,emerson k-12,103,0,6,0,6,0,7,81,9,48,55,7,17414,kirkland,98033,1688,2017
king,environmental & adventure,142,0,22,0,22,2,2,105,11,85,57,3,17414,kirkland,98034,1800,2017
king,evergreen middle,1117,4,455,3,458,16,81,506,52,599,518,63,17414,redmond,98053,4148,2017
king,explorer community,72,0,32,0,32,0,3,34,3,31,41,0,17414,redmond,98052,1687,2017
king,finn hill middle,629,3,55,0,55,16,79,411,64,323,306,116,17414,kirkland,98034,3590,2017
king,franklin elementary,487,0,144,0,144,4,45,254,40,250,237,27,17414,kirkland,98033,3591,2017
king,frost elementary,445,4,41,1,42,12,125,228,34,232,213,153,17414,kirkland,98034,3675,2017
king,futures,45,0,4,0,4,1,12,25,3,27,18,18,17414,kirkland,98034,1804,2017
king,inglewood middle,1227,2,280,1,281,12,73,776,82,617,610,34,17414,sammamish,98074,4386,2017
king,international community,438,0,200,1,201,1,20,193,23,201,237,9,17414,kirkland,98033,1706,2017
king,juanita elementary,403,0,52,0,52,14,75,203,59,217,186,100,17414,kirkland,98034,2796,2017
king,juanita high,1503,0,238,6,244,45,234,845,134,796,707,340,17414,kirkland,98034,3771,2017
king,kamiakin middle,574,1,118,0,118,13,117,277,48,309,265,180,17414,kirkland,98034,3922,2017
king,keller elementary,393,2,46,2,48,14,58,217,54,195,198,82,17414,kirkland,98034,3704,2017
king,kirk elementary,550,2,56,0,56,9,29,402,52,267,283,25,17414,kirkland,98033,3941,2017
king,kirkland middle,587,3,63,3,66,10,42,425,41,309,278,65,17414,kirkland,98033,2308,2017
king,lake washington high,1642,5,174,1,175,32,188,1126,116,853,789,218,17414,kirkland,98033,2739,2017
king,lakeview elementary,556,4,70,1,71,11,66,352,52,291,265,80,17414,kirkland,98033,3041,2017
king,mann elementary,482,1,130,0,130,8,34,271,38,252,230,22,17414,redmond,98052,3529,2017
king,mcauliffe elementary,534,0,166,1,167,6,38,290,33,275,259,17,17414,sammamish,98074,4354,2017
king,mead elementary,627,1,177,0,177,5,38,356,50,321,306,19,17414,sammamish,98074,4096,2017
king,muir elementary,441,2,96,0,96,6,84,214,39,210,231,159,17414,kirkland,98034,3748,2017
king,northstar middle,85,0,34,0,34,1,3,43,4,43,42,1,17414,kirkland,98033,4167,2017
king,ready start preschool,1,0,0,0,0,0,0,1,0,1,0,0,17414,redmond,98052,3549,2017
king,redmond elementary,725,1,346,0,346,17,83,217,61,379,346,110,17414,redmond,98052,2289,2017
king,redmond high,1916,3,388,4,392,38,211,1115,157,963,953,214,17414,redmond,98052,3528,2017
king,redmond middle,994,1,252,2,254,18,143,495,83,525,469,160,17414,redmond,98052,3232,2017
king,renaissance,89,0,15,0,15,0,6,60,8,20,69,2,17414,sammamish,98074,5057,2017
king,rockwell elementary,625,0,275,0,275,5,33,264,48,313,312,20,17414,redmond,98052,4147,2017
king,rosa parks elementary,649,3,322,0,322,12,40,235,37,330,319,11,17414,redmond,98053,5053,2017
king,rose hill elementary,441,0,86,1,87,7,102,203,42,222,219,122,17414,kirkland,98033,2992,2017
king,rose hill middle,862,1,157,1,158,18,136,481,68,460,402,157,17414,redmond,98052,3706,2017
king,rush elementary,584,0,259,1,260,9,40,240,35,318,266,38,17414,redmond,98052,3703,2017
king,sandburg elementary,457,0,31,0,31,0,35,355,36,245,212,24,17414,kirkland,98034,3747,2017
king,smith elementary,636,1,335,0,335,2,31,225,42,337,299,10,17414,sammamish,98074,4302,2017
king,stella schola,90,0,37,0,37,0,3,39,11,40,50,3,17414,redmond,98052,1975,2017
king,tesla stem high,577,1,254,0,254,3,26,253,39,357,220,10,17414,redmond,98053,5265,2017
king,thoreau elementary,425,2,64,0,64,5,42,265,47,213,212,64,17414,kirkland,98034,3490,2017
king,twain elementary,572,3,98,0,98,10,76,326,59,284,288,96,17414,kirkland,98033,3441,2017
king,wilder elementary,609,1,228,0,228,7,44,297,32,334,275,15,17414,woodinville,98077,4336,2017
snohomish,cougar creek elementary,363,5,9,4,13,2,59,256,28,189,174,126,31306,n. lakewood,98259,4576,2017
snohomish,english crossing elementary,322,2,7,2,9,5,64,208,34,174,148,143,31306,n. lakewood,98259,4477,2017
snohomish,lakewood elementary,412,2,3,12,15,10,70,274,41,222,190,207,31306,n. lakewood,98259,3255,2017
snohomish,lakewood high,740,5,14,5,19,12,105,567,32,372,368,156,31306,n lakewood,98259,4204,2017
snohomish,lakewood middle,569,8,9,9,18,10,85,411,37,299,270,184,31306,n. lakewood,98259,3893,2017
snohomish,lakewood nwesd 189 open door program,2,0,0,0,0,1,0,1,0,2,0,2,31306,marysville,98270,5404,2017
whitman,lamont middle,29,0,0,0,0,0,2,26,1,13,16,19,38264,lamont,99017,3137,2017
spokane,liberty high,157,2,0,0,0,3,9,141,2,87,70,56,32362,spangle,99031,3416,2017
spokane,liberty jr high & elementary,310,0,4,0,4,0,28,267,11,168,142,122,32362,spangle,99031,4226,2017
adams,lind elementary,99,0,0,0,0,0,32,67,0,57,42,58,01158,lind,99341,3421,2017
adams,lind-ritzville high,56,0,4,0,4,0,21,28,3,25,31,32,01158,ritzville,99169,2903,2017
adams,lind-ritzville middle,49,0,1,0,1,0,16,32,0,20,29,22,01158,lind,99341,5293,2017
cowlitz,broadway learning center,81,0,0,0,0,1,13,60,7,56,25,109,08122,longview,98632,2665,2017
cowlitz,cascade middle,523,10,9,2,11,5,126,324,47,271,252,323,08122,longview,98632,3475,2017
cowlitz,columbia heights elementary,379,5,2,0,2,1,29,307,35,195,184,181,08122,longview,98632,3211,2017
cowlitz,columbia valley garden elem,445,3,8,0,8,3,49,360,22,217,228,216,08122,longview,98632,2369,2017
cowlitz,discovery high,161,2,1,0,1,2,37,109,10,72,89,95,08122,longview,98632,5312,2017
cowlitz,discovery high school-achieve,14,0,0,0,0,0,6,8,0,9,5,55,08122,longview,98632,5400,2017
cowlitz,kessler elementary,340,3,6,1,7,2,86,198,44,177,163,300,08122,longview,98632,2319,2017
cowlitz,longview school district special services,60,2,2,0,2,0,13,35,8,31,29,58,08122,longview,98632,3913,2017
cowlitz,mark morris high,1006,11,22,4,26,8,162,721,78,497,509,360,08122,longview,98632,3151,2017
cowlitz,mint valley elementary,419,2,4,0,4,10,81,294,28,210,209,318,08122,longview,98632,3658,2017
cowlitz,monticello middle,503,10,10,6,16,7,134,298,38,252,251,364,08122,longview,98632,2831,2017
cowlitz,mt. solo middle,410,6,5,0,5,0,55,315,29,197,213,177,08122,longview,98632,4574,2017
cowlitz,northlake elementary,330,6,3,1,4,5,132,161,22,180,150,278,08122,longview,98632,2914,2017
cowlitz,olympic elementary,396,9,7,3,10,11,107,233,26,190,206,329,08122,longview,98632,2726,2017
cowlitz,r a long high,941,12,26,11,37,11,173,645,63,464,477,468,08122,longview,98632,2416,2017
cowlitz,robert gray elementary,468,6,5,0,5,2,50,373,32,222,246,171,08122,longview,98632,3019,2017
cowlitz,saint helens elementary,350,2,6,5,11,5,131,179,22,196,154,337,08122,longview,98632,2370,2017
stevens,loon lake elementary,105,0,0,0,0,1,16,84,4,46,59,87,33183,loon lake,99148,2480,2017
stevens,loon lake homelink program,88,0,4,0,4,1,6,69,8,45,43,16,33183,loon lake,99148,1922,2017
san juan,cva-lopez island,21,0,0,0,0,4,0,16,1,10,11,3,28144,lopez island,98261,5299,2017
san juan,decatur elementary,4,0,0,0,0,0,0,3,1,3,1,0,28144,anacortes,98221,4178,2017
san juan,lopez elementary,120,0,3,0,3,1,39,75,2,61,59,60,28144,lopez island,98261,4107,2017
san juan,lopez middle high,98,1,13,0,13,0,15,68,1,52,46,33,28144,lopez island,98261,2632,2017
whatcom,lummi nation,294,258,0,1,1,0,13,5,17,167,127,265,37903,bellingham,98226,5373,2017
klickitat,dallesport elementary,112,13,0,0,0,0,13,78,8,60,52,76,20406,lyle,98635,3049,2017
klickitat,lyle high,79,8,0,0,0,1,10,54,6,43,36,42,20406,lyle,98635,3111,2017
klickitat,lyle middle,55,6,1,0,1,0,10,36,2,27,28,35,20406,lyle,98635,3643,2017
whatcom,fisher elementary,443,3,7,0,7,2,143,275,13,244,199,231,37504,lynden,98264,3417,2017
whatcom,isom elementary,529,5,14,0,14,8,120,363,19,267,262,186,37504,lynden,98264,4324,2017
whatcom,lynden academy,254,0,2,0,2,0,5,245,2,110,144,8,37504,lynden,98264,1983,2017
whatcom,lynden high,871,4,25,1,26,8,213,579,41,436,435,262,37504,lynden,98264,4201,2017
whatcom,lynden middle,616,1,16,1,17,5,163,394,36,325,291,226,37504,lynden,98264,2219,2017
whatcom,lynden special services,63,2,1,0,1,3,8,47,2,49,14,0,37504,lynden,98264,1914,2017
whatcom,vossbeck elementary,465,3,13,0,13,9,126,297,17,239,226,171,37504,lynden,98264,4517,2017
yakima,artz fox elementary,537,3,0,0,0,0,526,8,0,264,273,479,39120,mabton,98935,3070,2017
yakima,mabton jr. sr. high,375,0,0,0,0,0,364,11,0,182,193,295,39120,mabton,98935,5289,2017
douglas,mansfield elem and high,102,6,3,0,3,1,25,63,4,52,50,65,09207,mansfield,98830,2233,2017
chelan,manson elementary,318,5,0,0,0,1,215,97,0,167,151,233,04019,manson,98831,2196,2017
chelan,manson high,199,2,1,0,1,0,136,59,1,109,90,145,04019,manson,98831,2623,2017
chelan,manson middle,156,2,2,0,2,2,97,52,1,79,77,107,04019,manson,98831,5286,2017
mason,mary m. knight,157,4,0,0,0,1,6,138,8,87,70,106,23311,elma,98541,5444,2017
mason,washington connections academy,371,3,6,0,6,30,53,240,39,179,192,94,23311,tumwater,98501,5445,2017
stevens,mary walker high,176,15,1,0,1,1,11,128,20,97,79,122,33207,springdale,99173,3311,2017
stevens,mary walker promise,49,3,0,0,0,0,12,28,6,29,20,35,33207,springdale,99173,5446,2017
stevens,springdale academy,8,0,0,0,0,0,0,8,0,5,3,7,33207,springdale,99173,1857,2017
stevens,springdale elementary,204,28,0,0,0,0,18,136,22,106,98,173,33207,springdale,99173,2297,2017
stevens,springdale middle,108,23,0,0,0,0,9,71,5,67,41,83,33207,springdale,99173,3894,2017
snohomish,10th street,179,7,6,0,6,2,20,127,17,76,103,29,31025,marysville,98271,1656,2017
snohomish,allen creek elementary,480,11,32,3,35,12,77,298,47,269,211,206,31025,marysville,98270,4454,2017
snohomish,cascade elementary,449,10,31,5,36,8,133,205,57,218,231,279,31025,marysville,98270,3059,2017
snohomish,cedarcrest,821,22,47,9,56,7,195,457,84,426,395,389,31025,marysville,98270,4357,2017
snohomish,grove elementary,507,12,28,2,30,8,96,288,73,255,252,190,31025,marysville,98270,5123,2017
snohomish,heritage,90,60,0,0,0,1,13,6,10,35,55,59,31025,marysville,98271,1657,2017
snohomish,kellogg marsh elementary,487,8,11,6,17,5,95,300,62,262,225,254,31025,marysville,98270,4323,2017
snohomish,liberty elementary,480,31,21,6,27,6,186,198,32,240,240,370,31025,marysville,98270,3964,2017
snohomish,marshall elementary,394,12,9,5,14,7,103,205,53,211,183,238,31025,marysville,98271,4150,2017
snohomish,marysville coop program,283,13,4,0,4,1,38,185,42,144,139,55,31025,marysville,98270,1862,2017
snohomish,marysville middle,776,30,47,9,56,19,202,391,78,431,345,419,31025,marysville,98270,3355,2017
snohomish,marysville nwesd 189 youth engagement,75,6,2,2,4,2,18,36,9,45,30,26,31025,marysville,98270,5402,2017
snohomish,marysville pilchuck high,1288,74,45,4,49,29,298,726,112,661,627,517,31025,marysville,98271,5213,2017
snohomish,marysville sd special,122,9,4,0,4,1,20,74,14,78,44,52,31025,marysville,98270,1910,2017
snohomish,pinewood elementary,558,7,16,0,16,6,143,323,63,266,292,257,31025,marysville,98270,3651,2017
snohomish,quil ceda tulalip elementary,572,210,4,3,7,7,107,141,100,279,293,446,31025,tulalip,98271,5350,2017
snohomish,school home partnership program,30,0,2,0,2,2,4,20,2,12,18,10,31025,marysville,98271,1744,2017
snohomish,shoultes elementary,466,6,21,5,26,8,124,241,61,236,230,270,31025,marysville,98271,3187,2017
snohomish,sunnyside elementary,528,7,47,5,52,12,102,322,33,251,277,186,31025,marysville,98270,3537,2017
snohomish,totem middle,564,91,42,2,44,8,114,251,56,285,279,281,31025,marysville,98270,2813,2017
grays harbor,mccleary elem,334,4,4,2,6,6,14,291,13,177,157,195,14065,mccleary,98557,2835,2017
spokane,brentwood elementary,548,2,3,0,3,13,34,455,41,284,264,195,32354,spokane,99218,3693,2017
spokane,colbert elementary,525,0,4,0,4,1,22,475,23,270,255,142,32354,colbert,99005,3562,2017
spokane,evergreen elementary,587,5,5,9,14,10,23,495,40,280,307,247,32354,spokane,99208,3414,2017
spokane,farwell elementary,557,3,9,1,10,9,38,451,46,277,280,211,32354,spokane,99208,3759,2017
spokane,mead alternative high,80,0,0,0,0,1,3,68,8,34,46,51,32354,spokane,99218,1803,2017
spokane,mead education partnership prog,425,0,0,0,0,3,18,380,24,209,216,114,32354,spokane,99208,1858,2017
spokane,mead open doors,12,0,0,0,0,0,2,9,1,7,5,4,32354,mead,99021,5401,2017
spokane,mead preschool,68,2,0,0,0,1,3,62,0,52,16,0,32354,mead,99021,5122,2017
spokane,mead senior high,1622,5,8,1,9,25,104,1319,160,831,791,347,32354,spokane,99218,2402,2017
spokane,meadow ridge elementary,564,1,5,2,7,2,32,495,27,294,270,148,32354,mead,99021,4400,2017
spokane,midway elementary,599,1,4,0,4,2,38,521,33,299,300,110,32354,colbert,99005,4133,2017
spokane,mountainside middle,785,6,11,25,36,12,48,641,42,397,388,241,32354,colbert,99005,3191,2017
spokane,mt spokane high,1532,11,21,23,44,23,85,1243,126,760,772,423,32354,mead,99021,4491,2017
spokane,northwood middle,756,3,8,2,10,16,54,600,73,409,347,208,32354,spokane,99208,3851,2017
spokane,prairie view elementary,761,0,4,0,4,10,25,646,76,394,367,82,32354,spokane,99208,5094,2017
spokane,riverpoint academy,137,0,0,0,0,3,10,118,6,86,51,26,32354,spokane,99218,5268,2017
spokane,shiloh hills elementary,543,10,9,33,42,7,60,346,78,275,268,396,32354,spokane,99208,4134,2017
spokane,hallett elementary,497,2,3,0,3,9,40,423,20,259,238,252,32326,medical lake,99022,4483,2017
spokane,medical lake high,544,2,4,3,7,16,55,416,48,297,247,151,32326,medical lake,99022,2890,2017
spokane,medical lake middle,388,2,3,2,5,7,37,295,42,203,185,139,32326,medical lake,99022,3965,2017
spokane,michael anderson elementary,428,0,7,5,12,22,77,271,46,222,206,110,32326,fairchild afb,99011,4577,2017
king,island park elementary,373,0,65,0,65,4,19,244,41,216,157,8,17400,mercer island,98040,3162,2017
king,islander middle,1127,0,208,5,213,16,29,781,88,602,525,25,17400,mercer island,98040,3219,2017
king,lakeridge elementary,484,1,74,0,74,3,23,331,52,270,214,4,17400,mercer island,98040,2981,2017
king,mercer island high,1495,8,304,2,306,15,60,1025,81,784,711,43,17400,mercer island,98040,3029,2017
king,northwood elementary,470,0,111,0,111,6,27,278,48,249,221,25,17400,mercer island,98040,5447,2017
king,west mercer elementary,516,0,135,0,135,3,37,271,70,265,251,24,17400,mercer island,98040,3433,2017
whatcom,irene reither elementary,627,8,32,3,35,8,133,424,19,323,304,298,37505,everson,98226,2584,2017
whatcom,meridian high,520,2,39,0,39,5,103,352,19,276,244,185,37505,bellingham,98226,2554,2017
whatcom,meridian middle,272,1,16,0,16,3,67,173,12,146,126,135,37505,lynden,98264,3930,2017
whatcom,meridian parent partnership program,292,0,6,0,6,3,22,246,15,153,139,16,37505,bellingham,98226,5047,2017
whatcom,meridian special programs,18,0,0,0,0,1,3,14,0,9,9,1,37505,bellingham,98226,1743,2017
okanogan,alternative,23,0,1,0,1,0,1,20,1,12,11,15,24350,winthrop,98862,1621,2017
okanogan,home school experience,14,0,0,0,0,0,0,14,0,6,8,10,24350,winthrop,98862,1845,2017
okanogan,liberty bell jr sr high,264,1,5,0,5,1,16,232,8,128,136,101,24350,winthrop,98862,2146,2017
okanogan,methow valley elementary,311,5,0,0,0,1,19,278,8,167,144,128,24350,winthrop,98862,4501,2017
skamania,mill a elementary,22,3,0,0,0,0,0,17,2,13,9,16,30031,cook,98605,3406,2017
snohomish,chain lake elementary,534,0,13,0,13,3,55,428,35,248,286,94,31103,snohomish,98290,4362,2017
snohomish,frank wagner elementary,593,1,9,2,11,6,350,192,33,294,299,397,31103,monroe,98272,3060,2017
snohomish,fryelands elementary,468,1,11,0,11,0,134,294,28,250,218,158,31103,monroe,98272,4594,2017
snohomish,hidden river middle,464,3,20,0,20,3,89,323,26,237,227,110,31103,snohomish,98296,4544,2017
snohomish,leaders in learning,87,1,0,0,0,2,17,63,4,37,50,41,31103,monroe,98272,1806,2017
snohomish,maltby elementary,456,1,22,2,24,2,66,347,16,228,228,111,31103,snohomish,98296,2546,2017
snohomish,monroe high,1713,13,41,5,46,8,356,1207,83,879,834,430,31103,monroe,98272,4528,2017
snohomish,monroe special ed preschool,47,0,2,0,2,2,9,32,2,36,11,1,31103,monroe,98272,1570,2017
snohomish,out of district special ed,9,0,0,0,0,0,2,7,0,7,2,1,31103,monroe,98272,1643,2017
snohomish,park place middle,770,8,10,3,13,1,205,516,27,399,371,275,31103,monroe,98272,5040,2017
snohomish,salem woods elementary,487,4,2,0,2,1,55,392,33,249,238,110,31103,monroe,98272,4159,2017
snohomish,shoreline-monroe high,344,5,17,0,17,35,54,199,34,199,145,0,31103,monroe,98272,5154,2017
snohomish,sky valley education center,882,3,11,3,14,9,55,765,36,418,464,6,31103,monroe,98272,1777,2017
snohomish,youth re-engagement,235,4,0,1,1,11,27,192,0,123,112,1,31103,monroe,98272,1883,2017
grays harbor,beacon avenue elementary,329,5,0,0,0,0,24,278,21,176,153,123,14066,montesano,98563,3661,2017
grays harbor,montesano jr-sr high,659,8,8,0,8,0,85,516,41,337,322,199,14066,montesano,98563,2180,2017
grays harbor,simpson avenue elementary,415,8,5,0,5,0,46,334,22,218,197,146,14066,montesano,98563,3374,2017
lewis,morton elementary,168,1,0,0,0,3,18,132,14,84,84,120,21214,morton,98356,2678,2017
lewis,morton junior-senior high,160,3,3,0,3,1,20,129,4,75,85,105,21214,morton,98356,3112,2017
grant,chief moses middle,933,0,9,0,9,6,438,460,20,472,461,577,13161,moses lake,98837,3022,2017
grant,endeavor middle,247,2,0,0,0,4,150,79,12,114,133,216,13161,moses lake,98837,5354,2017
grant,frontier middle,716,1,7,0,7,17,322,347,22,363,353,430,13161,moses lake,98837,2673,2017
grant,garden heights elementary,516,4,4,0,4,3,226,258,21,255,261,285,13161,moses lake,98837,3091,2017
grant,knolls vista elementary,451,1,7,1,8,10,235,184,13,235,216,343,13161,moses lake,98837,2833,2017
grant,lakeview terrace elementary,437,1,2,0,2,4,199,221,10,224,213,272,13161,moses lake,98837,2969,2017
grant,larson heights elementary,342,0,0,1,1,5,183,147,6,186,156,309,13161,moses lake,98837,3021,2017
grant,longview elementary,457,0,3,2,5,3,226,218,5,242,215,334,13161,moses lake,98837,3153,2017
grant,midway elementary,354,0,3,0,3,4,174,162,11,196,158,312,13161,moses lake,98837,2970,2017
grant,moses lake high,2418,16,23,0,23,30,1084,1224,41,1209,1209,1222,13161,moses lake,98837,3215,2017
grant,north elementary,280,0,0,0,0,2,177,89,12,129,151,277,13161,moses lake,98837,3779,2017
grant,park orchard elementary,459,4,1,0,1,4,235,200,15,227,232,304,13161,moses lake,98837,5251,2017
grant,peninsula elementary,462,0,6,0,6,4,208,230,14,233,229,307,13161,moses lake,98837,2832,2017
grant,sage point elementary,442,1,2,0,2,2,119,308,10,223,219,153,13161,moses lake,98837,5173,2017
grant,skill source learning center,113,1,0,0,0,2,47,62,1,65,48,72,13161,moses lake,98837,5323,2017
lewis,mossyrock academy,10,0,0,0,0,0,0,10,0,7,3,7,21206,mossyrock,98564,5415,2017
lewis,mossyrock elementary,309,5,1,2,3,3,94,204,0,159,150,211,21206,mossyrock,98564,2572,2017
lewis,mossyrock jr./sr. high,207,5,2,2,4,1,44,151,2,111,96,107,21206,mossyrock,98564,3238,2017
yakima,harrah elementary,567,296,0,0,0,0,216,28,27,291,276,526,39209,harrah,98933,2506,2017
yakima,mount adams middle,126,81,0,0,0,0,41,1,3,64,62,121,39209,white swan,98952,2389,2017
yakima,white swan high,241,119,0,0,0,0,92,13,17,133,108,202,39209,white swan,98952,2532,2017
whatcom,acme elementary,241,21,0,0,0,1,22,165,32,130,111,111,37507,acme,98220,2585,2017
whatcom,educational resource center,33,5,0,0,0,1,3,20,4,20,13,0,37507,deming,98244,1936,2017
whatcom,harmony elementary,348,29,0,1,1,2,33,257,26,189,159,141,37507,bellingham,98226,3365,2017
whatcom,kendall elementary,446,15,7,1,8,6,77,321,19,234,212,314,37507,maple falls,98266,4533,2017
whatcom,mount baker academy,28,0,0,0,0,0,1,25,2,17,11,0,37507,acme,98220,5112,2017
whatcom,mount baker junior high,294,13,3,1,4,1,27,230,19,152,142,159,37507,deming,98244,3003,2017
whatcom,mount baker senior high,544,26,6,1,7,0,71,410,30,296,248,243,37507,deming,98244,2343,2017
skamania,mount pleasant,63,0,0,0,0,0,8,52,3,36,27,9,30029,washougal,98671,3459,2017
skagit,jefferson elementary,476,1,9,6,15,3,263,189,5,243,233,312,29320,mount vernon,98273,3183,2017
skagit,la venture middle,636,4,6,3,9,8,426,176,13,292,344,472,29320,mount vernon,98273,3821,2017
skagit,lincoln elementary,371,2,8,6,14,2,203,140,10,182,189,261,29320,mount vernon,98274,2579,2017
skagit,little mountain elementary,641,2,17,3,20,11,326,260,22,313,328,381,29320,mount vernon,98274,4013,2017
skagit,madison elementary,524,0,1,1,2,8,372,136,6,267,257,327,29320,mount vernon,98273,3001,2017
skagit,mount baker middle,700,4,20,9,29,8,359,284,16,347,353,432,29320,mount vernon,98274,4511,2017
skagit,mount vernon high,1939,9,47,16,63,17,1022,778,50,1000,939,1026,29320,mount vernon,98273,2295,2017
skagit,mount vernon open doors,18,2,0,1,1,0,11,3,1,8,10,7,29320,mount vernon,98273,5449,2017
skagit,mount vernon special ed,96,1,4,0,4,1,56,33,1,57,39,68,29320,mount vernon,98273,3829,2017
skagit,washington elementary,413,1,6,1,7,1,260,135,9,211,202,330,29320,mount vernon,98273,2880,2017
king,muckleshoot tribal,464,441,0,0,0,2,9,2,10,238,226,383,17903,auburn,98092,1986,2017
snohomish,aces high,186,2,5,3,8,8,69,82,17,111,75,119,31006,everett,98204,4247,2017
snohomish,challenger elementary,815,0,60,17,77,62,350,237,89,392,423,604,31006,everett,98204,4303,2017
snohomish,columbia elementary,629,1,80,6,86,29,96,338,79,330,299,186,31006,mukilteo,98275,4342,2017
snohomish,discovery elementary,643,1,60,7,67,30,275,209,61,338,305,451,31006,everett,98208,4304,2017
snohomish,endeavour elementary,487,0,183,1,184,19,56,174,54,265,222,94,31006,mukilteo,98275,4469,2017
snohomish,explorer middle,969,2,144,17,161,62,386,288,70,528,441,593,31006,everett,98204,4231,2017
snohomish,fairmount elementary,633,0,98,5,103,63,196,212,59,308,325,422,31006,everett,98204,2886,2017
snohomish,harbour pointe middle,837,1,215,2,217,34,106,386,93,425,412,183,31006,mukilteo,98275,4430,2017
snohomish,horizon elementary,701,1,13,6,19,38,401,145,97,366,335,536,31006,everett,98204,4344,2017
snohomish,kamiak high,2105,7,459,12,471,58,227,1157,185,1091,1014,356,31006,mukilteo,98275,4433,2017
snohomish,lake stickney elementary,666,1,131,1,132,79,153,235,66,354,312,351,31006,lynnwood,98087,5450,2017
snohomish,mariner high,2282,17,300,38,338,201,856,722,148,1222,1060,1301,31006,everett,98204,3688,2017
snohomish,mukilteo elementary,611,0,82,0,82,15,59,380,75,312,299,91,31006,mukilteo,98275,4164,2017
snohomish,odyssey elementary,612,10,56,9,65,70,242,165,60,297,315,398,31006,everett,98204,4583,2017
snohomish,olivia park elementary,658,1,68,7,75,49,270,202,61,332,326,416,31006,everett,98204,3121,2017
snohomish,olympic view middle,905,2,102,8,110,58,206,455,74,470,435,400,31006,mukilteo,98275,3120,2017
snohomish,picnic point elementary,441,1,44,6,50,40,85,219,46,231,210,162,31006,edmonds,98026,4165,2017
snohomish,serene lake elementary,425,0,45,2,47,31,68,217,62,231,194,186,31006,edmonds,98026,3687,2017
snohomish,special services,82,0,13,1,14,5,16,41,6,45,37,17,31006,everett,98204,1848,2017
snohomish,voyager middle,863,4,128,17,145,83,323,235,73,447,416,505,31006,everett,98204,4425,2017
yakima,naches valley elementary,506,2,0,0,0,6,111,373,14,259,247,275,39003,naches,98937,5451,2017
yakima,naches valley high,447,2,3,0,3,0,90,337,15,239,208,181,39003,naches,98937,2591,2017
yakima,naches valley middle,397,2,2,0,2,1,92,286,14,194,203,180,39003,naches,98937,2898,2017
lewis,napavine elementary,439,0,2,0,2,1,63,349,24,237,202,220,21014,napavine,98565,3288,2017
lewis,napavine jr sr high,373,2,2,0,2,2,46,307,14,205,168,141,21014,napavine,98565,2273,2017
pacific,naselle elementary,171,1,2,1,3,6,15,146,0,87,84,93,25155,naselle,98638,2868,2017
pacific,naselle jr sr high schools,163,0,4,2,6,0,16,135,6,85,78,81,25155,naselle,98638,3295,2017
pend oreille,newport high,345,2,3,1,4,1,19,304,15,193,152,171,26056,newport,99156,2518,2017
pend oreille,pend oreille river,32,3,0,0,0,0,3,26,0,14,18,25,26056,newport,99156,5118,2017
pend oreille,sadie halstead middle,338,0,2,0,2,0,16,299,21,168,170,209,26056,newport,99156,3968,2017
pend oreille,stratton elementary,378,1,1,1,2,0,24,331,20,213,165,264,26056,newport,99156,4478,2017
spokane,lake spokane elementary,446,6,3,2,5,2,39,360,34,240,206,165,32325,nine mile falls,99026,4036,2017
spokane,lakeside high,503,6,2,1,3,4,18,448,24,241,262,105,32325,nine mile falls,99026,4333,2017
spokane,lakeside middle,336,6,2,1,3,4,16,286,21,172,164,88,32325,nine mile falls,99026,4521,2017
spokane,nine mile falls elementary,155,1,0,0,0,1,8,138,7,78,77,37,32325,nine mile falls,99026,2341,2017
spokane,re-engagement school (nine mile falls),5,0,0,0,0,0,0,5,0,2,3,3,32325,nine mile falls,99026,5417,2017
whatcom,everson elementary,260,31,5,0,5,1,106,99,18,138,122,167,37506,everson,98247,4428,2017
whatcom,nooksack elementary,367,3,2,1,3,1,122,219,19,188,179,187,37506,everson,98247,4525,2017
whatcom,nooksack valley high,462,14,6,0,6,3,135,286,18,239,223,188,37506,everson,98247,2459,2017
whatcom,nooksack valley middle,345,13,2,0,2,1,109,201,19,157,188,177,37506,everson,98247,2687,2017
whatcom,nooksack valley special services,41,0,1,0,1,0,14,24,2,28,13,29,37506,everson,98247,1823,2017
whatcom,sumas elementary,256,6,0,0,0,2,86,149,13,145,111,139,37506,sumas,98295,2489,2017
grays harbor,north beach junior high,105,21,1,0,1,1,9,69,4,57,48,72,14064,ocean shores,98569,3788,2017
grays harbor,north beach senior high,195,13,1,0,1,7,27,136,11,117,78,99,14064,ocean shores,98569,2728,2017
grays harbor,ocean shores elementary,236,16,8,1,9,5,21,180,5,112,124,161,14064,ocean shores,98569,3787,2017
grays harbor,pacific beach elementary,138,44,0,0,0,1,13,51,29,73,65,128,14064,pacific beach,98571,3155,2017
franklin,basin city elem,424,0,1,0,1,0,340,78,5,228,196,361,11051,connell,99326,3325,2017
franklin,connell elem,525,0,13,0,13,0,401,102,9,267,258,414,11051,connell,99326,2918,2017
franklin,connell high,612,0,7,0,7,2,403,192,8,319,293,400,11051,connell,99326,3272,2017
franklin,connell preschool,37,0,0,0,0,0,27,10,0,24,13,22,11051,connell,99326,1889,2017
franklin,mesa elem,178,0,0,0,0,2,103,73,0,101,77,123,11051,mesa,99343,3086,2017
franklin,north franklin virtual academy,5,0,0,0,0,0,0,5,0,1,4,0,11051,connell,99326,5261,2017
franklin,palouse junction high,36,0,0,0,0,0,28,8,0,26,10,39,11051,connell,99326,1754,2017
franklin,robert l olds junior high,339,0,3,0,3,1,237,98,0,180,159,236,11051,connell,99326,2198,2017
kitsap,chief kitsap academy,74,30,0,2,2,2,13,7,18,44,30,44,18400,poulsbo,98370,5319,2017
kitsap,david wolfle elementary,344,71,2,2,4,1,56,147,65,187,157,197,18400,kingston,98346,2798,2017
kitsap,hilder pearson elementary,330,1,11,2,13,6,41,236,33,155,175,89,18400,poulsbo,98370,2854,2017
kitsap,kingston high,766,56,18,2,20,4,61,525,100,401,365,213,18400,kingston,98346,5085,2017
kitsap,kingston middle,487,45,8,3,11,4,53,318,56,259,228,172,18400,kingston,98346,4359,2017
kitsap,middle school options,26,0,0,0,0,0,0,25,1,11,15,1,18400,kingston,98346,3126,2017
kitsap,north kitsap high,1151,12,39,4,43,9,138,842,107,571,580,202,18400,poulsbo,98370,3236,2017
kitsap,pal program,70,2,0,0,0,1,8,57,2,29,41,26,18400,kingston,98346,1733,2017
kitsap,poulsbo elementary,515,8,28,2,30,6,77,341,53,253,262,164,18400,poulsbo,98370,2026,2017
kitsap,poulsbo middle,808,6,36,3,39,7,118,550,88,420,388,212,18400,poulsbo,98370,2476,2017
kitsap,richard gordon elementary,431,6,4,1,5,3,49,323,45,215,216,132,18400,kingston,98346,4467,2017
kitsap,special programs,2,0,0,0,0,0,1,1,0,1,1,0,18400,poulsbo,98370,1677,2017
kitsap,suquamish elementary,385,45,6,0,6,3,56,216,59,180,205,196,18400,suquamish,98392,3391,2017
kitsap,vinland elementary,632,6,26,1,27,8,123,407,61,329,303,185,18400,poulsbo,98370,4461,2017
mason,belfair elementary,487,6,6,0,6,0,122,309,44,250,237,269,23403,belfair,98528,2662,2017
mason,hawkins middle,452,7,2,0,2,4,107,300,32,211,241,251,23403,belfair,98528,3174,2017
mason,james a. taylor high,35,0,0,1,1,0,2,32,0,17,18,32,23403,belfair,98528,1680,2017
mason,north mason homelink program,14,0,0,0,0,0,1,11,2,4,10,4,23403,belfair,98528,1861,2017
mason,north mason senior high,749,6,4,6,10,8,113,568,44,394,355,314,23403,belfair,98528,3175,2017
mason,sand hill elementary,471,5,3,5,8,2,104,318,34,256,215,292,23403,belfair,98528,4320,2017
pacific,north river,60,1,0,0,0,6,13,40,0,32,28,40,25200,cosmopolis,98537,2292,2017
thurston,aspire middle,323,0,20,5,25,8,37,200,53,127,196,79,34003,lacey,98513,5168,2017
thurston,chambers prairie elementary,494,1,25,15,40,46,111,204,92,262,232,254,34003,lacey,98513,5167,2017
thurston,chinook middle,771,8,93,21,114,26,156,376,91,400,371,337,34003,lacey,98516,3361,2017
thurston,evergreen forest elementary,555,15,20,13,33,31,94,288,94,256,299,197,34003,lacey,98503,4058,2017
thurston,horizons elementary,543,3,29,8,37,37,73,317,76,281,262,132,34003,lacey,98513,4408,2017
thurston,komachin middle,724,1,47,25,72,48,142,365,96,380,344,311,34003,lacey,98503,4409,2017
thurston,lacey elementary,495,6,23,14,37,21,114,237,80,264,231,290,34003,lacey,98503,3653,2017
thurston,lakes elementary,616,4,32,16,48,25,91,355,93,330,286,233,34003,lacey,98503,3539,2017
thurston,lydia hawk elementary,433,3,30,15,45,8,168,156,53,222,211,316,34003,lacey,98503,3262,2017
thurston,meadows elementary,669,4,45,15,60,27,124,325,129,339,330,231,34003,lacey,98513,4255,2017
thurston,mountain view elementary,692,6,44,12,56,26,168,350,86,356,336,385,34003,lacey,98503,3130,2017
thurston,nisqually middle,809,16,59,24,83,42,152,406,110,414,395,345,34003,lacey,98503,3611,2017
thurston,north thurston high,1435,16,135,16,151,56,262,812,138,753,682,481,34003,lacey,98506,3010,2017
thurston,olympic view elementary,510,8,28,16,44,22,94,268,74,271,239,218,34003,lacey,98516,3709,2017
thurston,pleasant glade elementary,364,5,56,2,58,12,77,154,58,186,178,242,34003,lacey,98516,4271,2017
thurston,river ridge high,1265,36,87,48,135,84,292,527,191,661,604,503,34003,lacey,98513,4427,2017
thurston,salish middle,677,16,52,11,63,31,130,327,110,368,309,290,34003,lacey,98516,5452,2017
thurston,seven oaks elementary,499,2,23,13,36,24,87,269,81,257,242,242,34003,lacey,98503,4368,2017
thurston,south bay elementary,744,10,24,9,33,28,116,467,90,372,372,258,34003,lacey,98506,2754,2017
thurston,south sound high,164,8,2,4,6,12,38,72,28,83,81,125,34003,lacey,98516,4314,2017
thurston,timberline high,1662,15,104,48,152,110,265,891,229,898,764,554,34003,lacey,98503,3710,2017
thurston,woodland elementary,492,3,20,11,31,19,92,287,60,266,226,166,34003,lacey,98503,4122,2017
stevens,northport elementary,110,0,1,2,3,0,14,90,3,54,56,76,33211,northport,99157,2062,2017
stevens,northport high,64,2,1,0,1,1,7,53,0,38,26,38,33211,northport,99157,2958,2017
stevens,northport homelink program,59,2,3,0,3,0,8,44,2,29,30,25,33211,northport,99157,5252,2017
king,arrowhead elementary,427,1,38,1,39,10,47,288,42,207,220,58,17417,kenmore,98028,3107,2017
king,bear creek elementary,446,0,104,0,104,2,28,275,37,236,210,19,17417,woodinville,98077,4305,2017
king,bothell high,1732,14,253,1,254,58,231,1034,141,912,820,277,17417,bothell,98011,3106,2017
king,c o sorenson,138,1,23,0,23,0,29,69,16,93,45,11,17417,bothell,98011,2493,2017
king,canyon creek elementary,770,5,210,0,210,21,90,364,80,387,383,134,17417,bothell,98021,4017,2017
king,canyon park middle,810,0,85,7,92,19,95,530,74,401,409,139,17417,bothell,98021,3493,2017
king,cottage lake elementary,365,0,17,1,18,5,48,267,27,205,160,47,17417,woodinville,98077,3234,2017
king,crystal springs elementary,622,2,140,1,141,18,118,272,71,316,306,130,17417,bothell,98021,3105,2017
king,east ridge elementary,327,0,22,0,22,0,21,260,24,162,165,13,17417,woodinville,98077,4379,2017
king,fernwood elementary,942,1,372,2,374,16,70,416,65,466,476,71,17417,bothell,98012,4306,2017
king,frank love elementary,658,1,97,1,98,17,84,392,66,317,341,119,17417,bothell,98021,4355,2017
king,hollywood hill elementary,368,0,18,0,18,0,35,287,28,189,179,33,17417,woodinville,98072,4124,2017
king,inglemoor hs,1400,4,214,5,219,30,180,866,101,716,684,195,17417,kenmore,98028,3492,2017
king,kenmore elementary,560,0,47,1,48,16,156,283,57,293,267,196,17417,kenmore,98028,2993,2017
king,kenmore middle,623,5,69,1,70,13,91,384,60,325,298,108,17417,kenmore,98028,3345,2017
king,kokanee elementary,759,4,284,4,288,16,60,334,57,420,339,66,17417,woodinville,98072,4455,2017
king,leota middle,849,3,154,2,156,12,109,500,69,463,386,105,17417,woodinville,98072,3790,2017
king,lockwood elementary,638,3,98,1,99,14,59,399,64,323,315,55,17417,bothell,98021,3390,2017
king,maywood hills elementary,689,1,83,1,84,11,88,423,82,352,337,144,17417,bothell,98011,3344,2017
king,moorlands elementary,792,1,107,0,107,13,71,542,58,399,393,66,17417,kenmore,98028,3442,2017
king,northshore middle,737,2,114,5,119,8,113,435,60,383,354,102,17417,bothell,98011,4021,2017
king,northshore networks,150,2,6,0,6,2,11,118,11,68,82,12,17417,bothell,98021,1814,2017
king,northshore online,16,0,0,0,0,0,3,12,1,9,7,2,17417,bothell,98021,5331,2017
king,northshore special services,165,1,31,3,34,3,24,88,15,115,50,2,17417,bothell,98021,1815,2017
king,secondary academy for success,130,1,4,2,6,3,12,94,14,67,63,48,17417,bothell,98021,3811,2017
king,shelton view elementary,530,1,161,3,164,10,44,257,54,274,256,55,17417,bothell,98021,3679,2017
king,skyview middle,1036,7,285,1,286,27,125,516,75,499,537,161,17417,bothell,98021,4371,2017
king,sunrise elementary,418,0,96,0,96,4,19,260,39,208,210,5,17417,redmond,98052,4187,2017
king,timbercrest middle,750,1,42,0,42,7,53,595,52,372,378,45,17417,woodinville,98077,4516,2017
king,wellington elementary,527,2,69,0,69,5,30,379,42,258,269,37,17417,woodinville,98072,4069,2017
king,westhill elementary,495,0,60,1,61,13,58,304,59,262,233,94,17417,bothell,98011,3287,2017
king,woodin elementary,613,0,70,3,73,10,219,268,43,319,294,189,17417,bothell,98011,3749,2017
king,woodinville hs,1468,1,154,4,158,15,130,1050,114,769,699,111,17417,woodinville,98072,4208,2017
king,woodmoor elementary,818,5,119,0,119,11,184,414,85,425,393,209,17417,bothell,98011,4377,2017
island,broadview elementary,533,1,44,7,51,24,83,291,83,272,261,192,15201,oak harbor,98277,3477,2017
island,crescent harbor elem,587,3,16,4,20,20,108,362,74,293,294,292,15201,oak harbor,98277,3377,2017
island,hillcrest elementary,566,1,24,5,29,15,81,366,74,292,274,170,15201,oak harbor,98277,4328,2017
island,homeconnection,285,0,2,0,2,6,18,242,17,139,146,51,15201,oak harbor,98277,1758,2017
island,igrad academy,8,0,0,0,0,0,2,6,0,4,4,7,15201,oak harbor,98277,5343,2017
island,north whidbey middle,532,3,30,3,33,22,95,324,55,283,249,253,15201,oak harbor,98277,3939,2017
island,oak harbor elementary,568,0,34,7,41,23,115,305,84,283,285,194,15201,oak harbor,98277,2696,2017
island,oak harbor high,1609,6,184,11,195,84,209,989,126,838,771,513,15201,oak harbor,98277,2974,2017
island,olympic view elem,533,1,26,6,32,36,127,257,80,284,249,287,15201,oak harbor,98277,3566,2017
island,special education,116,0,5,0,5,1,17,79,14,87,29,71,15201,oak harbor,98277,3662,2017
whitman,oakesdale elementary,71,0,0,0,0,0,5,66,0,38,33,24,38324,oakesdale,99158,3205,2017
whitman,oakesdale high,40,0,0,0,0,0,3,37,0,16,24,12,38324,oakesdale,99158,2432,2017
grays harbor,oakville elementary,113,25,0,1,1,0,18,56,13,65,48,81,14400,oakville,98568,2922,2017
grays harbor,oakville high,112,24,0,0,0,0,17,65,6,52,60,87,14400,oakville,98568,2283,2017
pacific,hilltop,308,7,3,0,3,0,50,225,23,161,147,192,25101,ilwaco,98624,2517,2017
pacific,ilwaco high,269,6,5,0,5,0,36,208,14,147,122,137,25101,ilwaco,98624,4220,2017
pacific,long beach elementary,254,2,2,1,3,2,47,187,13,137,117,157,25101,long beach,98631,3531,2017
pacific,ocean beach alternative,11,1,0,0,0,0,0,10,0,4,7,23,25101,long beach,98631,5454,2017
pacific,ocean beach early childhood center,16,0,0,0,0,0,4,12,0,8,8,18,25101,long beach,98631,5179,2017
pacific,ocean park elementary,176,0,0,0,0,1,48,114,13,92,84,126,25101,ocean park,98640,4039,2017
grays harbor,ocosta elementary,321,8,2,0,2,2,75,211,23,179,142,249,14172,westport,98595,3025,2017
grays harbor,ocosta junior - senior high,297,16,3,0,3,2,45,197,34,142,155,188,14172,westport,98595,3024,2017
lincoln,odessa high,111,4,0,0,0,2,9,96,0,62,49,36,22105,odessa,99159,2443,2017
lincoln,p c jantz elementary,124,1,0,0,0,2,18,103,0,69,55,71,22105,odessa,99159,2769,2017
okanogan,grainger elementary,482,37,1,0,1,2,159,254,29,259,223,311,24105,okanogan,98840,2539,2017
okanogan,okanogan alternative high,14,3,0,0,0,0,6,3,2,5,9,14,24105,omak,98841,1980,2017
okanogan,okanogan high,287,17,1,0,1,0,64,188,17,145,142,117,24105,okanogan,98840,2246,2017
okanogan,okanogan middle,260,22,3,0,3,2,58,162,13,135,125,140,24105,okanogan,98840,2245,2017
okanogan,okanogan outreach alternative,76,21,0,0,0,0,16,34,5,34,42,55,24105,okanogan,98840,5151,2017
thurston,avanti high,158,0,0,0,0,1,14,125,18,65,93,45,34111,olympia,98501,1768,2017
thurston,boston harbor elementary,152,0,2,0,2,2,7,127,14,76,76,29,34111,olympia,98506,2487,2017
thurston,capital high,1388,12,101,6,107,33,142,970,124,730,658,383,34111,olympia,98502,3960,2017
thurston,centennial elementary olympia,523,1,67,2,69,12,48,330,63,263,260,69,34111,olympia,98501,4367,2017
thurston,garfield elementary,414,4,35,1,36,20,84,213,57,214,200,237,34111,olympia,98502,2448,2017
thurston,jefferson middle,430,2,50,3,53,18,57,258,42,210,220,172,34111,olympia,98502,3133,2017
thurston,julia butler hansen elementary,459,10,42,0,42,21,89,225,72,254,205,202,34111,olympia,98502,4472,2017
thurston,leland p brown elementary,338,1,6,1,7,10,44,228,48,167,171,177,34111,olympia,98502,3540,2017
thurston,lincoln elementary,281,1,4,1,5,4,28,221,22,154,127,66,34111,olympia,98501,2342,2017
thurston,madison elementary,244,1,13,3,16,9,42,136,40,130,114,122,34111,olympia,98501,3066,2017
thurston,mckenny elementary,367,2,26,0,26,10,44,234,51,199,168,108,34111,olympia,98501,4458,2017
thurston,mclane elementary,328,1,23,0,23,7,34,235,28,184,144,109,34111,olympia,98502,2621,2017
thurston,olympia high,1804,10,184,3,187,30,155,1269,153,900,904,281,34111,olympia,98501,3132,2017
thurston,olympia regional learning academy,482,3,5,0,5,15,31,398,30,242,240,127,34111,olympia,98501,5078,2017
thurston,olympia regional learning academy - montessori,206,1,17,0,17,2,16,148,21,106,100,40,34111,olympia,98501,5248,2017
thurston,pioneer elementary,506,1,28,1,29,8,38,387,43,282,224,98,34111,olympia,98501,3697,2017
thurston,reeves middle,428,1,10,1,11,6,50,323,37,217,211,125,34111,olympia,98506,3696,2017
thurston,roosevelt elementary,417,2,10,0,10,5,52,299,49,213,204,166,34111,olympia,98506,2778,2017
thurston,thurgood marshall middle,368,2,31,1,32,13,46,243,32,199,169,132,34111,olympia,98502,4473,2017
thurston,washington middle,819,4,75,1,76,11,72,572,84,446,373,131,34111,olympia,98501,3711,2017
okanogan,e omak elementary,363,77,1,0,1,1,96,148,40,177,186,180,24019,omak,98841,3051,2017
okanogan,highlands high,15,5,0,0,0,1,4,5,0,7,8,15,24019,omak,98841,4279,2017
okanogan,n omak elementary,452,90,4,0,4,5,121,200,32,242,210,287,24019,omak,98841,2999,2017
okanogan,omak high,419,118,1,0,1,2,83,190,25,228,191,146,24019,omak,98841,2031,2017
okanogan,omak middle,295,74,2,0,2,0,65,125,29,151,144,131,24019,omak,98841,4237,2017
okanogan,washington virtual academy omak elementary,1272,30,71,32,103,122,84,924,9,618,654,421,24019,omak,98841,5195,2017
okanogan,washington virtual academy omak high,1231,20,53,12,65,94,68,978,6,538,693,228,24019,omak,98841,5197,2017
okanogan,washington virtual academy omak middle,1372,28,61,18,79,123,102,1028,12,663,709,382,24019,omak,98841,5196,2017
lewis,onalaska elementary,378,2,0,0,0,0,45,312,19,194,184,240,21300,onalaska,98570,3239,2017
lewis,onalaska high,211,2,2,0,2,0,20,180,7,104,107,108,21300,onalaska,98570,2331,2017
lewis,onalaska middle,165,1,1,0,1,0,20,136,7,95,70,104,21300,onalaska,98570,4335,2017
stevens,onion creek elementary,40,0,0,0,0,0,2,33,5,23,17,33,33030,colville,99114,2049,2017
san juan,oasis k-12,409,1,6,0,6,11,8,357,26,175,234,41,28137,eastsound,98245,1892,2017
san juan,orcas island elementary,203,2,2,0,2,2,47,138,12,114,89,99,28137,eastsound,98245,2749,2017
san juan,orcas island high,123,1,8,2,10,2,15,91,4,61,62,40,28137,eastsound,98245,2750,2017
san juan,orcas island middle,55,0,2,1,3,1,5,40,6,26,29,22,28137,eastsound,98245,4558,2017
san juan,waldron island,7,0,0,0,0,0,0,6,1,4,3,2,28137,waldron island,98297,3808,2017
spokane,orchard prairie elementary,85,0,0,0,0,2,6,77,0,40,45,4,32123,spokane,99217,3723,2017
ferry,orient elem,29,0,0,0,0,0,0,28,1,17,12,19,10065,orient,99160,2136,2017
douglas,orondo elementary and middle,195,0,0,0,0,0,175,20,0,95,100,152,09013,orondo,98843,2666,2017
okanogan,oroville elementary,323,5,3,1,4,1,134,167,12,160,163,245,24410,oroville,98844,2422,2017
okanogan,oroville middle-high,264,5,3,1,4,1,88,162,4,144,120,151,24410,oroville,98844,2706,2017
pierce,orting high,830,2,11,3,14,8,104,639,63,426,404,214,27344,orting,98360,2942,2017
pierce,orting middle,566,3,12,1,13,8,77,420,45,301,265,173,27344,orting,98360,4262,2017
pierce,orting primary,516,4,5,2,7,7,67,372,59,258,258,205,27344,orting,98360,2360,2017
pierce,orting special education,12,0,0,0,0,0,3,9,0,6,6,5,27344,orting,98360,5011,2017
pierce,ptarmigan ridge elementary,687,3,6,1,7,8,107,506,56,347,340,234,27344,orting,98360,4547,2017
adams,desert oasis high,90,0,0,0,0,0,87,3,0,54,36,87,01147,othello,99344,5367,2017
adams,hiawatha elementary,551,0,0,0,0,0,493,56,2,277,274,491,01147,othello,99344,2961,2017
adams,lutacaga elementary,590,0,1,0,1,1,555,31,2,299,291,476,01147,othello,99344,2902,2017
adams,mcfarland middle,950,0,3,0,3,1,844,101,1,515,435,765,01147,othello,99344,3471,2017
adams,othello high,1098,0,3,0,3,1,954,133,7,565,533,845,01147,othello,99344,3015,2017
adams,scootney springs elementary,546,0,2,0,2,1,466,74,3,304,242,455,01147,othello,99344,3730,2017
adams,wahitis elementary,541,0,0,0,0,0,483,57,1,270,271,463,01147,othello,99344,5285,2017
douglas,palisades elementary,28,0,0,0,0,0,21,7,0,19,9,22,09102,palisades,98845,2502,2017
whitman,palouse at garfield middle,43,0,0,0,0,0,4,37,2,17,26,13,38301,palouse,99161,1961,2017
whitman,palouse elementary,98,0,0,0,0,0,4,90,4,46,52,36,38301,palouse,99161,2622,2017
whitman,palouse high,48,1,0,0,0,0,6,39,2,29,19,13,38301,palouse,99161,2634,2017
franklin,barbara mcclintock stem elementary,735,0,8,0,8,3,362,335,27,361,374,371,11001,pasco,99301,5391,2017
franklin,captain gray stem elementary,618,0,1,0,1,7,558,40,12,308,310,582,11001,pasco,99301,5392,2017
franklin,chiawana high,2571,2,44,9,53,42,1643,766,65,1356,1215,1583,11001,pasco,99301,5164,2017
franklin,edwin markham elementary,395,2,0,0,0,1,144,242,6,219,176,187,11001,pasco,99301,3425,2017
franklin,internet pasco academy of learning,5,0,0,0,0,0,3,2,0,3,2,8,11001,pasco,99301,5393,2017
franklin,james mcgee elementary,643,0,8,2,10,18,333,253,29,356,287,372,11001,pasco,99301,4155,2017
franklin,longfellow elementary,459,0,0,0,0,1,445,10,3,245,214,456,11001,pasco,99301,2790,2017
franklin,mark twain elementary,781,1,1,1,2,11,502,234,31,388,393,539,11001,pasco,99301,3085,2017
franklin,maya angelou elementary,903,0,21,4,25,10,457,366,45,452,451,460,11001,pasco,99301,4595,2017
franklin,mcloughlin middle,1243,3,30,5,35,22,610,502,71,608,635,653,11001,pasco,99301,2267,2017
franklin,new horizons high,270,1,1,2,3,5,224,32,5,153,117,230,11001,pasco,99301,3912,2017
franklin,pasco early childhood,38,0,0,0,0,1,26,11,0,27,11,36,11001,pasco,99301,1970,2017
franklin,pasco senior high,2172,2,16,1,17,38,1703,377,35,1127,1045,1634,11001,pasco,99301,2917,2017
franklin,robert frost elementary,643,0,0,1,1,0,489,144,9,322,321,584,11001,pasco,99301,3515,2017
franklin,rosalind franklin stem elementary,775,0,14,0,14,4,396,333,28,419,356,425,11001,pasco,99301,5345,2017
franklin,ruth livingston elementary,823,5,20,5,25,11,275,463,44,429,394,335,11001,pasco,99301,4041,2017
franklin,whittier elementary,602,0,3,0,3,2,566,25,6,290,312,574,11001,pasco,99301,4526,2017
okanogan,pateros elementary,169,0,2,0,2,0,96,69,2,96,73,120,24122,pateros,98846,2396,2017
okanogan,pateros high,142,0,0,0,0,0,81,54,7,66,76,90,24122,pateros,98846,2397,2017
lewis,pe ell,276,2,1,0,1,1,20,238,14,143,133,144,21301,pe ell,98572,2858,2017
lewis,trojan alternative,1,0,0,0,0,0,0,1,0,0,1,0,21301,pe ell,98572,1925,2017
pierce,artondale elementary,475,2,4,1,5,2,46,377,43,229,246,86,27401,gig harbor,98335,3299,2017
pierce,discovery elementary,480,2,9,0,9,7,35,384,43,233,247,115,27401,gig harbor,98335,4080,2017
pierce,evergreen elementary,255,3,0,0,0,5,15,215,17,132,123,160,27401,lakebay,98349,3055,2017
pierce,gig harbor high,1658,7,50,6,56,15,118,1353,109,842,816,260,27401,gig harbor,98335,4081,2017
pierce,goodman middle,551,1,19,3,22,7,56,407,58,278,273,126,27401,gig harbor,98335,2294,2017
pierce,harbor heights elementary,589,2,4,2,6,5,70,433,73,299,290,170,27401,gig harbor,98335,2944,2017
pierce,harbor ridge middle,578,2,15,2,17,7,39,465,48,288,290,115,27401,gig harbor,98332,4387,2017
pierce,henderson bay alt high,153,2,1,0,1,2,9,123,16,81,72,90,27401,gig harbor,98332,1516,2017
pierce,key peninsula middle,424,3,2,0,2,0,20,361,38,212,212,208,27401,lakebay,98349,4156,2017
pierce,kopachuck middle,524,1,4,0,4,4,43,430,42,281,243,87,27401,gig harbor,98335,4219,2017
pierce,minter creek elementary,385,3,7,0,7,1,30,309,35,202,183,135,27401,gig harbor,98329,4189,2017
pierce,peninsula high,1394,6,24,4,28,11,95,1136,118,706,688,435,27401,gig harbor,98332,2681,2017
pierce,purdy elementary,621,2,17,1,18,5,65,478,53,306,315,122,27401,gig harbor,98332,3685,2017
pierce,vaughn elementary,385,1,0,0,0,2,31,310,41,220,165,172,27401,vaughn,98394,3056,2017
pierce,voyager elementary,563,4,8,1,9,6,52,445,47,291,272,98,27401,gig harbor,98335,4307,2017
mason,pioneer elementary,340,8,1,0,1,1,52,259,19,184,156,236,23402,shelton,98584,4463,2017
mason,pioneer middle,394,8,0,0,0,7,47,308,24,211,183,252,23402,shelton,98584,2865,2017
garfield,pomeroy elementary,166,0,2,0,2,0,15,146,3,86,80,103,12110,pomeroy,99347,3087,2017
garfield,pomeroy jr sr high,142,0,2,0,2,0,10,126,4,74,68,65,12110,pomeroy,99347,2241,2017
clallam,dry creek elementary,370,76,1,0,1,0,21,209,63,186,184,257,05121,port angeles,98363,4494,2017
clallam,franklin elementary,420,14,12,0,12,6,43,307,38,214,206,237,05121,port angeles,98362,2909,2017
clallam,hamilton elementary,384,12,7,0,7,3,39,280,43,196,188,201,05121,port angeles,98363,3079,2017
clallam,jefferson elementary,330,13,3,3,6,6,54,218,33,164,166,207,05121,port angeles,98362,2368,2017
clallam,lincoln high,69,9,0,0,0,1,8,46,5,26,43,66,05121,port angeles,98363,4003,2017
clallam,parents as partners,9,1,0,0,0,0,0,7,1,4,5,5,05121,port angeles,98362,1715,2017
clallam,port angeles high,1158,35,21,1,22,8,92,887,114,575,583,453,05121,port angeles,98362,2908,2017
clallam,roosevelt elementary,496,7,7,2,9,1,25,395,59,257,239,241,05121,port angeles,98362,5115,2017
clallam,special education,27,2,2,0,2,0,2,20,1,16,11,20,05121,port angeles,98362,1897,2017
clallam,stevens middle,553,24,9,2,11,3,42,420,53,293,260,250,05121,port angeles,98363,3318,2017
jefferson,blue heron middle,395,5,6,2,8,5,34,327,16,195,200,200,16050,port townsend,98368,4475,2017
jefferson,ocean,73,2,0,0,0,0,1,68,2,26,47,24,16050,port townsend,98368,1798,2017
jefferson,port townsend high,348,5,10,2,12,6,30,272,23,180,168,134,16050,port townsend,98368,2503,2017
walla walla,prescott elementary,155,0,0,0,0,1,124,30,0,79,76,129,36402,prescott,99348,3574,2017
walla walla,prescott jr sr high,127,0,0,0,0,0,111,16,0,58,69,109,36402,prescott,99348,3575,2017
walla walla,prescott special ed pre-school,6,0,0,0,0,0,5,1,0,5,1,6,36402,prescott,99348,5157,2017
benton,housel middle,608,5,3,1,4,5,360,225,9,294,314,398,03116,prosser,99350,2906,2017
benton,keene-riverview elementary,500,3,9,0,9,6,311,159,12,280,220,356,03116,prosser,99350,2195,2017
benton,prosser heights elementary,476,3,10,0,10,0,307,149,7,209,267,338,03116,prosser,99350,3316,2017
benton,prosser high,871,2,14,2,16,5,541,279,28,449,422,511,03116,prosser,99350,2508,2017
benton,whitstran elementary,290,0,2,0,2,0,215,72,1,147,143,242,03116,prosser,99350,2905,2017
whitman,franklin elementary,464,2,55,0,55,11,41,324,31,250,214,180,38267,pullman,99163,2587,2017
whitman,jefferson elementary,506,1,47,0,47,15,75,330,38,272,234,188,38267,pullman,99163,3203,2017
whitman,lincoln middle,602,2,51,2,53,16,64,434,33,287,315,163,38267,pullman,99163,3419,2017
whitman,pullman high,845,5,77,3,80,21,92,591,56,442,403,195,38267,pullman,99163,2499,2017
whitman,sunnyside elementary,457,1,57,1,58,7,51,296,44,254,203,134,38267,pullman,99163,3614,2017
pierce,aylen jr high,692,11,30,5,35,18,135,425,68,351,341,213,27003,puyallup,98371,3447,2017
pierce,ballou jr high,847,9,70,6,76,42,137,487,96,445,402,284,27003,puyallup,98373,3750,2017
pierce,brouillet elementary,736,6,29,17,46,17,94,464,109,398,338,198,27003,puyallup,98375,4361,2017
pierce,carson elementary,918,3,63,23,86,47,143,491,148,490,428,283,27003,puyallup,98375,5088,2017
pierce,edgemont jr high,380,3,30,4,34,16,48,252,27,191,189,124,27003,edgewood,98372,2575,2017
pierce,edgerton elementary,770,4,21,7,28,36,95,517,90,405,365,167,27003,puyallup,98374,5093,2017
pierce,emerald ridge high,1563,17,68,18,86,67,202,995,196,837,726,326,27003,puyallup,98374,4540,2017
pierce,ferrucci jr high,669,11,23,5,28,24,118,389,99,370,299,259,27003,puyallup,98374,4183,2017
pierce,firgrove elementary,666,2,36,8,44,39,230,282,69,378,288,385,27003,puyallup,98373,2496,2017
pierce,fruitland elementary,659,4,30,10,40,18,75,425,97,350,309,169,27003,puyallup,98371,3557,2017
pierce,glacier view junior high,796,1,41,8,49,31,117,487,111,421,375,233,27003,puyallup,98374,5142,2017
pierce,kalles junior high,911,8,59,8,67,19,126,601,90,470,441,220,27003,puyallup,98372,3052,2017
pierce,karshner elementary,345,9,12,1,13,10,126,147,40,196,149,181,27003,puyallup,98371,2870,2017
pierce,maplewood elementary,426,1,14,1,15,1,33,315,61,221,205,91,27003,puyallup,98371,2498,2017
pierce,meeker elementary,412,2,18,5,23,15,57,269,46,221,191,105,27003,puyallup,98371,2334,2017
pierce,mt view elementary,362,4,6,7,13,9,50,246,40,167,195,146,27003,edgewood,98372,3572,2017
pierce,northwood elementary,427,1,52,9,61,23,59,223,60,240,187,136,27003,edgewood,98371,3927,2017
pierce,pope elementary,584,9,14,2,16,15,95,386,63,289,295,175,27003,puyallup,98374,4146,2017
pierce,psd special services,124,1,4,3,7,2,26,74,14,77,47,0,27003,puyallup,98371,3951,2017
pierce,puyallup high,1813,14,88,15,103,55,241,1221,179,927,886,463,27003,puyallup,98371,2125,2017
pierce,puyallup parent partnership program,1,0,0,0,0,0,0,1,0,1,0,0,27003,puyallup,98373,5322,2017
pierce,ridgecrest elementary,552,9,14,7,21,15,81,376,50,288,264,207,27003,puyallup,98374,4121,2017
pierce,rogers high,1883,15,113,33,146,107,292,1085,238,980,903,506,27003,puyallup,98373,3645,2017
pierce,shaw road elementary,666,1,45,1,46,14,66,450,89,344,322,138,27003,puyallup,98372,4414,2017
pierce,spinning elementary,314,4,10,4,14,4,68,183,41,156,158,176,27003,puyallup,98372,2497,2017
pierce,stahl junior high,836,8,64,31,95,54,149,411,119,395,441,307,27003,puyallup,98375,4443,2017
pierce,stewart elementary,374,2,17,5,22,21,96,195,38,183,191,210,27003,puyallup,98372,2311,2017
pierce,sunrise elementary,528,3,19,15,34,14,106,290,81,273,255,276,27003,puyallup,98374,3896,2017
pierce,walker high,111,0,0,0,0,0,23,74,14,55,56,62,27003,puyallup,98372,3972,2017
pierce,waller road elementary,342,11,7,2,9,9,62,202,49,181,161,168,27003,tacoma,98443,2495,2017
pierce,wildwood elementary,500,4,22,5,27,25,133,258,53,270,230,251,27003,puyallup,98374,3558,2017
pierce,woodland elementary,696,8,18,18,36,25,101,428,98,336,360,267,27003,puyallup,98373,2519,2017
pierce,zeiger elementary,699,5,54,2,56,25,132,385,96,361,338,218,27003,puyallup,98373,4496,2017
jefferson,crossroads community,4,0,0,0,0,0,0,4,0,3,1,3,16048,quilcene,98376,5081,2017
jefferson,pearl,129,0,0,0,0,0,7,117,5,69,60,0,16048,quilcene,98376,5236,2017
jefferson,quilcene high and elementary,201,7,5,0,5,0,9,157,23,102,99,94,16048,quilcene,98376,2474,2017
clallam,district run home,23,0,0,0,0,0,1,18,4,12,11,14,05402,forks,98331,1671,2017
clallam,forks alternative,38,6,0,0,0,0,7,19,6,20,18,15,05402,forks,98331,1500,2017
clallam,forks elementary,325,35,0,0,0,0,114,144,32,171,154,210,05402,forks,98331,3737,2017
clallam,forks intermediate,244,18,2,0,2,0,77,123,24,127,117,144,05402,forks,98331,5363,2017
clallam,forks junior-senior high,456,44,5,0,5,3,151,219,34,244,212,255,05402,forks,98331,2349,2017
clallam,insight school of washington,1994,25,43,16,59,92,308,1328,182,808,1186,1115,05402,forks,98331,5071,2017
grant,george elementary,187,0,0,0,0,0,169,18,0,82,105,164,13144,quincy,98848,3426,2017
grant,monument elementary,618,0,0,0,0,1,564,52,1,310,308,545,13144,quincy,98848,4536,2017
grant,mountain view elementary,462,0,0,0,0,1,417,41,2,243,219,392,13144,quincy,98848,3020,2017
grant,pioneer elementary,451,0,0,0,0,0,405,44,1,214,237,385,13144,quincy,98848,2919,2017
grant,quincy high,815,0,2,0,2,4,678,129,2,416,399,592,13144,quincy,98848,3088,2017
grant,quincy junior high,415,1,1,0,1,1,361,49,1,215,200,347,13144,quincy,98848,2510,2017
king,rainier prep,251,1,27,2,29,81,104,16,20,129,122,191,17908,seattle,98168,5380,2017
thurston,rainier elementary,372,2,1,2,3,3,36,301,27,188,184,212,34307,rainier,98576,4486,2017
thurston,rainier middle,179,1,2,0,2,0,24,139,13,92,87,90,34307,rainier,98576,2158,2017
thurston,rainier senior high,264,2,3,0,3,1,20,220,18,136,128,88,34307,rainier,98576,2468,2017
pacific,developmental preschool,3,0,0,0,0,0,0,3,0,2,1,3,25116,raymond,98577,1672,2017
pacific,raymond elementary,298,3,12,1,13,0,80,195,7,148,150,201,25116,raymond,98577,2803,2017
pacific,raymond jr sr high,242,12,17,1,18,1,64,139,8,132,110,115,25116,raymond,98577,2357,2017
lincoln,reardan elementary,247,13,0,0,0,0,10,208,16,125,122,98,22009,reardan,99029,2864,2017
lincoln,reardan middle-senior high,324,9,0,0,0,0,14,287,14,162,162,106,22009,reardan,99029,2478,2017
king,benson hill elementary,575,4,189,7,196,83,81,134,77,292,283,279,17403,renton,98058,3587,2017
king,bryn mawr elementary,489,5,135,4,139,121,116,52,56,248,241,304,17403,seattle,98178,2439,2017
king,campbell hill elementary,480,6,115,8,123,171,104,35,41,249,231,365,17403,seattle,98178,3034,2017
king,cascade elementary,547,5,98,12,110,82,162,110,78,254,293,353,17403,renton,98058,3337,2017
king,dimmitt middle,938,1,236,16,252,239,266,102,78,432,506,661,17403,seattle,98178,3280,2017
king,h.o.m.e. program,127,1,6,1,7,11,2,101,5,56,71,9,17403,renton,98055,1784,2017
king,hazelwood elementary,616,5,139,0,139,27,67,310,68,329,287,135,17403,newcastle,98056,3485,2017
king,hazen senior high,1624,12,493,4,497,99,360,593,63,835,789,498,17403,renton,98059,3630,2017
king,highlands elementary,570,2,101,3,104,56,280,85,43,288,282,396,17403,renton,98056,2640,2017
king,honey dew elementary,536,0,89,1,90,39,263,119,25,276,260,345,17403,renton,98058,5229,2017
king,kennydale elementary,613,3,174,3,177,30,123,224,56,317,296,194,17403,renton,98056,2597,2017
king,lakeridge elementary,397,4,50,9,59,220,58,31,25,176,221,357,17403,seattle,98178,2929,2017
king,lindbergh senior high,1265,12,347,9,356,193,242,405,57,648,617,559,17403,renton,98058,3741,2017
king,maplewood heights elementary,717,1,240,3,243,23,145,239,66,378,339,229,17403,renton,98059,3586,2017
king,mcknight middle,1270,4,376,6,382,72,300,441,71,642,628,491,17403,renton,98056,3035,2017
king,meadow crest early childhood education center,283,1,51,2,53,42,73,79,35,198,85,153,17403,renton,98056,5313,2017
king,nelsen middle,1002,2,241,16,257,175,191,294,83,548,454,576,17403,renton,98055,3434,2017
king,open door youth reengagement renton,32,2,1,0,1,10,3,13,3,19,13,38,17403,renton,98055,5335,2017
king,out of district facility,13,0,0,0,0,3,5,4,1,11,2,6,17403,renton,98055,1648,2017
king,renton academy,43,2,2,0,2,17,7,13,2,36,7,30,17403,renton,98055,5070,2017
king,renton park elementary,467,2,58,14,72,91,111,141,50,221,246,280,17403,renton,98058,3521,2017
king,renton senior high,1299,5,409,15,424,367,294,138,71,659,640,789,17403,renton,98055,2475,2017
king,sierra heights elementary,617,1,151,2,153,29,162,200,72,317,300,255,17403,renton,98059,3668,2017
king,talbot hill elementary,531,3,168,6,174,83,81,111,79,287,244,237,17403,renton,98055,3740,2017
king,talley high,308,4,26,1,27,72,89,85,31,159,149,193,17403,seattle,98178,5282,2017
king,tiffany park elementary,439,0,75,1,76,77,98,147,41,232,207,240,17403,renton,98058,3702,2017
ferry,republic elementary,159,5,2,0,2,0,8,123,21,87,72,129,10309,republic,99166,2789,2017
ferry,republic junior high,47,5,1,0,1,2,3,29,7,31,16,30,10309,republic,99166,3559,2017
ferry,republic parent partner,73,0,0,0,0,0,1,71,1,41,32,8,10309,republic,99166,1898,2017
ferry,republic senior high,97,7,2,0,2,0,7,76,5,46,51,45,10309,republic,99166,3579,2017
benton,badger mountain elementary,609,0,31,0,31,15,128,399,36,324,285,203,03400,richland,99352,4060,2017
benton,carmichael middle,959,5,31,1,32,20,194,667,41,480,479,316,03400,richland,99352,2721,2017
benton,chief joseph middle,754,6,25,3,28,25,154,509,32,358,396,386,03400,richland,99352,2785,2017
benton,enterprise middle,1183,13,57,1,58,15,149,923,25,584,599,265,03400,west richland,99353,3926,2017
benton,hanford high,2010,10,106,2,108,57,282,1482,71,1034,976,457,03400,richland,99352,3833,2017
benton,jason lee elementary,548,0,9,0,9,4,100,391,44,275,273,405,03400,richland,99352,2786,2017
benton,jefferson elementary,481,1,8,7,15,33,117,297,18,257,224,327,03400,richland,99352,2642,2017
benton,lewis & clark elementary,557,2,32,1,33,8,131,348,35,281,276,364,03400,richland,99352,2657,2017
benton,marcus whitman elementary,563,4,6,0,6,9,157,350,37,290,273,447,03400,richland,99352,2656,2017
benton,orchard elementary,669,0,49,1,50,13,91,473,42,358,311,113,03400,richland,99352,5419,2017
benton,richland high,2007,8,69,4,73,38,302,1536,50,1007,1000,546,03400,richland,99352,3511,2017
benton,rivers edge high,212,1,2,1,3,5,53,145,5,107,105,109,03400,richland,99352,4295,2017
benton,sacajawea elementary,499,3,17,5,22,14,119,313,28,258,241,220,03400,richland,99352,3732,2017
benton,special programs,127,0,3,0,3,3,23,93,5,71,56,0,03400,richland,99352,2001,2017
benton,tapteal elementary,614,3,7,0,7,4,153,400,47,307,307,295,03400,west richland,99353,4059,2017
benton,three rivers home link,531,2,11,0,11,8,29,473,8,288,243,80,03400,richland,99352,5165,2017
benton,white bluffs elementary,687,1,34,0,34,4,70,543,35,357,330,114,03400,richland,99352,5092,2017
benton,william wiley elementary,526,4,8,0,8,5,67,421,21,267,259,92,03400,west richland,99353,4543,2017
clark,ridgefield high,825,2,14,3,17,7,82,667,50,418,407,149,06122,ridgefield,98642,2390,2017
clark,south ridge elementary,717,1,15,5,20,4,105,544,43,379,338,182,06122,ridgefield,98642,3321,2017
clark,union ridge elementary,837,3,4,1,5,2,78,704,45,402,435,205,06122,ridgefield,98642,3786,2017
clark,view ridge middle,427,0,6,1,7,3,49,344,24,216,211,104,06122,ridgefield,98642,3891,2017
adams,lind ritzville middle,54,2,0,0,0,0,4,48,0,27,27,28,01160,lind,99341,5303,2017
adams,ritzville grade,174,1,4,0,4,2,25,140,2,106,68,93,01160,ritzville,99169,2719,2017
adams,ritzville high,126,3,2,0,2,1,10,106,4,54,72,43,01160,ritzville,99169,2132,2017
spokane,chattaroy elementary,245,4,1,1,2,1,17,211,10,131,114,148,32416,chattaroy,99003,2525,2017
spokane,independent scholar,64,3,0,0,0,0,1,59,1,29,35,44,32416,chattaroy,99003,1919,2017
spokane,riverside elementary,380,10,3,0,3,0,20,333,14,200,180,196,32416,chattaroy,99003,4033,2017
spokane,riverside high,475,14,2,1,3,4,21,429,4,246,229,187,32416,chattaroy,99003,4228,2017
spokane,riverside middle,320,9,2,2,4,2,16,282,7,181,139,156,32416,chattaroy,99003,3466,2017
king,carnation elementary,425,1,17,0,17,5,54,335,13,215,210,78,17407,carnation,98014,2485,2017
king,cedarcrest high,996,9,27,4,31,4,116,805,31,485,511,121,17407,duvall,98019,3524,2017
king,cherry valley elementary,515,3,19,0,19,4,76,388,25,271,244,68,17407,duvall,98019,3101,2017
king,choice,10,0,0,0,0,0,0,9,1,4,6,4,17407,carnation,98014,5244,2017
king,clip,30,0,0,0,0,0,4,23,3,11,19,14,17407,carnation,98014,1756,2017
king,eagle rock multiage,66,0,0,0,0,0,2,64,0,30,36,2,17407,duvall,98019,3006,2017
king,parade,128,0,1,0,1,0,7,115,5,59,69,3,17407,carnation,98014,1854,2017
king,stillwater elementary,449,1,4,0,4,1,74,345,24,252,197,65,17407,carnation,98014,4332,2017
king,tolt middle,736,0,19,5,24,5,93,573,41,341,395,106,17407,carnation,98014,4318,2017
thurston,grand mound elementary,530,19,4,0,4,1,108,356,42,272,258,292,34401,rochester,98579,3801,2017
thurston,h.e.a.r.t. high,31,1,0,0,0,0,5,21,4,14,17,20,34401,rochester,98579,1735,2017
thurston,rochester high,658,26,4,1,5,6,122,469,30,359,299,265,34401,rochester,98579,4326,2017
thurston,rochester middle,526,15,3,0,3,1,125,347,35,269,257,251,34401,rochester,98579,3067,2017
thurston,rochester primary,557,21,0,2,2,2,128,367,37,305,252,304,34401,rochester,98579,2527,2017
klickitat,roosevelt elementary,26,0,0,0,0,0,23,3,0,11,15,0,20403,roosevelt,99356,3530,2017
whitman,rosalia elementary & secondary,183,3,1,0,1,1,6,167,5,88,95,96,38320,rosalia,99170,3204,2017
grant,red rock elementary,618,3,0,0,0,0,514,99,2,307,311,480,13160,royal city,99357,3090,2017
grant,royal high,489,0,0,0,0,1,408,80,0,258,231,359,13160,royal city,99357,3516,2017
grant,royal intermediate,388,0,0,0,0,0,326,61,1,194,194,312,13160,royal city,99357,5388,2017
grant,royal middle,264,0,1,0,1,0,207,56,0,141,123,195,13160,royal city,99357,3620,2017
san juan,friday harbor elementary,405,3,2,0,2,1,75,305,19,198,207,179,28149,friday harbor,98250,2520,2017
san juan,friday harbor high,285,2,9,1,10,2,46,209,16,152,133,101,28149,friday harbor,98250,2879,2017
san juan,friday harbor middle,123,0,2,0,2,0,21,95,5,54,69,59,28149,friday harbor,98250,3011,2017
san juan,griffin bay,12,0,0,0,0,0,1,11,0,6,6,10,28149,friday harbor,98250,1963,2017
grays harbor,satsop elementary,70,0,0,0,0,0,13,52,5,29,41,29,14104,satsop,98583,2010,2017
king,adams elementary,572,3,11,1,12,25,59,409,64,301,271,87,17001,seattle,98107,2138,2017
king,aki kurose middle,737,3,271,3,274,276,118,24,42,392,345,553,17001,seattle,98118,3774,2017
king,alki elementary,380,2,11,0,11,20,32,270,45,199,181,56,17001,seattle,98116,2181,2017
king,arbor heights elementary,455,2,29,2,31,42,55,274,51,245,210,123,17001,seattle,98146,2730,2017
king,b f day elementary,290,0,19,1,20,36,25,174,35,152,138,74,17001,seattle,98103,3717,2017
king,bailey gatzert elementary,317,0,38,0,38,166,65,18,30,183,134,242,17001,seattle,98122,2307,2017
king,ballard high,1852,18,115,1,116,56,175,1381,106,945,907,197,17001,seattle,98117,2220,2017
king,beacon hill international,423,3,126,1,127,22,150,65,56,210,213,255,17001,seattle,98144,2070,2017
king,birth to 3 contracts,419,1,57,1,58,49,58,190,63,270,149,24,17001,seattle,98124,5048,2017
king,bridges transition,117,2,20,0,20,23,14,50,8,65,52,50,17001,seattle,98108,5406,2017
king,broadview-thomson k-8,624,3,67,3,70,137,149,198,67,320,304,353,17001,seattle,98133,2209,2017
king,bryant elementary,595,3,38,0,38,6,31,438,79,269,326,25,17001,seattle,98115,2372,2017
king,cascade parent partnership program,175,2,10,0,10,14,9,94,46,99,76,29,17001,seattle,98119,1751,2017
king,cascadia elementary,754,0,97,1,98,4,22,516,114,397,357,26,17001,seattle,98115,5292,2017
king,catharine blaine k-8,770,3,34,3,37,16,46,567,101,402,368,48,17001,seattle,98199,2838,2017
king,chief sealth international high,1118,19,191,15,206,238,326,258,71,568,550,657,17001,seattle,98126,3096,2017
king,cleveland high school stem,859,5,417,1,418,243,86,60,47,439,420,479,17001,seattle,98108,2392,2017
king,concord international,358,2,27,4,31,34,230,43,18,181,177,286,17001,seattle,98108,2199,2017
king,daniel bagley elementary,427,0,47,0,47,18,25,290,47,219,208,53,17001,seattle,98103,2450,2017
king,david t. denny international middle,823,20,132,12,144,202,244,172,41,437,386,549,17001,seattle,98126,2839,2017
king,dearborn park international,354,1,139,0,139,125,28,29,32,199,155,255,17001,seattle,98108,3803,2017
king,dunlap elementary,302,1,79,4,83,134,60,7,17,164,138,236,17001,seattle,98118,2321,2017
king,eckstein middle,980,3,92,1,93,50,64,681,89,489,491,118,17001,seattle,98115,2729,2017
king,emerson elementary,290,1,56,1,57,114,60,26,32,148,142,196,17001,seattle,98118,2118,2017
king,fairmount park elementary,521,1,25,1,26,30,51,333,80,254,267,74,17001,seattle,98126,3518,2017
king,franklin high,1258,9,618,4,622,354,126,98,49,632,626,842,17001,seattle,98144,2182,2017
king,frantz coe elementary,560,1,18,1,19,14,50,414,62,292,268,47,17001,seattle,98119,2090,2017
king,garfield high,1763,10,304,7,311,437,139,730,136,862,901,515,17001,seattle,98122,2306,2017
king,gatewood elementary,388,2,9,2,11,37,44,247,47,190,198,90,17001,seattle,98136,2139,2017
king,genesee hill elementary,691,2,17,0,17,13,33,533,93,372,319,62,17001,seattle,98116,3429,2017
king,graham hill elementary,352,1,55,3,58,110,66,71,46,189,163,247,17001,seattle,98118,3378,2017
king,green lake elementary,427,1,38,0,38,10,22,302,54,207,220,60,17001,seattle,98103,2061,2017
king,greenwood elementary,360,3,14,1,15,20,38,243,41,175,185,49,17001,seattle,98117,2123,2017
king,hamilton international middle,1202,1,99,2,101,35,81,896,88,669,533,86,17001,seattle,98103,2371,2017
king,hawthorne elementary school - seattle,385,1,63,2,65,99,76,104,40,190,195,230,17001,seattle,98118,4248,2017
king,hazel wolf k-8,711,4,37,4,41,54,69,483,60,344,367,141,17001,seattle,98125,5175,2017
king,highland park elementary,359,8,69,6,75,54,109,58,55,195,164,257,17001,seattle,98106,2269,2017
king,ingraham high,1345,10,167,2,169,128,180,745,113,709,636,334,17001,seattle,98133,3276,2017
king,interagency open doors,87,4,6,3,9,27,21,20,6,42,45,78,17001,seattle,98118,5405,2017
king,interagency programs,396,16,39,3,42,139,99,73,27,214,182,342,17001,seattle,98124,1635,2017
king,jane addams middle,929,10,138,1,139,74,99,520,87,475,454,244,17001,seattle,98125,5351,2017
king,john hay elementary,499,0,79,0,79,19,43,278,80,247,252,57,17001,seattle,98109,2063,2017
king,john muir elementary,400,0,44,3,47,195,46,64,48,193,207,269,17001,seattle,98144,2143,2017
king,john rogers elementary,366,3,35,3,38,42,51,172,60,204,162,129,17001,seattle,98125,2975,2017
king,john stanford international,430,4,55,0,55,5,68,215,83,205,225,31,17001,seattle,98105,2081,2017
king,kimball elementary,425,0,129,1,130,85,56,97,57,201,224,218,17001,seattle,98144,3478,2017
king,lafayette elementary,463,2,37,0,37,30,33,301,60,241,222,85,17001,seattle,98116,2733,2017
king,laurelhurst elementary,401,0,53,1,54,19,18,265,45,208,193,94,17001,seattle,98105,2437,2017
king,lawton elementary,443,3,29,1,30,12,29,301,68,232,211,31,17001,seattle,98199,2183,2017
king,leschi elementary,399,1,10,2,12,175,38,129,44,206,193,208,17001,seattle,98122,2121,2017
king,licton springs k-8,130,18,5,1,6,10,24,48,24,71,59,70,17001,seattle,98115,3874,2017
king,louisa boren stem k-8,476,1,44,0,44,60,59,248,64,279,197,125,17001,seattle,98106,5276,2017
king,lowell elementary,344,3,74,3,77,96,35,93,40,180,164,219,17001,seattle,98102,3714,2017
king,loyal heights elementary,411,0,13,0,13,8,27,319,44,200,211,30,17001,seattle,98115,2462,2017
king,madison middle,866,6,84,3,87,78,82,532,81,442,424,224,17001,seattle,98116,2435,2017
king,madrona k-5,307,0,6,0,6,135,34,83,49,167,140,164,17001,seattle,98122,2069,2017
king,maple elementary,502,3,261,2,263,42,88,63,43,269,233,309,17001,seattle,98108,2353,2017
king,martin luther king jr. elementary,293,0,96,8,104,116,48,6,19,157,136,175,17001,seattle,98118,2089,2017
king,mcclure middle,536,3,50,4,54,31,50,365,33,273,263,90,17001,seattle,98119,3517,2017
king,mcdonald international,457,0,18,0,18,2,58,295,84,229,228,13,17001,seattle,98105,5203,2017
king,mcgilvra elementary,282,0,28,0,28,18,13,185,38,138,144,24,17001,seattle,98112,2201,2017
king,mercer international middle,1177,2,475,1,476,274,216,139,70,589,588,744,17001,seattle,98108,3095,2017
king,middle college high,129,4,11,0,11,18,23,63,10,47,82,34,17001,seattle,98125,1547,2017
king,montlake elementary,264,0,23,0,23,12,10,178,41,143,121,14,17001,seattle,98112,2322,2017
king,nathan hale high,1176,15,143,8,151,159,135,632,84,624,552,357,17001,seattle,98125,3479,2017
king,north beach elementary,328,0,13,0,13,4,21,241,49,180,148,23,17001,seattle,98117,3218,2017
king,northgate elementary,281,1,23,4,27,65,104,52,32,133,148,203,17001,seattle,98125,3027,2017
king,nova high,337,7,18,0,18,15,26,232,39,151,186,85,17001,seattle,98122,3868,2017
king,olympic hills elementary,352,1,35,6,41,84,97,88,41,160,192,262,17001,seattle,98125,2976,2017
king,olympic view elementary,494,3,60,1,61,71,59,240,60,258,236,181,17001,seattle,98115,2256,2017
king,orca k-8,372,0,23,0,23,91,23,190,45,195,177,119,17001,seattle,98118,4065,2017
king,pathfinder k-8,490,1,21,0,21,24,48,326,70,259,231,79,17001,seattle,98106,1620,2017
king,private school services,183,1,15,0,15,19,17,112,19,119,64,19,17001,seattle,98124,5046,2017
king,queen anne elementary,418,0,24,0,24,10,26,296,62,222,196,33,17001,seattle,98109,5204,2017
king,rainier beach high,696,2,190,11,201,347,94,21,31,368,328,509,17001,seattle,98118,3327,2017
king,rainier view elementary,225,2,65,3,68,90,26,11,28,121,104,176,17001,seattle,98178,3380,2017
king,residential consortium,31,2,1,2,3,6,3,12,5,22,9,6,17001,seattle,98119,4263,2017
king,roosevelt high,1743,7,202,2,204,76,126,1195,135,850,893,195,17001,seattle,98115,2285,2017
king,roxhill elementary,300,2,35,4,39,76,103,49,31,154,146,233,17001,seattle,98126,3157,2017
king,sacajawea elementary,265,0,28,0,28,25,29,150,33,142,123,67,17001,seattle,98115,3028,2017
king,salmon bay k-8,658,3,36,0,36,9,41,503,66,348,310,52,17001,seattle,98117,1796,2017
king,sand point elementary,237,0,34,0,34,34,29,87,53,118,119,101,17001,seattle,98115,5205,2017
king,sanislo elementary,257,4,49,7,56,50,60,56,31,133,124,160,17001,seattle,98106,3665,2017
king,seattle world,280,0,90,0,90,74,104,9,3,162,118,338,17001,seattle,98122,1596,2017
king,south lake high,68,1,8,1,9,34,15,2,7,27,41,54,17001,seattle,98118,3778,2017
king,south shore pk-8,619,9,143,3,146,296,58,45,65,338,281,404,17001,seattle,98118,4218,2017
king,stevens elementary,297,2,11,1,12,59,30,155,39,146,151,100,17001,seattle,98112,2080,2017
king,the center,234,1,10,0,10,11,27,167,18,84,150,29,17001,seattle,98109,1856,2017
king,thornton creek elementary,464,2,23,1,24,6,29,341,62,240,224,30,17001,seattle,98115,3974,2017
king,thurgood marshall elementary,550,2,83,0,83,102,40,237,86,313,237,169,17001,seattle,98144,2141,2017
king,tops k-8,471,2,95,0,95,56,23,232,63,217,254,118,17001,seattle,98102,1579,2017
king,van asselt elementary,472,1,176,1,177,197,45,21,31,242,230,380,17001,seattle,98108,2120,2017
king,view ridge elementary,571,5,84,0,84,13,35,353,81,272,299,45,17001,seattle,98115,2667,2017
king,viewlands elementary,388,5,36,1,37,42,76,178,50,191,197,171,17001,seattle,98177,2977,2017
king,washington middle,1090,6,187,5,192,309,83,403,97,560,530,478,17001,seattle,98144,4064,2017
king,wedgwood elementary,471,0,62,0,62,11,46,262,90,237,234,40,17001,seattle,98115,3026,2017
king,west seattle elementary,447,2,31,6,37,289,50,45,24,225,222,372,17001,seattle,98126,2645,2017
king,west seattle high,992,9,124,7,131,115,136,521,80,494,498,251,17001,seattle,98116,2234,2017
king,west woodland elementary,545,0,27,0,27,12,33,406,67,272,273,26,17001,seattle,98107,2142,2017
king,whitman middle,856,9,68,3,71,92,111,500,73,465,391,248,17001,seattle,98117,3277,2017
king,whittier elementary,477,1,23,0,23,10,20,375,48,256,221,40,17001,seattle,98117,2092,2017
king,wing luke elementary,356,0,117,2,119,173,22,12,30,167,189,264,17001,seattle,98118,3581,2017
skagit,big lake elementary,338,1,8,0,8,5,25,284,15,152,186,67,29101,mount vernon,98274,2521,2017
skagit,cascade middle,612,18,5,0,5,3,139,428,19,312,300,308,29101,sedro-woolley,98284,3181,2017
skagit,central elementary,444,4,2,0,2,2,115,302,19,222,222,271,29101,sedro-woolley,98284,2380,2017
skagit,clear lake elementary,315,3,3,0,3,0,35,268,6,145,170,145,29101,clear lake,98235,3403,2017
skagit,evergreen elementary,551,29,9,3,12,5,155,332,18,302,249,334,29101,sedro-woolley,98284,3942,2017
skagit,good beginnings center,52,1,0,0,0,2,16,32,1,32,20,44,29101,sedro-woolley,98273,5058,2017
skagit,lyman elementary,165,2,0,0,0,0,16,137,10,80,85,79,29101,lyman,98263,2620,2017
skagit,mary purcell elementary,421,3,0,1,1,2,134,266,15,207,214,304,29101,sedro-woolley,98284,2774,2017
skagit,samish elementary,175,2,0,0,0,1,19,150,3,90,85,72,29101,sedro-woolley,98284,3402,2017
skagit,sedro woolley senior high,1205,32,11,3,14,8,208,902,41,630,575,488,29101,sedro-woolley,98284,2150,2017
skagit,state street high,158,6,0,3,3,4,24,116,5,86,72,96,29101,sedro-woolley,98284,1537,2017
yakima,john campbell primary,830,6,1,1,2,5,230,560,27,433,397,422,39119,selah,98942,5383,2017
yakima,robert lince early learning center,32,0,0,0,0,0,14,17,1,24,8,12,39119,selah,98942,5232,2017
yakima,selah academy,96,2,0,0,0,3,21,70,0,44,52,49,39119,selah,98942,4272,2017
yakima,selah high,1118,7,7,0,7,6,281,794,23,589,529,391,39119,selah,98942,2388,2017
yakima,selah homelink,28,0,0,0,0,0,3,25,0,15,13,9,39119,selah,98942,5231,2017
yakima,selah intermediate,790,5,5,0,5,3,257,503,17,398,392,411,39119,selah,98942,5384,2017
yakima,selah middle,817,9,4,2,6,2,244,531,25,405,412,389,39119,selah,98942,5385,2017
pend oreille,selkirk elementary,131,0,0,0,0,0,6,118,7,65,66,70,26070,metaline falls,99153,5075,2017
pend oreille,selkirk high,92,1,2,0,2,0,5,82,2,43,49,28,26070,ione,99139,5226,2017
pend oreille,selkirk middle,50,1,1,0,1,0,5,43,0,29,21,20,26070,ione,99139,5225,2017
clallam,greywolf elementary,546,7,2,4,6,1,54,435,43,281,265,254,05323,sequim,98382,4378,2017
clallam,helen haller elementary,625,6,8,0,8,1,100,466,44,322,303,332,05323,sequim,98382,2722,2017
clallam,sequim community,132,6,0,0,0,2,16,102,6,74,58,56,05323,sequim,98382,1708,2017
clallam,sequim middle,617,6,9,2,11,4,72,483,41,316,301,248,05323,sequim,98382,4519,2017
clallam,sequim senior high,942,26,25,1,26,6,90,728,66,468,474,305,05323,sequim,98382,2471,2017
san juan,shaw island elementary,8,0,0,0,0,1,0,7,0,4,4,0,28010,shaw island,98286,3725,2017
mason,bordeaux elementary,594,34,3,1,4,1,86,419,50,332,262,382,23309,shelton,98584,3291,2017
mason,evergreen elementary,579,4,1,2,3,6,440,114,12,288,291,525,23309,shelton,98584,2745,2017
mason,mountain view elementary,685,10,2,1,3,1,147,476,48,353,332,486,23309,shelton,98584,3292,2017
mason,oakland bay junior high,668,25,9,2,11,7,176,397,49,353,315,398,23309,shelton,98584,4363,2017
mason,olympic middle,571,16,1,1,2,1,195,332,25,301,270,383,23309,shelton,98584,4586,2017
mason,shelton high,1057,48,9,1,10,6,234,675,84,589,468,535,23309,shelton,98584,3241,2017
king,albert einstein middle,723,7,122,7,129,49,85,375,78,372,351,186,17412,shoreline,98177,3674,2017
king,briarcrest elementary,526,2,55,1,56,49,103,246,70,260,266,180,17412,shoreline,98155,2990,2017
king,brookside elementary,500,1,38,1,39,16,55,314,75,265,235,79,17412,lake forest park,98155,3230,2017
king,cascade k-8 community,201,1,15,0,15,7,29,131,18,101,100,43,17412,shoreline,98155,1942,2017
king,early childhood education,36,0,8,0,8,0,6,17,5,27,9,10,17412,shoreline,98155,5287,2017
king,echo lake elementary,521,3,94,5,99,33,85,233,68,273,248,174,17412,shoreline,98133,3104,2017
king,handicapped contractual services,102,1,5,0,5,5,12,69,10,56,46,26,17412,shoreline,98155,1667,2017
king,highland terrace elementary,496,2,48,4,52,23,39,316,64,243,253,69,17412,shoreline,98133,3231,2017
king,home education exchange,132,0,2,0,2,2,8,114,6,72,60,14,17412,shoreline,98155,1771,2017
king,kellogg middle,685,0,88,2,90,62,93,350,90,346,339,179,17412,shoreline,98155,3387,2017
king,lake forest park elementary,535,1,52,5,57,32,52,339,54,260,275,138,17412,lake forest park,98155,2185,2017
king,melvin g syre elementary,520,1,29,0,29,16,56,348,70,287,233,80,17412,shoreline,98177,3527,2017
king,meridian park elementary,606,1,125,1,126,46,70,291,72,307,299,174,17412,shoreline,98133,3958,2017
king,parkwood elementary,448,4,66,12,78,37,90,196,43,250,198,169,17412,shoreline,98133,3489,2017
king,ridgecrest elementary,559,0,76,3,79,41,79,269,91,305,254,141,17412,shoreline,98155,2703,2017
king,shorecrest high,1409,3,194,5,199,101,156,788,162,716,693,366,17412,shoreline,98155,3343,2017
king,shorewood high,1611,6,272,9,281,135,196,825,168,849,762,414,17412,shoreline,98133,3921,2017
skamania,skamania elementary,84,0,0,0,0,1,4,77,2,37,47,44,30002,skamania,98648,3405,2017
king,skykomish elementary,40,0,0,0,0,0,4,36,0,20,20,29,17404,skykomish,98288,2512,2017
king,skykomish high,17,0,0,0,0,0,2,15,0,10,7,11,17404,skykomish,98288,2513,2017
snohomish,aim high,139,2,1,0,1,0,14,114,8,63,76,42,31201,snohomish,98290,4265,2017
snohomish,cascade view elementary,411,2,8,1,9,2,42,330,26,216,195,93,31201,snohomish,98290,4366,2017
snohomish,cathcart elementary,401,1,5,1,6,10,64,308,12,198,203,75,31201,snohomish,98296,3305,2017
snohomish,centennial middle,774,6,16,0,16,3,85,635,29,387,387,172,31201,snohomish,98290,4395,2017
snohomish,central elementary,250,0,1,3,4,2,51,176,17,132,118,113,31201,snohomish,98290,2446,2017
snohomish,dutch hill elementary,551,3,5,3,8,0,33,473,34,276,275,78,31201,snohomish,98290,4241,2017
snohomish,emerson elementary,346,1,2,0,2,0,80,242,21,174,172,163,31201,snohomish,98290,3005,2017
snohomish,glacier peak high,1813,9,121,1,122,22,153,1389,118,937,876,172,31201,snohomish,98296,5128,2017
snohomish,high school re entry,10,0,0,0,0,0,0,10,0,7,3,16,31201,snohomish,98290,3981,2017
snohomish,little cedars elementary,708,6,71,1,72,9,66,512,43,363,345,92,31201,snohomish,98290,5100,2017
snohomish,machias elementary,494,5,9,0,9,0,40,410,30,272,222,137,31201,snohomish,98290,2073,2017
snohomish,riverview elementary,564,1,12,0,12,3,76,438,34,283,281,123,31201,snohomish,98290,3561,2017
snohomish,seattle hill elementary,646,1,48,0,48,5,66,447,79,309,337,112,31201,everett,98208,4184,2017
snohomish,snohomish center,33,2,2,0,2,1,1,25,2,20,13,6,31201,snohomish,98290,1730,2017
snohomish,snohomish high,1690,11,30,2,32,13,177,1381,76,861,829,322,31201,snohomish,98290,2428,2017
snohomish,totem falls,442,4,28,1,29,7,26,359,17,242,200,43,31201,snohomish,98296,4383,2017
snohomish,valley view middle,786,1,56,2,58,7,92,584,44,405,381,96,31201,snohomish,98296,4145,2017
king,cascade view elementary,621,0,41,0,41,0,33,501,46,328,293,16,17410,snoqualmie,98065,5015,2017
king,chief kanim middle,773,4,66,2,68,7,51,608,35,418,355,66,17410,fall city,98024,4397,2017
king,edwin r opstad elementary,557,5,11,0,11,11,57,449,24,303,254,101,17410,north bend,98045,4308,2017
king,fall city elementary,586,0,41,0,41,0,39,474,32,318,268,47,17410,fall city,98024,2222,2017
king,mount si high,1832,15,67,9,76,11,107,1567,56,956,876,165,17410,snoqualmie,98065,2850,2017
king,north bend elementary,462,2,5,1,6,1,61,367,25,222,240,88,17410,north bend,98045,2287,2017
king,snoqualmie access,64,3,2,0,2,2,1,53,3,44,20,8,17410,snoqualmie,98065,5181,2017
king,snoqualmie elementary,590,1,38,0,38,11,60,430,50,334,256,86,17410,snoqualmie,98065,2288,2017
king,snoqualmie parent partnership program,86,0,2,0,2,1,10,70,3,43,43,2,17410,north bend,98045,5296,2017
king,svsd open doors,3,0,0,0,0,0,0,3,0,0,3,5,17410,snoqualmie,98065,5374,2017
king,timber ridge elementary,598,0,80,1,81,1,40,420,56,300,298,8,17410,snoqualmie,98065,5457,2017
king,twin falls middle,799,1,26,1,27,6,61,669,35,407,392,71,17410,north bend,98045,5135,2017
king,two rivers,102,3,0,0,0,0,9,87,3,57,45,35,17410,north bend,98045,1502,2017
grant,smokiam alternative high,20,0,0,0,0,0,4,16,0,9,11,13,13156,soap lake,98851,1518,2017
grant,soap lake elementary,213,2,1,0,1,0,80,127,3,110,103,197,13156,soap lake,98851,2694,2017
grant,soap lake middle & high,262,0,0,0,0,8,92,160,2,143,119,206,13156,soap lake,98851,3089,2017
pierce,soar academy public charter,143,1,0,3,3,55,17,25,42,64,79,101,27909,tacoma,98404,5379,2017
pacific,chauncey davis elementary,319,7,10,2,12,2,143,123,32,177,142,234,25118,south bend,98586,2804,2017
pacific,south bend high,237,7,5,0,5,2,80,113,30,112,125,142,25118,south bend,98586,2214,2017
kitsap,burley glenwood elementary,477,2,5,8,13,2,49,369,42,244,233,194,18402,port orchard,98367,4029,2017
kitsap,cedar heights middle,772,10,34,20,54,17,95,510,86,400,372,333,18402,port orchard,98366,3680,2017
kitsap,discovery,211,5,2,1,3,5,15,166,17,103,108,104,18402,port orchard,98366,3899,2017
kitsap,east port orchard elementary,481,5,10,15,25,10,54,317,70,249,232,252,18402,port orchard,98366,2641,2017
kitsap,explorer academy,176,1,0,2,2,0,15,141,17,81,95,67,18402,port orchard,98366,1718,2017
kitsap,hidden creek elementary,510,8,18,7,25,1,66,356,54,270,240,217,18402,port orchard,98367,4348,2017
kitsap,madrona heights preschool program,95,1,2,0,2,1,18,61,12,67,28,50,18402,port orchard,98366,5072,2017
kitsap,manchester elementary,375,1,4,2,6,6,42,278,42,208,167,165,18402,port orchard,98366,4079,2017
kitsap,mullenix ridge elementary,523,2,6,1,7,3,50,393,68,277,246,142,18402,port orchard,98367,4350,2017
kitsap,olalla elementary,375,7,1,8,9,0,39,273,47,200,175,144,18402,port orchard,98359,2995,2017
kitsap,orchard heights elementary,785,4,12,6,18,10,86,546,121,427,358,346,18402,port orchard,98366,2650,2017
kitsap,sidney glen elementary,571,4,17,10,27,15,72,375,78,278,293,280,18402,port orchard,98366,4349,2017
kitsap,south colby elementary,378,3,9,1,10,2,33,289,41,177,201,87,18402,port orchard,98366,3110,2017
kitsap,south kitsap high,2279,24,99,41,140,34,240,1591,250,1204,1075,661,18402,port orchard,98366,2272,2017
kitsap,sunnyslope elementary,503,1,29,5,34,5,68,326,69,251,252,177,18402,port orchard,98367,4141,2017
island,south whidbey academy,75,0,0,0,0,0,3,69,3,39,36,24,15206,langley,98260,1682,2017
island,south whidbey elementary,540,6,4,4,8,5,41,455,25,263,277,190,15206,langley,98260,4321,2017
island,south whidbey high,453,5,16,0,16,10,21,391,10,224,229,72,15206,langley,98260,4149,2017
island,south whidbey middle,318,2,14,1,15,1,21,263,16,157,161,86,15206,langley,98260,2511,2017
island,south whidbey special services,9,0,0,0,0,0,0,8,1,6,3,1,15206,langley,98260,1683,2017
mason,southside elementary,217,8,6,0,6,4,21,162,16,95,122,82,23042,shelton,98584,2744,2017
spokane,spokane international academy elementary,263,3,4,0,4,8,29,186,33,112,151,105,32901,spokane,99217,5381,2017
spokane,adams elementary,356,6,10,4,14,8,52,212,64,168,188,254,32081,spokane,99223,2156,2017
spokane,alternative northeast community center preschool,11,0,0,0,0,0,1,10,0,7,4,12,32081,spokane,99207,1566,2017
spokane,arlington elementary,612,9,29,20,49,18,90,383,63,324,288,480,32081,spokane,99217,2381,2017
spokane,audubon elementary,399,8,11,0,11,9,58,264,49,204,195,330,32081,spokane,99205,2128,2017
spokane,balboa elementary,373,1,3,1,4,3,33,295,37,202,171,149,32081,spokane,99208,3357,2017
spokane,bemiss elementary,538,26,3,14,17,25,91,297,82,282,256,482,32081,spokane,99207,2155,2017
spokane,browne elementary,415,2,0,0,0,6,38,309,60,220,195,282,32081,spokane,99205,2218,2017
spokane,bryant center,1051,2,13,1,14,14,93,873,55,518,533,221,32081,spokane,99201,3008,2017
spokane,chase middle,713,5,22,4,26,13,83,500,86,363,350,354,32081,spokane,99223,4457,2017
spokane,cooper elementary,536,3,22,32,54,18,59,319,83,279,257,395,32081,spokane,99217,2129,2017
spokane,eagle peak at pratt,81,4,0,1,1,4,10,38,24,66,15,101,32081,spokane valley,99212,1567,2017
spokane,ferris high,1742,8,81,9,90,58,141,1269,176,953,789,685,32081,spokane,99223,3412,2017
spokane,finch elementary,545,3,0,0,0,9,47,434,52,282,263,303,32081,spokane,99205,2312,2017
spokane,franklin elementary,415,5,23,0,23,5,42,276,64,210,205,191,32081,spokane,99223,2127,2017
spokane,garfield elementary,458,3,7,5,12,20,59,297,67,243,215,340,32081,spokane,99205,3727,2017
spokane,garry middle,589,11,18,19,37,31,76,337,97,313,276,455,32081,spokane,99207,3758,2017
spokane,glover middle,495,9,11,5,16,18,51,321,80,267,228,384,32081,spokane,99205,3258,2017
spokane,grant elementary,372,4,7,7,14,59,46,167,82,200,172,320,32081,spokane,99202,3729,2017
spokane,hamblen elementary,547,2,7,6,13,8,62,398,64,300,247,236,32081,spokane,99203,3007,2017
spokane,holmes elementary,416,8,6,12,18,15,72,221,82,211,205,367,32081,spokane,99201,2056,2017
spokane,hutton elementary,557,1,8,0,8,13,32,459,44,260,297,104,32081,spokane,99203,2258,2017
spokane,indian trail elementary,341,3,4,1,5,2,31,260,40,182,159,131,32081,spokane,99208,3506,2017
spokane,jefferson elementary,506,0,4,0,4,7,44,397,54,278,228,187,32081,spokane,99203,2111,2017
spokane,lewis & clark high,1884,21,89,40,129,85,150,1297,202,916,968,617,32081,spokane,99204,2172,2017
spokane,libby center,338,1,26,0,26,2,22,256,31,175,163,76,32081,spokane,99202,2401,2017
spokane,lidgerwood elementary,442,7,13,21,34,12,58,244,87,225,217,377,32081,spokane,99208,2952,2017
spokane,lincoln heights elementary,499,5,14,2,16,18,50,347,63,258,241,313,32081,spokane,99223,2951,2017
spokane,linwood elementary,516,2,1,25,26,11,55,315,107,243,273,373,32081,spokane,99208,3190,2017
spokane,logan elementary,404,7,10,14,24,22,63,218,70,195,209,391,32081,spokane,99207,3719,2017
spokane,longfellow elementary,543,7,8,4,12,6,56,339,123,270,273,439,32081,spokane,99207,3718,2017
spokane,madison elementary,361,1,10,0,10,2,35,268,45,178,183,275,32081,spokane,99205,2708,2017
spokane,moran prairie elementary,527,0,15,0,15,13,28,436,35,282,245,109,32081,spokane,99223,4389,2017
spokane,mullan road elementary,617,2,14,3,17,13,46,482,57,328,289,176,32081,spokane,99223,4035,2017
spokane,north central high,1492,28,36,20,56,45,160,1011,192,783,709,751,32081,spokane,99205,2106,2017
spokane,on track academy,343,6,5,2,7,10,38,236,46,178,165,265,32081,spokane,99207,5250,2017
spokane,open doors youth re-engagement spokane,157,5,1,0,1,2,27,93,29,90,67,87,32081,spokane,99201,5344,2017
spokane,regal elementary,484,10,12,9,21,14,46,307,86,261,223,444,32081,spokane,99207,2096,2017
spokane,ridgeview elementary,355,4,6,2,8,4,42,239,58,176,179,249,32081,spokane,99205,2950,2017
spokane,rogers high,1603,37,67,79,146,71,197,934,218,833,770,1161,32081,spokane,99207,2479,2017
spokane,roosevelt elementary,530,3,22,9,31,35,55,338,68,258,272,338,32081,spokane,99204,2086,2017
spokane,sacajawea middle,782,6,22,8,30,38,62,562,84,383,399,240,32081,spokane,99203,3356,2017
spokane,sacred heart hospital,4,1,0,0,0,0,1,2,0,2,2,2,32081,spokane,99204,4286,2017
spokane,salk middle,713,9,4,6,10,7,77,521,89,352,361,363,32081,spokane,99208,3413,2017
spokane,sccp images,46,0,2,0,2,3,5,30,6,30,16,23,32081,spokane,99217,1698,2017
spokane,shadle park high,1348,18,16,5,21,23,106,1030,150,725,623,626,32081,spokane,99205,3189,2017
spokane,shaw middle,571,22,27,28,55,32,67,317,78,308,263,491,32081,spokane,99207,3257,2017
spokane,sheridan elementary,467,9,39,3,42,21,54,277,64,245,222,413,32081,spokane,99202,2110,2017
spokane,spokane public montessori,463,7,5,1,6,5,33,353,59,225,238,147,32081,spokane,99205,5361,2017
spokane,spokane regional health district,131,1,0,2,2,4,4,116,4,79,52,0,32081,spokane,99201,5113,2017
spokane,stevens elementary,491,16,16,45,61,32,63,224,95,246,245,411,32081,spokane,99202,2108,2017
spokane,the community,157,1,0,0,0,3,4,136,13,58,99,78,32081,spokane,99205,5301,2017
spokane,westview elementary,490,1,3,8,11,2,47,346,83,248,242,322,32081,spokane,99205,3063,2017
spokane,whitman elementary,559,2,8,35,43,14,82,339,79,287,272,476,32081,spokane,99207,2191,2017
spokane,willard elementary,575,16,2,0,2,27,55,397,78,295,280,436,32081,spokane,99205,2109,2017
spokane,wilson elementary,364,2,6,0,6,2,19,291,44,176,188,57,32081,spokane,99203,2296,2017
spokane,woodridge elementary,480,14,7,4,11,4,37,363,51,244,236,156,32081,spokane,99208,4192,2017
lincoln,sprague elementary,45,0,0,0,0,0,3,42,0,18,27,29,22008,sprague,99032,3050,2017
lincoln,sprague high,30,1,1,0,1,0,2,26,0,13,17,18,22008,sprague,99032,2186,2017
whitman,st john elementary,69,0,0,0,0,0,7,59,3,34,35,22,38322,saint john,99171,3069,2017
whitman,st john/endicott high,86,0,2,0,2,0,1,82,1,42,44,30,38322,saint john,99171,3068,2017
snohomish,cedarhome elementary,513,4,6,3,9,3,45,421,31,262,251,107,31401,stanwood,98292,4513,2017
snohomish,elger bay elementary,284,2,0,1,1,2,26,236,17,153,131,100,31401,camano island,98282,4553,2017
snohomish,lincoln academy,15,0,0,0,0,0,1,10,4,9,6,11,31401,stanwood,98292,5108,2017
snohomish,lincoln hill high,135,0,0,1,1,0,16,111,7,72,63,56,31401,stanwood,98292,1707,2017
snohomish,port susan middle,500,3,13,0,13,4,46,409,25,264,236,122,31401,stanwood,98292,4512,2017
snohomish,saratoga,173,1,1,0,1,3,11,146,11,78,95,21,31401,stanwood,98292,5004,2017
snohomish,stanwood elementary,466,8,5,2,7,1,39,384,27,243,223,157,31401,stanwood,98292,3125,2017
snohomish,stanwood high,1376,14,15,5,20,17,93,1172,60,689,687,262,31401,stanwood,98292,2581,2017
snohomish,stanwood middle,480,3,3,2,5,2,63,382,25,261,219,133,31401,stanwood,98292,2400,2017
snohomish,twin city elementary,344,7,6,4,10,1,56,251,19,182,162,136,31401,stanwood,98292,4364,2017
snohomish,utsalady elementary,312,1,6,0,6,2,26,270,7,167,145,64,31401,camano island,98282,4551,2017
franklin,star elem,15,0,0,0,0,0,9,6,0,5,10,0,11054,richland,99352,2007,2017
columbia,starbuck,25,0,0,0,0,0,0,25,0,9,16,0,07035,starbuck,99359,2135,2017
chelan,stehekin elementary,6,0,0,0,0,0,0,6,0,1,5,0,04069,stehekin,98852,2265,2017
pierce,anderson island elementary,34,0,0,0,0,0,6,26,2,21,13,22,27001,steilacoom,98388,2040,2017
pierce,birth to three,20,0,1,0,1,2,1,11,5,13,7,5,27001,steilacoom,98388,5389,2017
pierce,cherrydale elementary,359,2,10,6,16,20,68,173,80,184,175,138,27001,steilacoom,98388,3446,2017
pierce,chloe clark elementary,592,2,41,9,50,42,113,297,88,334,258,67,27001,dupont,98327,4562,2017
pierce,futures program,2,0,0,2,2,0,0,0,0,0,2,0,27001,steilacoom,98388,5410,2017
pierce,pioneer middle,806,5,60,25,85,71,131,386,128,418,388,182,27001,dupont,98327,2237,2017
pierce,saltars point elementary,429,0,30,5,35,36,65,225,68,219,210,82,27001,steilacoom,98388,3827,2017
pierce,steilacoom high,958,7,90,25,115,77,138,474,147,493,465,170,27001,steilacoom,98388,4131,2017
whitman,steptoe elementary,43,2,0,0,0,0,4,37,0,18,25,0,38304,steptoe,99174,2115,2017
skamania,carson elementary,282,6,1,1,2,1,43,215,15,157,125,127,30303,stevenson,98648,2882,2017
skamania,preschool,21,0,0,0,0,0,4,15,2,13,8,9,30303,stevenson,98648,1765,2017
skamania,stevenson elementary,148,1,0,0,0,2,18,117,10,74,74,68,30303,stevenson,98648,2682,2017
skamania,stevenson high,322,6,4,1,5,2,46,245,18,177,145,126,30303,stevenson,98648,3119,2017
skamania,wind river middle,121,3,0,0,0,2,16,96,4,63,58,52,30303,stevenson,98648,3800,2017
snohomish,gold bar elementary,331,0,0,0,0,3,77,246,5,185,146,215,31311,gold bar,98251,4399,2017
snohomish,open doors youth reengagement sultan,4,0,0,0,0,0,0,4,0,1,3,2,31311,sultan,98296,5329,2017
snohomish,student services,28,0,0,0,0,0,5,22,1,14,14,13,31311,sultan,98294,1670,2017
snohomish,sultan elementary,533,2,13,1,14,6,101,373,37,271,262,290,31311,sultan,98294,2229,2017
snohomish,sultan middle,451,4,7,0,7,5,89,336,10,244,207,246,31311,sultan,98294,2105,2017
snohomish,sultan senior high,578,14,9,0,9,5,103,431,16,304,274,266,31311,sultan,98294,4274,2017
pierce,summit public school: olympus,134,3,6,3,9,26,37,42,17,68,66,75,27905,seattle,98134,5376,2017
king,summit public school: sierra,190,3,27,0,27,81,12,46,21,91,99,89,17902,seattle,98134,5375,2017
stevens,summit valley,65,0,0,0,0,0,3,58,4,32,33,51,33202,addy,99101,4394,2017
pierce,bonney lake elementary,536,3,9,1,10,8,54,411,50,271,265,176,27320,bonney lake,98390,3349,2017
pierce,bonney lake high,1427,12,28,9,37,23,163,1073,119,730,697,352,27320,bonney lake,98391,4585,2017
pierce,crestwood elementary,461,3,7,0,7,6,39,358,48,252,209,128,27320,bonney lake,98390,4435,2017
pierce,daffodil valley elementary,531,3,14,0,14,0,165,313,36,260,271,352,27320,sumner,98390,4541,2017
pierce,eismann elementary,606,5,12,2,14,5,54,462,66,288,318,64,27320,bonney lake,98391,3399,2017
pierce,emerald hills elementary,446,5,12,0,12,5,47,328,49,235,211,118,27320,bonney lake,98390,4250,2017
pierce,lakeridge middle,597,1,12,1,13,4,55,471,53,303,294,149,27320,bonney lake,98391,4132,2017
pierce,liberty ridge elementary,446,1,4,3,7,5,62,322,49,215,231,248,27320,sumner,98390,4402,2017
pierce,maple lawn elementary,646,2,9,7,16,9,107,454,58,334,312,224,27320,sumner,98390,2875,2017
pierce,mountain view middle,640,7,6,2,8,6,90,464,65,320,320,195,27320,bonney lake,98390,4502,2017
pierce,sumner high,1874,19,42,6,48,12,234,1429,132,953,921,404,27320,sumner,98390,3247,2017
pierce,sumner middle,781,7,21,0,21,9,175,495,74,394,387,324,27320,sumner,98390,3499,2017
pierce,sumner special services,31,1,0,0,0,0,3,27,0,17,14,15,27320,sumner,98390,1781,2017
pierce,victor falls elementary,586,2,7,1,8,4,53,476,43,306,280,142,27320,bonney lake,98391,4166,2017
yakima,chief kamiakin elementary,746,0,0,0,0,1,686,52,7,399,347,704,39201,sunnyside,98944,4000,2017
yakima,harrison middle,891,1,0,0,0,1,822,52,15,453,438,723,39201,sunnyside,98944,3313,2017
yakima,outlook elementary,604,0,0,0,0,0,569,30,5,313,291,576,39201,sunnyside,98944,2469,2017
yakima,pioneer elementary,744,0,0,0,0,0,681,53,10,379,365,641,39201,sunnyside,98944,4497,2017
yakima,shs graduation alliance,5,0,0,0,0,0,5,0,0,1,4,4,39201,sunnyside,98944,5352,2017
yakima,sierra vista middle,690,0,0,0,0,0,631,50,9,363,327,610,39201,sunnyside,98944,5049,2017
yakima,sun valley elementary,505,0,1,0,1,0,470,32,2,253,252,451,39201,sunnyside,98944,5137,2017
yakima,sunnyside high,1920,0,0,0,0,3,1751,151,15,991,929,1511,39201,sunnyside,98944,2959,2017
yakima,washington elementary,731,0,0,0,0,0,675,50,6,379,352,569,39201,sunnyside,98944,2717,2017
kitsap,chief kitsap academy,74,30,0,2,2,2,13,7,18,44,30,44,18902,poulsbo,98370,5319,2017
pierce,angelo giaudrone middle,657,10,78,28,106,160,128,202,51,329,328,464,27010,tacoma,98408,4575,2017
pierce,arlington,272,5,11,21,32,48,71,83,33,145,127,216,27010,tacoma,98409,2940,2017
pierce,baker,718,5,123,34,157,137,191,168,60,366,352,540,27010,tacoma,98408,3054,2017
pierce,birney,436,5,33,10,43,73,134,127,54,219,217,336,27010,tacoma,98408,3449,2017
pierce,blix elementary,523,6,56,22,78,77,181,135,46,277,246,435,27010,tacoma,98404,2094,2017
pierce,boze,390,6,76,20,96,67,137,57,27,214,176,320,27010,tacoma,98404,3646,2017
pierce,browns point,428,2,41,1,42,22,48,251,63,218,210,74,27010,tacoma,98422,2872,2017
pierce,bryant,478,13,14,10,24,52,50,285,54,228,250,202,27010,tacoma,98405,3397,2017
pierce,comm based trans program,61,1,7,1,8,11,5,32,4,35,26,38,27010,tacoma,98405,1585,2017
pierce,crescent heights,483,4,55,14,69,50,75,237,48,248,235,159,27010,tacoma,98422,4537,2017
pierce,day reporting,21,1,2,0,2,3,5,9,1,13,8,15,27010,tacoma,98406,1797,2017
pierce,delong,418,7,26,11,37,113,73,162,26,207,211,267,27010,tacoma,98405,2939,2017
pierce,downing,311,5,16,2,18,42,44,167,35,155,156,150,27010,tacoma,98406,2747,2017
pierce,edison,467,4,30,17,47,98,125,138,55,238,229,385,27010,tacoma,98409,2871,2017
pierce,fawcett,446,3,57,8,65,45,108,157,68,228,218,305,27010,tacoma,98404,2772,2017
pierce,fern hill,312,2,28,25,53,28,82,89,58,155,157,226,27010,tacoma,98444,2167,2017
pierce,first creek middle,790,21,128,40,168,170,253,137,41,415,375,641,27010,tacoma,98404,5170,2017
pierce,foss,796,6,116,34,150,181,154,249,56,421,375,472,27010,tacoma,98405,3880,2017
pierce,franklin,314,4,10,3,13,54,57,121,65,172,142,245,27010,tacoma,98405,2148,2017
pierce,fresh start,381,4,24,6,30,84,83,153,27,190,191,171,27010,tacoma,98405,5307,2017
pierce,geiger,445,3,31,9,40,36,76,228,62,224,221,193,27010,tacoma,98465,2746,2017
pierce,grant,382,1,8,1,9,41,49,233,49,187,195,127,27010,tacoma,98406,3053,2017
pierce,gray,553,2,58,31,89,140,137,150,35,279,274,421,27010,tacoma,98409,2377,2017
pierce,helen b. stafford elementary,514,4,114,23,137,72,137,96,68,261,253,407,27010,tacoma,98444,5066,2017
pierce,industrial design engineering and art,124,1,13,3,16,19,15,71,2,92,32,44,27010,tacoma,98444,5458,2017
pierce,jason lee,536,10,30,11,41,160,72,229,23,269,267,323,27010,tacoma,98403,2338,2017
pierce,jefferson,280,1,7,1,8,29,44,161,37,130,150,147,27010,tacoma,98406,2103,2017
pierce,larchmont,372,5,46,8,54,67,101,99,46,203,169,285,27010,tacoma,98445,2036,2017
pierce,lincoln,1509,27,226,71,297,352,368,344,121,789,720,989,27010,tacoma,98418,2215,2017
pierce,lister,486,11,60,24,84,84,112,88,107,241,245,421,27010,tacoma,98404,2771,2017
pierce,lowell,442,1,10,3,13,21,47,322,38,221,221,77,27010,tacoma,98403,2805,2017
pierce,lyon,360,5,32,7,39,35,107,115,59,188,172,302,27010,tacoma,98404,2336,2017
pierce,madison headstart,4,0,1,0,1,1,0,1,1,3,1,14,27010,tacoma,98409,2335,2017
pierce,manitou park,487,3,29,12,41,79,186,117,61,241,246,383,27010,tacoma,98409,2252,2017
pierce,mann,483,6,29,10,39,79,99,176,84,262,221,340,27010,tacoma,98408,2941,2017
pierce,mason,791,8,57,5,62,71,60,563,27,407,384,235,27010,tacoma,98407,2376,2017
pierce,mccarver,409,6,26,8,34,153,55,90,71,206,203,394,27010,tacoma,98405,3453,2017
pierce,meeker,647,12,74,16,90,73,65,367,40,349,298,179,27010,tacoma,98422,3244,2017
pierce,mt tahoma,1480,27,241,69,310,275,365,406,97,783,697,926,27010,tacoma,98409,3398,2017
pierce,northeast tacoma,392,1,36,11,47,33,85,166,60,209,183,187,27010,tacoma,98422,2247,2017
pierce,oakland high,219,5,2,5,7,67,45,63,31,98,121,195,27010,tacoma,98409,4109,2017
pierce,pearl street center,11,0,0,0,0,1,0,9,1,6,5,10,27010,tacoma,98465,4283,2017
pierce,point defiance,438,5,17,1,18,31,50,297,37,246,192,172,27010,tacoma,98407,2169,2017
pierce,reed,487,2,32,37,69,101,159,69,87,257,230,393,27010,tacoma,98418,2806,2017
pierce,roosevelt,269,6,17,13,30,51,93,52,37,145,124,238,27010,tacoma,98404,2275,2017
pierce,science and math institute,465,3,39,4,43,57,50,299,13,243,222,152,27010,tacoma,98407,5169,2017
pierce,sheridan,569,12,72,18,90,77,245,87,58,282,287,463,27010,tacoma,98404,2168,2017
pierce,sherman,425,1,8,0,8,20,36,327,33,211,214,73,27010,tacoma,98407,2938,2017
pierce,skyline,377,3,15,2,17,53,48,208,48,194,183,223,27010,tacoma,98406,3498,2017
pierce,special services,61,2,2,0,2,10,5,38,4,43,18,48,27010,tacoma,98405,5192,2017
pierce,stadium,1463,24,171,21,192,174,174,834,65,718,745,409,27010,tacoma,98403,2084,2017
pierce,stanley,290,5,6,16,22,89,45,77,52,151,139,235,27010,tacoma,98405,2358,2017
pierce,stewart,329,9,42,9,51,64,75,113,17,173,156,257,27010,tacoma,98465,2359,2017
pierce,tacoma school of the arts,473,9,27,7,34,87,70,259,14,149,324,158,27010,tacoma,98402,1860,2017
pierce,truman,801,9,70,11,81,139,114,436,22,397,404,441,27010,tacoma,98407,3448,2017
pierce,wainwright,268,2,16,3,19,57,41,127,22,142,126,133,27010,tacoma,98466,3116,2017
pierce,washington elementary,473,0,16,1,17,22,50,336,48,227,246,92,27010,tacoma,98407,2083,2017
pierce,whitman,420,5,46,23,69,73,76,125,72,211,209,331,27010,tacoma,98408,2874,2017
pierce,whittier,369,2,22,4,26,55,66,143,77,173,196,183,27010,tacoma,98466,3452,2017
pierce,wilson,1301,15,105,17,122,211,113,765,75,675,626,435,27010,tacoma,98406,3246,2017
grays harbor,taholah elementary & middle,115,85,0,0,0,0,18,0,12,64,51,72,14077,taholah,98587,5032,2017
grays harbor,taholah high,55,44,0,0,0,0,5,0,6,28,27,36,14077,taholah,98587,3580,2017
king,glacier park elementary,1002,0,52,11,63,19,101,720,99,524,478,91,17409,maple valley,98038,4453,2017
king,lake wilderness elementary,1205,2,55,7,62,14,112,867,148,653,552,178,17409,maple valley,98038,3286,2017
king,rock creek elementary,1003,5,26,9,35,24,83,778,78,543,460,111,17409,maple valley,98038,4415,2017
king,shadow lake elementary,699,4,32,13,45,8,93,479,70,369,330,124,17409,maple valley,98038,3589,2017
king,tahoma senior high,1829,7,71,7,78,46,177,1404,117,957,872,149,17409,maple valley,98038,2849,2017
whitman,tekoa elementary,101,4,0,0,0,1,11,83,2,48,53,48,38265,tekoa,99033,2052,2017
whitman,tekoa high,94,5,0,0,0,1,6,82,0,50,44,55,38265,tekoa,99033,3418,2017
thurston,parkside elementary,322,4,1,0,1,1,33,265,18,188,134,179,34402,tenino,98589,2457,2017
thurston,tenino elementary,287,1,1,0,1,0,20,247,18,159,128,149,34402,tenino,98589,4238,2017
thurston,tenino high,370,6,1,1,2,0,19,335,8,179,191,143,34402,tenino,98589,3509,2017
thurston,tenino middle,267,4,1,0,1,1,20,230,11,154,113,120,34402,tenino,98589,3795,2017
kittitas,thorp elem & jr sr high,142,2,0,0,0,0,9,126,5,76,66,61,19400,thorp,98946,2514,2017
lewis,cowlitz prairie academy,38,2,0,0,0,0,1,32,3,13,25,26,21237,toledo,98591,5190,2017
lewis,toledo elementary,318,10,3,0,3,2,27,272,4,187,131,161,21237,toledo,98591,2998,2017
lewis,toledo high,250,4,3,0,3,1,27,198,17,132,118,99,21237,toledo,98591,2616,2017
lewis,toledo middle,177,1,0,1,1,1,22,140,12,86,91,90,21237,toledo,98591,3977,2017
okanogan,tonasket elementary,562,5,0,0,0,3,220,307,27,284,278,378,24404,tonasket,98855,3176,2017
okanogan,tonasket high,340,4,0,0,0,0,107,219,10,190,150,194,24404,tonasket,98855,2679,2017
okanogan,tonasket middle,275,0,2,1,3,0,108,155,9,142,133,166,24404,tonasket,98855,4196,2017
yakima,computer academy toppenish high,152,30,0,0,0,1,109,11,1,88,64,148,39202,toppenish,98948,1508,2017
yakima,garfield elementary,405,43,1,0,1,1,351,6,3,201,204,383,39202,toppenish,98948,2608,2017
yakima,kirkwood elementary,658,138,3,0,3,1,499,10,7,336,322,582,39202,toppenish,98948,4106,2017
yakima,lincoln elementary,419,61,0,0,0,0,345,7,6,217,202,361,39202,toppenish,98948,2635,2017
yakima,nw allprep,685,13,30,0,30,11,52,574,5,343,342,157,39202,vancouver,98684,5262,2017
yakima,toppenish high,923,103,0,0,0,0,791,25,4,447,476,794,39202,toppenish,98948,2900,2017
yakima,toppenish middle,884,120,0,0,0,1,735,18,10,449,435,772,39202,toppenish,98948,2264,2017
yakima,toppenish pre,56,11,0,0,0,0,41,4,0,36,20,61,39202,toppenish,98948,1831,2017
walla walla,touchet elem & high,204,3,0,0,0,0,107,92,2,109,95,123,36300,touchet,99360,2160,2017
cowlitz,toutle lake elementary,356,4,2,0,2,1,26,307,16,190,166,137,08130,toutle,98649,4264,2017
cowlitz,toutle lake high,302,2,4,0,4,2,21,265,8,160,142,106,08130,toutle,98649,2560,2017
klickitat,trout lake elementary,67,1,1,0,1,2,5,53,5,31,36,0,20400,trout lake,98650,3062,2017
klickitat,trout lake,139,4,3,0,3,0,23,99,10,65,74,0,20400,trout lake,98650,2676,2017
king,cascade view elementary,486,4,162,11,173,67,163,59,20,252,234,422,17406,tukwila,98168,3226,2017
king,foster senior high,934,8,301,42,343,181,236,121,45,486,448,585,17406,tukwila,98168,2848,2017
king,showalter middle,637,5,192,23,215,114,197,74,32,337,300,459,17406,tukwila,98168,2564,2017
king,thorndyke elementary,396,9,60,18,78,117,126,36,30,208,188,333,17406,tukwila,98168,3635,2017
king,tukwila elementary,537,2,127,16,143,107,144,70,71,249,288,351,17406,tukwila,98168,3488,2017
thurston,a g west black hills high,871,6,35,5,40,21,73,656,75,460,411,186,34033,tumwater,98512,4500,2017
thurston,black lake elementary,531,3,14,2,16,1,54,403,54,258,273,145,34033,olympia,98512,4205,2017
thurston,east olympia elementary,577,2,5,0,5,4,77,434,55,298,279,172,34033,olympia,98501,4365,2017
thurston,george washington bush middle,529,3,9,3,12,7,60,407,40,271,258,151,34033,tumwater,98512,4452,2017
thurston,littlerock elementary,338,4,7,3,10,2,41,246,35,179,159,118,34033,olympia,98512,2816,2017
thurston,michael t simmons elementary,692,1,22,3,25,16,87,500,63,381,311,283,34033,tumwater,98512,2552,2017
thurston,new market high,60,1,1,0,1,1,6,48,3,40,20,16,34033,tumwater,98501,5014,2017
thurston,peter g schmidt elementary,660,2,11,1,12,8,97,467,74,341,319,260,34033,tumwater,98501,3199,2017
thurston,secondary options,146,2,1,0,1,3,16,116,8,74,72,35,34033,olympia,98512,1713,2017
thurston,tumwater high,1245,9,28,7,35,21,148,933,98,656,589,301,34033,tumwater,98501,3362,2017
thurston,tumwater hill elementary,473,1,45,2,47,8,67,298,52,246,227,136,34033,tumwater,98512,4373,2017
thurston,tumwater middle,480,7,22,6,28,9,53,318,65,225,255,130,34033,tumwater,98512,3612,2017
yakima,union gap,648,11,6,0,6,1,510,108,12,333,315,563,39002,union gap,98903,2714,2017
pierce,chambers elementary,502,2,47,7,54,60,97,213,76,252,250,225,27083,university pla,98467,3792,2017
pierce,curtis junior high,946,6,107,6,113,86,124,470,147,493,453,325,27083,university place,98466,3179,2017
pierce,curtis senior high,1478,12,170,14,184,137,152,785,208,733,745,434,27083,university place,98466,3600,2017
pierce,drum intermediate,619,3,52,9,61,66,89,292,108,296,323,226,27083,university pla,98467,4325,2017
pierce,evergreen primary,526,0,52,6,58,39,91,215,123,261,265,204,27083,university place,98466,4447,2017
pierce,narrows view intermediate,685,5,60,4,64,57,107,344,108,365,320,271,27083,university pla,98466,3296,2017
pierce,sunset primary,422,1,32,7,39,30,55,221,76,237,185,159,27083,university place,98466,3601,2017
pierce,university place primary,533,1,22,2,24,47,78,274,109,278,255,252,27083,university pla,98466,2223,2017
stevens,columbia virtual academy,491,1,26,2,28,8,62,357,35,239,252,0,33070,valley,99181,1932,2017
stevens,paideia high,60,0,1,0,1,0,10,43,6,37,23,28,33070,valley,99181,5223,2017
stevens,valley early learning center,3,0,0,0,0,0,0,3,0,2,1,1,33070,valley,99181,5357,2017
stevens,valley,206,5,1,0,1,1,15,171,13,111,95,153,33070,valley,99181,2405,2017
clark,alki middle,686,2,26,3,29,9,59,537,50,356,330,163,06037,vancouver,98685,4406,2017
clark,benjamin franklin elementary,374,1,43,0,43,6,43,218,63,179,195,65,06037,vancouver,98663,3080,2017
clark,chinook elementary,718,2,20,2,22,3,80,545,66,362,356,135,06037,vancouver,98685,4405,2017
clark,columbia river high,1220,10,42,7,49,10,166,895,90,604,616,268,06037,vancouver,98665,3423,2017
clark,discovery middle,659,1,12,13,25,30,255,300,48,325,334,455,06037,vancouver,98663,4503,2017
clark,dwight d eisenhower elementary,566,3,25,7,32,8,95,369,59,294,272,236,06037,vancouver,98665,3733,2017
clark,early childhood education center,241,0,8,1,9,4,68,123,37,164,77,168,06037,vancouver,98668,2636,2017
clark,felida elementary,694,1,29,2,31,8,63,541,50,351,343,99,06037,vancouver,98685,4075,2017
clark,fir grove childrens center,58,3,0,0,0,3,13,36,3,50,8,46,06037,vancouver,98661,1574,2017
clark,fort vancouver high,1542,7,64,69,133,63,607,665,67,771,771,985,06037,vancouver,98661,2179,2017
clark,fruit valley elementary,288,1,5,10,15,6,139,102,25,133,155,246,06037,vancouver,98680,2637,2017
clark,gaiser middle,892,8,28,21,49,43,260,472,60,440,452,478,06037,vancouver,98665,3902,2017
clark,gate program,30,2,1,0,1,1,3,21,2,18,12,9,06037,vancouver,98661,1738,2017
clark,george c marshall elementary,401,5,4,18,22,10,130,208,26,199,202,277,06037,vancouver,98661,3424,2017
clark,harney elementary,684,9,8,18,26,12,292,300,45,348,336,388,06037,vancouver,98661,2643,2017
clark,harry s truman elementary,575,1,25,19,44,28,131,309,62,283,292,358,06037,vancouver,98661,3735,2017
clark,hazel dell elementary,487,1,7,1,8,15,167,253,43,259,228,314,06037,vancouver,98665,2690,2017
clark,hough elementary,315,0,6,1,7,7,63,209,29,156,159,173,06037,vancouver,98660,2610,2017
clark,hudson's bay high,1313,13,26,28,54,47,395,718,86,697,616,727,06037,vancouver,98663,3081,2017
clark,jason lee middle,668,3,39,6,45,18,146,398,58,360,308,297,06037,vancouver,98665,3543,2017
clark,jefferson middle,830,6,18,5,23,15,98,631,57,418,412,210,06037,vancouver,98685,4591,2017
clark,lake shore elementary,426,1,15,1,16,5,47,329,28,241,185,107,06037,vancouver,98665,3017,2017
clark,lewis and clark high,86,1,2,0,2,1,20,58,4,37,49,48,06037,vancouver,98661,3932,2017
clark,lincoln elementary,405,3,8,2,10,12,92,255,33,223,182,226,06037,vancouver,98660,2318,2017
clark,martin luther king elementary,492,2,9,25,34,18,242,149,47,227,265,410,06037,vancouver,98661,3734,2017
clark,mcloughlin middle,997,2,33,54,87,34,486,320,68,485,512,727,06037,vancouver,98661,3146,2017
clark,minnehaha elementary,544,1,14,15,29,14,116,348,36,269,275,323,06037,vancouver,98663,2723,2017
clark,open doors vancouver,76,0,1,3,4,1,25,40,6,45,31,31,06037,vancouver,98668,5342,2017
clark,peter s ogden elementary,552,4,17,22,39,15,232,210,52,295,257,394,06037,vancouver,98662,2644,2017
clark,roosevelt elementary,641,2,21,47,68,13,324,189,45,339,302,567,06037,vancouver,98661,4410,2017
clark,sacajawea elementary,412,0,5,2,7,9,96,256,44,229,183,221,06037,vancouver,98685,4034,2017
clark,salmon creek elementary,509,2,23,0,23,10,57,379,38,254,255,149,06037,vancouver,98685,2964,2017
clark,sarah j anderson elementary,791,3,14,5,19,19,311,383,56,417,374,448,06037,vancouver,98686,3016,2017
clark,skyview high,1963,5,102,9,111,55,257,1389,146,1045,918,412,06037,vancouver,98685,4504,2017
clark,vancouver home connection,210,0,2,0,2,0,15,183,10,99,111,72,06037,vancouver,98668,3556,2017
clark,vancouver itech preparatory,366,3,10,5,15,8,50,260,30,248,118,94,06037,vancouver,98668,5271,2017
clark,vancouver school of arts and academics,590,6,16,5,21,9,64,453,37,192,398,109,06037,vancouver,98663,1689,2017
clark,vancouver virtual learning academy,432,5,6,11,17,12,91,273,34,250,182,241,06037,vancouver,98668,5149,2017
clark,walnut grove elementary,757,5,35,14,49,23,193,421,66,374,383,488,06037,vancouver,98661,2828,2017
clark,washington elementary,354,1,4,9,13,8,168,135,29,178,176,282,06037,vancouver,98663,3565,2017
king,chautauqua elementary,556,0,4,0,4,4,87,402,59,293,263,151,17402,vashon,98070,4468,2017
king,family link,46,0,1,0,1,0,0,39,6,24,22,9,17402,vashon,98070,1822,2017
king,mcmurray middle,402,0,7,1,8,3,43,307,41,230,172,73,17402,vashon,98070,3667,2017
king,student link,22,0,2,0,2,0,2,15,3,8,14,12,17402,vashon,98070,1938,2017
king,vashon island high,594,5,21,0,21,6,57,458,47,309,285,101,17402,vashon,98070,2419,2017
wahkiakum,julius a wendt elementary/john c thomas middle,318,3,0,2,2,2,24,269,18,165,153,193,35200,cathlamet,98612,2893,2017
wahkiakum,wahkiakum high,123,1,3,0,3,2,14,100,3,61,62,65,35200,cathlamet,98612,3467,2017
grant,developmental pre-school,11,0,0,0,0,0,11,0,0,10,1,11,13073,mattawa,99349,1981,2017
grant,mattawa elementary pre-school,11,0,0,0,0,0,11,0,0,11,0,16,13073,mattawa,99349,5120,2017
grant,wahluke high,562,5,0,0,0,0,528,27,2,262,300,515,13073,mattawa,99349,4254,2017
walla walla,preston hall middle,57,0,0,0,0,0,8,46,3,32,25,40,36401,waitsburg,99361,2174,2017
walla walla,waitsburg elementary,126,1,3,0,3,0,21,96,5,69,57,74,36401,waitsburg,99361,2712,2017
walla walla,waitsburg high,116,0,2,0,2,0,10,99,5,65,51,40,36401,waitsburg,99361,2386,2017
walla walla,alternative education program,88,0,0,0,0,1,26,61,0,43,45,26,36140,walla walla,99362,2407,2017
walla walla,berney elementary,413,0,6,1,7,3,67,314,22,227,186,185,36140,walla walla,99362,2074,2017
walla walla,blue ridge elementary,368,0,1,1,2,6,261,91,8,191,177,322,36140,walla walla,99362,4193,2017
walla walla,edison elementary school - walla walla,423,4,3,0,3,1,237,165,13,221,202,314,36140,walla walla,99362,2528,2017
walla walla,garrison middle,587,1,7,3,10,5,242,312,17,291,296,303,36140,walla walla,99362,3510,2017
walla walla,green park elementary,426,1,2,0,2,3,171,231,18,218,208,280,36140,walla walla,99362,2078,2017
walla walla,lincoln high,195,1,0,0,0,0,33,154,7,105,90,158,36140,walla walla,99362,4071,2017
walla walla,opportunity youth reengagement,66,2,1,0,1,0,37,25,1,32,34,25,36140,walla walla,99362,5460,2017
walla walla,pioneer middle,677,1,15,2,17,5,260,374,20,336,341,366,36140,walla walla,99362,2780,2017
walla walla,prospect point elementary,432,1,6,0,6,1,72,338,14,235,197,153,36140,walla walla,99362,2159,2017
walla walla,sharpstein elementary,461,3,3,0,3,3,212,217,23,238,223,272,36140,walla walla,99362,3728,2017
walla walla,walla walla high,1724,13,29,4,33,24,609,986,59,820,904,771,36140,walla walla,99362,3468,2017
yakima,adams elementary,338,67,3,0,3,0,239,16,13,197,141,329,39207,wapato,98951,4518,2017
yakima,camas elementary,643,146,15,0,15,0,445,12,25,342,301,610,39207,wapato,98951,5544,2017
yakima,pace alternative high,62,25,0,0,0,0,34,3,0,46,16,61,39207,wapato,98951,4022,2017
yakima,satus elementary,654,96,3,0,3,0,519,17,19,353,301,628,39207,wapato,98951,2757,2017
yakima,wapato high,834,151,19,2,21,1,603,31,27,401,433,635,39207,wapato,98951,3141,2017
yakima,wapato middle,788,180,13,1,14,0,549,24,21,417,371,689,39207,wapato,98951,2131,2017
grant,warden elementary,494,0,0,0,0,3,405,83,3,238,256,443,13146,warden,98857,2792,2017
grant,warden high,298,0,2,0,2,0,237,54,5,154,144,205,13146,warden,98857,3273,2017
grant,warden middle,205,0,0,0,0,1,162,40,2,90,115,167,13146,warden,98857,3909,2017
clark,canyon creek middle,232,2,5,1,6,1,11,199,13,125,107,44,06112,washougal,98671,4549,2017
clark,cape horn skye elementary,403,2,2,0,2,3,22,353,21,212,191,113,06112,washougal,98671,3270,2017
clark,gause elementary,615,1,5,0,5,5,72,491,41,332,283,180,06112,washougal,98671,2911,2017
clark,hathaway elementary,418,4,0,3,3,1,52,328,30,198,220,251,06112,washougal,98671,2509,2017
clark,jemtegaard middle,522,1,5,2,7,2,67,406,39,262,260,203,06112,washougal,98671,4207,2017
clark,washougal high,983,4,27,1,28,9,97,789,56,518,465,261,06112,washougal,98671,3147,2017
clark,washougal special services,25,0,0,0,0,0,0,21,4,15,10,12,06112,washougal,98671,1899,2017
adams,washtucna elementary/high,49,0,0,0,0,0,5,44,0,29,20,37,01109,washtucna,99371,3075,2017
douglas,waterville elementary,126,5,0,0,0,0,20,97,4,60,66,80,09209,waterville,98858,2161,2017
douglas,waterville high,152,3,1,0,1,0,45,99,4,75,77,74,09209,waterville,98858,2162,2017
stevens,wellpinit elementary,180,141,0,0,0,0,8,6,25,98,82,167,33049,wellpinit,99040,2549,2017
stevens,wellpinit high,82,59,0,0,0,0,9,5,9,45,37,63,33049,wellpinit,99040,2550,2017
stevens,wellpinit middle,80,56,0,0,0,0,6,1,17,41,39,70,33049,wellpinit,99040,4232,2017
chelan,abraham lincoln elementary,501,1,0,0,0,2,382,110,6,262,239,401,04246,wenatchee,98801,3209,2017
chelan,columbia elementary,446,0,1,0,1,3,321,112,9,239,207,388,04246,wenatchee,98801,2301,2017
chelan,foothills middle,586,1,9,0,9,3,250,308,15,307,279,265,04246,wenatchee,98801,4432,2017
chelan,john newbery elementary,518,2,5,0,5,0,209,285,17,276,242,279,04246,wenatchee,98801,4423,2017
chelan,lewis and clark elementary,485,0,2,0,2,1,351,124,7,252,233,372,04246,wenatchee,98801,2279,2017
chelan,mission view elementary,541,1,3,0,3,0,389,146,2,290,251,440,04246,wenatchee,98801,2347,2017
chelan,open doors re-engagement wenatchee,88,2,0,0,0,1,43,42,0,55,33,42,04246,wenatchee,98807,5316,2017
chelan,orchard middle,426,2,1,0,1,1,267,146,9,218,208,302,04246,wenatchee,98801,3370,2017
chelan,pioneer middle,631,6,4,0,4,3,329,275,14,323,308,337,04246,wenatchee,98801,3210,2017
chelan,skill source,2,0,0,0,0,0,1,1,0,1,1,4,04246,wenatchee,98801,1612,2017
chelan,sunnyslope elementary,301,0,7,1,8,0,55,223,15,147,154,57,04246,wenatchee,98801,3208,2017
chelan,valley academy of learning,184,1,2,0,2,2,15,157,7,89,95,21,04246,wenatchee,98801,1742,2017
chelan,washington elementary,573,0,4,1,5,7,183,356,22,303,270,228,04246,wenatchee,98801,2907,2017
chelan,wenatchee high,2083,6,23,2,25,11,926,1052,63,1050,1033,938,04246,wenatchee,98801,2134,2017
chelan,westside high,270,3,0,1,1,2,123,134,7,139,131,132,04246,wenatchee,98801,1613,2017
spokane,centennial middle,616,7,9,0,9,14,62,466,58,340,276,313,32363,spokane,99212,3538,2017
spokane,dishman hills high,319,5,0,2,2,10,35,253,14,167,152,230,32363,spokane,99206,1628,2017
spokane,millwood kindergarten center,191,1,1,0,1,2,17,159,11,106,85,101,32363,spokane,99212,2711,2017
spokane,ness elementary,302,3,0,0,0,8,31,240,20,171,131,196,32363,spokane,99206,3196,2017
spokane,orchard center elementary,262,8,1,1,2,7,19,196,30,138,124,160,32363,spokane,99212,3129,2017
spokane,pasadena park elementary,342,0,8,0,8,4,17,285,28,182,160,126,32363,spokane,99212,3194,2017
spokane,seth woodard elementary,305,1,3,2,5,4,32,237,26,167,138,157,32363,spokane,99212,2956,2017
spokane,spokane valley high,104,1,0,0,0,0,7,86,10,53,51,38,32363,spokane,99212,1838,2017
spokane,spokane valley transition,143,2,0,0,0,1,10,119,11,72,71,81,32363,spokane,99212,1842,2017
spokane,west valley city,220,0,1,0,1,2,17,182,18,88,132,70,32363,spokane,99212,1755,2017
spokane,west valley early learning center,68,1,0,0,0,0,7,53,7,46,22,53,32363,spokane valley,99212,5462,2017
spokane,west valley high,902,6,23,1,24,18,65,709,80,449,453,334,32363,spokane,99212,3195,2017
yakima,ahtanum valley elementary,270,7,0,0,0,3,90,156,14,133,137,171,39208,yakima,98908,2822,2017
yakima,apple valley elementary,333,3,11,0,11,4,90,214,11,167,166,124,39208,yakima,98908,3699,2017
yakima,children's village,15,0,0,0,0,0,5,10,0,9,6,0,39208,yakima,98902,5096,2017
yakima,cottonwood elementary,435,3,15,0,15,5,116,279,17,218,217,139,39208,yakima,98908,4448,2017
yakima,mountainview elementary,174,1,0,0,0,0,52,113,8,90,84,119,39208,yakima,98908,2758,2017
yakima,summitview elementary,324,0,1,1,2,1,139,157,25,148,176,177,39208,yakima,98908,3207,2017
yakima,west valley high,1169,7,34,4,38,8,263,825,28,609,560,407,39208,yakima,98908,3074,2017
yakima,west valley high school freshman campus,409,6,6,2,8,5,124,252,14,221,188,172,39208,yakima,98908,5221,2017
yakima,west valley jr high,850,14,20,1,21,6,250,541,18,419,431,388,39208,yakima,98908,4040,2017
yakima,west valley middle,836,4,26,3,29,2,246,522,33,426,410,373,39208,yakima,98908,4506,2017
yakima,west valley preschool,56,1,0,0,0,0,25,30,0,39,17,0,39208,yakima,98903,5008,2017
yakima,wide hollow elementary,374,2,14,0,14,4,157,184,13,198,176,248,39208,yakima,98908,2505,2017
lewis,white pass elementary,207,2,0,0,0,2,17,185,1,101,106,146,21303,randle,98377,3555,2017
lewis,white pass jr. sr. high,222,3,0,0,0,3,11,201,4,115,107,128,21303,randle,98377,2859,2017
pierce,elk ridge elementary,410,0,3,0,3,1,36,341,29,212,198,106,27416,buckley,98321,2190,2017
pierce,foothills elementary,527,3,8,0,8,6,69,429,12,273,254,212,27416,buckley,98321,4309,2017
pierce,glacier middle,771,6,7,1,8,4,89,623,41,402,369,211,27416,buckley,98321,3458,2017
pierce,mountain meadow elementary,507,3,5,0,5,7,49,407,36,262,245,125,27416,buckley,98321,4471,2017
pierce,white river high,1212,11,11,2,13,7,120,1001,60,641,571,263,27416,buckley,98321,4569,2017
pierce,white river homeschool,2,0,0,0,0,0,0,2,0,0,2,0,27416,buckley,98321,5390,2017
pierce,white river reengagement program,10,0,1,0,1,0,1,8,0,4,6,6,27416,buckley,98321,5338,2017
pierce,white river special ed services,15,0,0,0,0,0,2,12,1,6,9,4,27416,buckley,98321,5045,2017
pierce,wilkeson elementary,265,1,2,0,2,1,21,222,18,140,125,83,27416,wilkeson,98396,4170,2017
klickitat,columbia high,395,6,4,0,4,0,128,251,6,205,190,137,20405,white salmon,98672,2330,2017
klickitat,hulan l whitson elem,417,1,0,0,0,2,140,257,17,221,196,204,20405,white salmon,98672,2997,2017
klickitat,wallace & priscilla stevenson intermediate,282,3,1,1,2,0,84,182,11,160,122,127,20405,white salmon,98672,5368,2017
klickitat,wayne m henkle middle,189,0,1,0,1,0,67,119,2,99,90,92,20405,white salmon,98672,3394,2017
klickitat,white salmon academy,14,0,0,0,0,0,9,5,0,9,5,12,20405,white salmon,98672,5077,2017
lincoln,wilbur elementary,123,4,0,1,1,1,5,98,14,62,61,52,22200,wilbur,99185,3290,2017
lincoln,wilbur secondary,153,16,1,2,3,0,8,119,7,84,69,50,22200,wilbur,99185,3289,2017
pacific,willapa elementary,160,0,1,0,1,0,24,129,6,70,90,78,25160,menlo,98561,3444,2017
pacific,willapa valley middle-high,178,2,1,0,1,0,21,144,10,96,82,84,25160,menlo,98561,2542,2017
grant,wilson creek elementary,74,0,0,0,0,0,21,52,1,34,40,37,13167,wilson creek,98860,2472,2017
grant,wilson creek high,76,1,1,0,1,1,12,61,0,36,40,38,13167,wilson creek,98860,2473,2017
lewis,winlock middle,146,0,1,0,1,0,37,102,6,76,70,123,21232,winlock,98596,4369,2017
lewis,winlock miller elementary,317,1,1,0,1,0,90,206,19,173,144,252,21232,winlock,98596,2290,2017
lewis,winlock senior high,192,2,1,0,1,2,38,143,6,106,86,129,21232,winlock,98596,3597,2017
lewis,winolequa learning academy,37,2,0,0,0,0,6,26,3,23,14,29,21232,winlock,98596,1829,2017
grays harbor,wishkah valley elementary/high,163,0,0,0,0,1,2,160,0,75,88,84,14117,aberdeen,98520,3375,2017
klickitat,wishram high and elementary,79,9,1,0,1,0,7,53,9,53,26,73,20094,wishram,98673,2605,2017
cowlitz,lewis river academy,50,0,1,0,1,0,9,37,3,25,25,12,08404,woodland,98674,5246,2017
cowlitz,team high,84,1,0,0,0,2,6,69,6,41,43,34,08404,woodland,98674,1795,2017
cowlitz,woodland high,715,4,3,1,4,3,125,553,26,378,337,277,08404,woodland,98674,3546,2017
cowlitz,woodland intermediate,486,5,7,0,7,3,128,335,8,252,234,238,08404,woodland,98674,5408,2017
cowlitz,woodland middle,695,1,2,0,2,11,130,532,19,371,324,322,08404,woodland,98674,5409,2017
cowlitz,woodland primary,195,0,0,0,0,0,43,142,10,101,94,99,08404,woodland,98674,5407,2017
cowlitz,yale elementary,35,1,0,0,0,0,2,31,1,21,14,10,08404,ariel,98603,3513,2017
yakima,adams elementary,723,4,1,0,1,1,694,23,0,369,354,649,39007,yakima,98901,2592,2017
yakima,barge-lincoln elementary,620,5,1,0,1,4,576,24,10,320,300,561,39007,yakima,98901,3138,2017
yakima,davis high,2273,13,12,0,12,22,1913,243,70,1117,1156,1407,39007,yakima,98902,2116,2017
yakima,discovery lab,210,2,0,0,0,2,110,84,12,100,110,82,39007,yakima,98902,3023,2017
yakima,early childhood center,163,1,1,0,1,0,116,40,5,102,61,111,39007,yakima,98902,5019,2017
yakima,eisenhower high,2098,16,16,2,18,21,1427,555,61,1056,1042,1226,39007,yakima,98908,3206,2017
yakima,franklin middle,826,11,0,1,1,4,615,167,28,430,396,586,39007,yakima,98902,2410,2017
yakima,garfield elementary,524,1,0,2,2,4,486,27,4,257,267,488,39007,yakima,98902,2176,2017
yakima,gilbert elementary,586,16,3,0,3,6,365,174,22,291,295,378,39007,yakima,98908,2818,2017
yakima,hoover elementary,743,5,1,4,5,3,639,78,13,422,321,624,39007,yakima,98902,2715,2017
yakima,lewis & clark middle,831,8,3,2,5,5,707,91,15,401,430,630,39007,yakima,98902,3615,2017
yakima,martin luther king jr elementary,611,4,0,0,0,3,559,39,6,322,289,530,39007,yakima,98903,3817,2017
yakima,mcclure elementary school yakima,605,2,2,0,2,6,443,134,18,313,292,408,39007,yakima,98902,2899,2017
yakima,mckinley elementary,450,3,0,0,0,3,360,70,14,223,227,374,39007,yakima,98902,2177,2017
yakima,nob hill elementary,496,3,0,0,0,2,267,209,15,258,238,268,39007,yakima,98902,2819,2017
yakima,ridgeview elementary,641,3,1,0,1,6,525,96,10,323,318,497,39007,yakima,98903,2433,2017
yakima,robertson elementary,507,10,1,0,1,3,363,118,12,241,266,409,39007,yakima,98902,3264,2017
yakima,roosevelt elementary,547,4,5,0,5,11,420,89,18,279,268,419,39007,yakima,98902,2529,2017
yakima,stanton academy,318,8,0,0,0,6,234,60,10,181,137,238,39007,yakima,98902,4093,2017
yakima,washington middle,772,6,1,0,1,6,723,33,3,392,380,644,39007,yakima,98901,2314,2017
yakima,whitney elementary yakima,547,0,6,2,8,8,360,152,19,275,272,333,39007,yakima,98908,3312,2017
yakima,wilson middle,852,11,7,0,7,7,582,219,26,417,435,527,39007,yakima,98908,3368,2017
yakima,yakima online,89,1,0,0,0,1,42,41,4,37,52,59,39007,yakima,98902,5153,2017
yakima,yakima open doors,111,2,0,1,1,1,83,21,3,50,61,70,39007,yakima,98901,5355,2017
yakima,yakima satellite alternative programs,42,0,1,0,1,1,21,19,0,20,22,28,39007,yakima,98902,5224,2017
thurston,fort stevens elementary,614,11,15,9,24,6,82,404,87,312,302,319,34002,yelm,98597,4346,2017
thurston,lackamas elementary,326,6,2,0,2,8,33,239,38,181,145,147,34002,yelm,98597,5018,2017
thurston,mckenna elementary,494,5,4,4,8,0,65,359,57,240,254,255,34002,yelm,98597,2260,2017
thurston,mill pond elementary,544,6,12,9,21,10,97,352,58,280,264,240,34002,yelm,98597,4451,2017
thurston,ridgeline middle,627,11,3,3,6,1,98,458,53,347,280,232,34002,yelm,98597,5052,2017
thurston,southworth elementary,611,29,8,12,20,8,108,375,71,347,264,262,34002,yelm,98597,3848,2017
thurston,yelm extension,138,2,0,0,0,3,12,109,12,63,75,54,34002,yelm,98597,1627,2017
thurston,yelm high school 12,1239,11,21,16,37,23,155,896,117,625,614,379,34002,yelm,98597,2633,2017
thurston,yelm middle,695,9,9,8,17,16,103,476,74,331,364,303,34002,yelm,98597,2481,2017
thurston,yelm prairie elementary,560,12,4,0,4,4,94,395,51,316,244,217,34002,yelm,98597,4224,2017
yakima,hilton elementary,373,9,1,0,1,0,209,136,18,189,184,227,39205,zillah,98953,2783,2017
yakima,zillah high,435,16,1,1,2,1,198,208,10,231,204,208,39205,zillah,98953,2240,2017
yakima,zillah intermediate,294,13,1,0,1,1,159,109,11,168,126,178,39205,zillah,98953,4221,2017
yakima,zillah middle,239,14,1,0,1,0,121,95,8,140,99,133,39205,zillah,98953,4481,2017
grays harbor,a j west elementary,405,8,3,0,3,3,181,185,25,205,200,278,14005,aberdeen,98520,2834,2018
grays harbor,central park elementary,192,1,3,0,3,1,31,133,23,103,89,103,14005,aberdeen,98520,3216,2018
grays harbor,harbor high,105,5,1,1,2,1,33,56,8,52,53,59,14005,aberdeen,98520,3857,2018
grays harbor,hopkins elementary,57,1,0,0,0,0,18,30,8,34,23,59,14005,aberdeen,98520,3154,2018
grays harbor,j m weatherwax high,945,48,32,4,36,13,269,539,40,468,477,430,14005,aberdeen,98520,3476,2018
grays harbor,mcdermoth elementary,387,9,2,0,2,2,114,217,43,188,199,230,14005,aberdeen,98520,2449,2018
grays harbor,miller junior high,483,19,10,0,10,4,145,277,28,237,246,336,14005,aberdeen,98520,2305,2018
grays harbor,robert gray elementary,351,8,3,2,5,1,135,174,28,168,183,285,14005,aberdeen,98520,2763,2018
grays harbor,stevens elementary,499,10,17,0,17,6,179,233,54,252,247,390,14005,aberdeen,98520,2971,2018
lewis,adna elementary,265,4,0,0,0,3,13,243,2,126,139,72,21226,adna,98522,2227,2018
lewis,adna middle/high,380,1,5,0,5,0,24,336,14,190,190,102,21226,adna,98522,2441,2018
lincoln,almira elementary,109,0,0,0,0,0,8,92,9,47,62,39,22017,almira,99103,2860,2018
skagit,anacortes high,795,7,38,1,39,11,65,654,19,401,394,154,29103,anacortes,98221,2467,2018
skagit,anacortes middle,623,2,26,0,26,6,66,510,13,321,302,156,29103,anacortes,98221,2707,2018
skagit,cap sante high,64,1,0,0,0,1,8,53,1,28,36,39,29103,anacortes,98221,5176,2018
skagit,fidalgo elementary,367,4,12,0,12,2,46,295,8,195,172,106,29103,anacortes,98221,3182,2018
skagit,island view elementary,426,3,10,0,10,5,54,343,11,215,211,145,29103,anacortes,98221,3252,2018
skagit,mount erie elementary,380,3,11,1,12,1,35,313,16,189,191,104,29103,anacortes,98221,3057,2018
skagit,whitney elementary anacortes,147,0,2,1,3,3,7,122,12,92,55,28,29103,anacortes,98221,3404,2018
snohomish,arlington high,1624,23,30,6,36,15,185,1287,78,812,812,378,31016,arlington,98223,2523,2018
snohomish,arlington open doors,11,1,0,0,0,0,4,6,0,8,3,18,31016,arlington,98223,5495,2018
snohomish,arlington special educ,45,2,0,1,1,0,7,35,0,34,11,8,31016,arlington,98223,2277,2018
snohomish,eagle creek elementary,661,9,4,0,4,2,126,473,47,334,327,268,31016,arlington,98223,4327,2018
snohomish,haller middle,666,14,8,1,9,9,115,470,49,358,308,169,31016,arlington,98223,5010,2018
snohomish,kent prairie elementary,644,5,6,1,7,1,80,478,73,337,307,261,31016,arlington,98223,4436,2018
snohomish,pioneer elementary,578,5,6,0,6,4,104,402,57,312,266,147,31016,arlington,98223,4573,2018
snohomish,post middle,625,4,11,2,13,3,73,481,51,353,272,207,31016,arlington,98223,3124,2018
snohomish,presidents elementary,545,5,3,0,3,2,63,426,46,287,258,200,31016,arlington,98223,4154,2018
snohomish,stillaguamish valley learning center,72,0,0,0,0,2,7,62,1,36,36,19,31016,arlington,98223,1714,2018
snohomish,weston high,157,2,2,0,2,3,13,133,4,86,71,58,31016,arlington,98223,4287,2018
asotin,asotin elementary,223,0,2,0,2,0,12,199,10,110,113,77,02420,asotin,99402,2507,2018
asotin,asotin jr sr high,365,2,4,0,4,1,23,315,20,174,191,74,02420,asotin,99402,2434,2018
king,alpac elementary,635,2,73,9,82,18,189,260,84,328,307,344,17408,pacific,98047,3825,2018
king,arthur jacobsen elementary,571,0,77,4,81,40,148,251,51,295,276,256,17408,auburn,98092,5082,2018
king,auburn mountainview high,1560,10,170,21,191,159,271,809,120,748,812,610,17408,auburn,98092,5037,2018
king,auburn riverside high,1643,6,177,44,221,83,445,775,113,829,814,529,17408,auburn,98092,4474,2018
king,auburn senior high,1770,38,126,101,227,177,564,645,119,934,836,934,17408,auburn,98002,2795,2018
king,cascade middle,806,4,65,42,107,81,214,326,74,392,414,466,17408,auburn,98002,2394,2018
king,chinook elementary,543,69,21,39,60,42,203,110,59,288,255,397,17408,auburn,98092,3439,2018
king,dick scobee elementary,504,2,34,33,67,49,144,172,70,259,245,373,17408,auburn,98002,2932,2018
king,evergreen heights elementary,523,0,98,21,119,57,104,183,60,257,266,218,17408,auburn,98001,3745,2018
king,gildo rey elementary,596,2,28,30,58,23,345,119,49,328,268,430,17408,auburn,98002,3669,2018
king,hazelwood elementary,572,6,44,4,48,23,170,270,55,303,269,263,17408,auburn,98092,4347,2018
king,ilalko elementary,632,3,68,33,101,30,205,218,75,329,303,343,17408,auburn,98092,4417,2018
king,lake view elementary,434,1,10,4,14,10,87,287,35,225,209,185,17408,auburn,98092,4120,2018
king,lakeland hills elementary,732,4,99,0,99,38,156,346,89,373,359,157,17408,auburn,98092,5051,2018
king,lea hill elementary,505,1,58,15,73,71,94,183,83,263,242,382,17408,auburn,98092,3525,2018
king,mt baker middle,1011,4,114,43,157,58,342,357,93,524,487,475,17408,auburn,98002,4462,2018
king,olympic middle,838,24,54,55,109,64,325,236,80,436,402,547,17408,auburn,98002,3169,2018
king,pioneer elementary,495,2,17,38,55,17,304,80,37,269,226,386,17408,auburn,98002,3227,2018
king,rainier middle,929,5,101,16,117,71,225,442,69,451,478,462,17408,auburn,98092,4385,2018
king,special ed,125,5,7,1,8,10,32,53,17,82,43,48,17408,auburn,98002,1915,2018
king,terminal park elementary,503,0,24,56,80,45,144,162,72,255,248,331,17408,auburn,98002,2659,2018
king,washington elementary,556,1,19,55,74,41,189,164,87,294,262,382,17408,auburn,98002,2326,2018
king,west auburn senior high,241,6,9,11,20,15,68,109,23,108,133,186,17408,auburn,98001,2702,2018
kitsap,bainbridge high,1352,10,50,1,51,4,108,1055,124,694,658,86,18303,bainbridge island,98110,2395,2018
kitsap,bainbridge special education services,25,0,1,0,1,0,3,18,3,16,9,0,18303,bainbridge island,98110,1939,2018
kitsap,capt johnston blakely elem,369,2,9,0,9,1,13,312,32,206,163,23,18303,bainbridge island,98110,3552,2018
kitsap,capt. charles wilkes elem,408,2,11,3,14,1,19,351,21,213,195,13,18303,bainbridge island,98110,3043,2018
kitsap,eagle harbor high,113,0,7,0,7,0,8,93,5,59,54,8,18303,bainbridge island,98110,1935,2018
kitsap,mosaic home education partnership,49,0,0,0,0,0,4,41,4,30,19,7,18303,bainbridge island,98110,1841,2018
kitsap,odyssey multiage program,117,0,1,0,1,2,4,105,5,58,59,9,18303,bainbridge island,98110,1699,2018
kitsap,ordway elementary,367,2,9,1,10,6,43,264,42,189,178,40,18303,bainbridge island,98110,4062,2018
kitsap,sakai intermediate,521,4,15,2,17,4,41,401,54,270,251,33,18303,bainbridge island,98110,4542,2018
kitsap,woodward middle,600,5,26,2,28,3,49,469,46,305,295,52,18303,bainbridge island,98110,4505,2018
pierce,bates technical high,296,7,3,7,10,51,14,202,12,242,54,0,27931,tacoma,98405,5950,2018
clark,amboy middle,579,3,0,0,0,1,10,551,13,298,281,176,06119,battle ground,98604,2671,2018
clark,battle ground high,2136,8,28,3,31,10,155,1845,87,1150,986,521,06119,battle ground,98604,2415,2018
clark,cam academy,522,0,20,1,21,1,20,449,31,233,289,79,06119,battle ground,98604,1836,2018
clark,captain strong,739,2,2,1,3,2,66,625,41,388,351,257,06119,battle ground,98604,4352,2018
clark,chief umtuch middle,584,0,2,0,2,3,65,486,28,316,268,211,06119,battle ground,98604,5133,2018
clark,daybreak middle,451,0,6,2,8,5,50,365,23,248,203,183,06119,battle ground,98604,5089,2018
clark,daybreak primary,522,1,5,4,9,9,38,446,19,283,239,222,06119,battle ground,98604,5090,2018
clark,db youth services,37,2,0,0,0,3,8,21,3,21,16,22,06119,brush prairie,98606,5502,2018
clark,glenwood heights primary,800,2,39,1,40,15,113,586,44,415,385,281,06119,vancouver,98662,3018,2018
clark,homelink river,1010,7,11,0,11,6,59,862,65,476,534,279,06119,battle ground,98604,1875,2018
clark,laurin middle,679,3,36,1,37,9,85,512,33,344,335,239,06119,battle ground,98604,3545,2018
clark,maple grove k-8,494,2,9,2,11,0,62,388,31,257,237,238,06119,battle ground,98604,5291,2018
clark,open doors battle ground,17,0,0,0,0,1,2,12,2,11,6,3,06119,battle ground,98604,5360,2018
clark,pleasant valley middle,543,6,42,6,48,13,87,352,37,277,266,183,06119,vancouver,98686,3997,2018
clark,pleasant valley primary,590,4,21,11,32,10,75,427,42,308,282,218,06119,battle ground,98604,3996,2018
clark,prairie high,1592,9,81,2,83,13,217,1181,89,819,773,418,06119,battle ground,98604,4104,2018
clark,preschool infant other,50,0,0,0,0,1,6,41,2,26,24,14,06119,battle ground,98604,4108,2018
clark,summit view high,348,2,3,2,5,0,26,300,15,155,193,171,06119,battle ground,98604,4450,2018
clark,tukes valley middle,468,1,3,0,3,0,37,404,23,237,231,125,06119,battle ground,98604,5131,2018
clark,tukes valley primary,605,0,0,0,0,2,47,526,30,314,291,176,06119,battle ground,98642,5132,2018
clark,yacolt primary,792,0,2,0,2,1,18,752,19,424,368,280,06119,yacolt,98675,2910,2018
king,ardmore elementary,420,1,146,1,147,23,105,117,27,211,209,176,17405,bellevue,98008,3633,2018
king,bellevue big picture,381,1,73,2,75,13,28,233,31,217,164,52,17405,bellevue,98007,5240,2018
king,bellevue high,1579,0,495,3,498,31,109,773,168,838,741,157,17405,bellevue,98004,2701,2018
king,bennett elementary,435,0,152,0,152,13,23,209,38,218,217,37,17405,bellevue,98008,3705,2018
king,central educational services,91,0,10,0,10,6,17,48,10,55,36,14,17405,bellevue,98009,5281,2018
king,cherry crest elementary,650,0,371,0,371,5,21,213,40,339,311,13,17405,bellevue,98005,3742,2018
king,chinook middle,991,0,305,2,307,22,86,486,90,478,513,97,17405,bellevue,98006,3338,2018
king,clyde hill elementary,619,1,277,1,278,4,43,230,63,305,314,49,17405,bellevue,98007,2847,2018
king,eastgate elementary,460,1,169,0,169,8,44,182,56,249,211,75,17405,bellevue,98006,3036,2018
king,enatai elementary,585,0,179,1,180,25,63,243,74,310,275,92,17405,bellevue,98007,2846,2018
king,grad alliance program,13,0,2,0,2,1,3,7,0,8,5,1,17405,bellevue,98005,5325,2018
king,highland middle,490,0,84,5,89,29,146,187,39,260,230,214,17405,bellevue,98006,3166,2018
king,interlake senior high,1691,0,636,0,636,64,256,586,149,884,807,371,17405,bellevue,98008,3588,2018
king,international,578,2,251,0,251,3,17,243,62,281,297,35,17405,bellevue,98005,3522,2018
king,jing mei elementary,369,0,240,0,240,4,10,40,75,181,188,14,17405,bellevue,98006,5308,2018
king,lake hills elementary,502,0,113,1,114,18,210,122,38,256,246,269,17405,bellevue,98007,3225,2018
king,medina elementary,498,0,273,0,273,1,16,171,37,260,238,8,17405,medina,98039,3436,2018
king,newport heights elementary,599,0,233,1,234,22,47,229,67,312,287,123,17405,bellevue,98006,3437,2018
king,newport senior high,1837,1,896,2,898,29,108,654,147,968,869,212,17405,bellevue,98006,3486,2018
king,odle middle,1059,0,581,1,582,20,123,242,92,560,499,212,17405,bellevue,98007,3631,2018
king,phantom lake elementary,424,1,102,0,102,14,71,183,53,235,189,101,17405,bellevue,98008,3168,2018
king,puesta del sol elementary,567,0,74,1,75,9,125,280,78,289,278,35,17405,bellevue,98006,3224,2018
king,sammamish senior high,1112,3,235,5,240,62,204,521,82,561,551,373,17405,bellevue,98005,3282,2018
king,sherwood forest elementary,429,0,92,2,94,37,148,119,31,229,200,206,17405,bellevue,98008,3339,2018
king,somerset elementary,721,0,507,1,508,4,20,120,69,357,364,43,17405,bellevue,98006,3789,2018
king,spiritridge elementary,698,0,354,0,354,16,39,234,55,375,323,60,17405,bellevue,98008,3634,2018
king,stevenson elementary,547,0,304,4,308,14,178,31,16,289,258,244,17405,bellevue,98007,3100,2018
king,tillicum middle,686,0,143,0,143,16,90,364,73,343,343,86,17405,bellevue,98008,3435,2018
king,tyee middle,1010,0,571,2,573,22,54,263,98,544,466,103,17405,bellevue,98006,3283,2018
king,woodridge elementary,676,2,294,6,300,22,49,251,52,357,319,110,17405,bellevue,98005,3167,2018
whatcom,alderwood elementary,364,4,20,0,20,8,111,202,19,203,161,262,37501,bellingham,98225,3200,2018
whatcom,bellingham family partnership program,192,0,3,0,3,2,15,162,10,100,92,20,37501,bellingham,98225,5366,2018
whatcom,bellingham high,1129,17,42,2,44,18,184,791,75,566,563,292,37501,bellingham,98225,2553,2018
whatcom,bellingham re-engagement program,89,0,1,0,1,3,21,52,12,59,30,55,37501,bellingham,98225,5340,2018
whatcom,birchwood elementary,337,1,13,4,17,2,140,150,27,178,159,217,37501,bellingham,98225,2431,2018
whatcom,carl cozier elementary,319,7,10,7,17,26,46,198,25,160,159,183,37501,bellingham,98229,2817,2018
whatcom,columbia elementary,294,2,10,0,10,1,20,248,13,162,132,51,37501,bellingham,98225,2365,2018
whatcom,cordata elementary,371,3,45,4,49,16,119,142,42,201,170,248,37501,bellingham,98226,5239,2018
whatcom,fairhaven middle,629,6,40,0,40,8,60,470,45,326,303,117,37501,bellingham,98225,2066,2018
whatcom,geneva elementary,466,4,4,3,7,8,40,387,20,249,217,118,37501,bellingham,98229,2262,2018
whatcom,happy valley elementary,439,4,23,2,25,7,48,317,38,225,214,145,37501,bellingham,98225,3134,2018
whatcom,kulshan middle,589,7,21,4,25,16,100,401,40,311,278,221,37501,bellingham,98229,4442,2018
whatcom,lowell elementary,293,1,7,0,7,7,24,235,19,139,154,71,37501,bellingham,98225,2225,2018
whatcom,northern heights elementary,426,5,28,3,31,16,73,252,49,237,189,153,37501,bellingham,98226,4571,2018
whatcom,options high,158,5,2,1,3,5,26,105,14,71,87,97,37501,bellingham,98225,1647,2018
whatcom,parkview elementary,317,2,9,0,9,7,41,223,35,162,155,131,37501,bellingham,98225,3202,2018
whatcom,roosevelt elementary,382,5,11,0,11,7,99,231,29,199,183,209,37501,bellingham,98226,2067,2018
whatcom,sehome high,1188,7,70,4,74,25,108,895,79,630,558,238,37501,bellingham,98225,3576,2018
whatcom,shuksan middle,665,9,72,3,75,11,190,338,42,336,329,357,37501,bellingham,98225,3201,2018
whatcom,silver beach elementary,476,3,19,0,19,1,34,365,54,249,227,79,37501,bellingham,98226,2175,2018
whatcom,squalicum high,1328,16,148,5,153,23,264,776,96,695,633,442,37501,bellingham,98226,4515,2018
whatcom,sunnyland elementary,301,2,23,1,24,1,49,202,23,164,137,124,37501,bellingham,98225,2387,2018
whatcom,visions (seamar youth center),22,1,2,0,2,2,3,10,4,0,22,0,37501,bellingham,98225,1799,2018
whatcom,wade king elementary,411,0,23,0,23,6,35,312,35,204,207,79,37501,bellingham,98229,5125,2018
whatcom,whatcom middle,720,6,18,0,18,11,71,558,56,408,312,163,37501,bellingham,98225,2075,2018
adams,benge elementary,12,0,0,0,0,0,0,12,0,7,5,2,01122,benge,99105,3142,2018
pierce,acceleration academy,193,6,2,4,6,27,34,102,18,99,94,91,27403,spanaway,98387,5372,2018
pierce,bethel elementary learning academy,25,0,0,0,0,2,5,16,2,13,12,6,27403,puyallup,98375,5471,2018
pierce,bethel high,1763,29,87,55,142,139,283,1053,117,940,823,694,27403,spanaway,98387,2807,2018
pierce,bethel middle,693,9,35,36,71,51,154,321,87,380,313,377,27403,spanaway,98387,3250,2018
pierce,camas prairie elementary,658,6,35,40,75,69,96,315,97,356,302,357,27403,spanaway,98387,4296,2018
pierce,cedarcrest middle,664,10,51,48,99,84,115,260,96,368,296,390,27403,spanaway,98387,4186,2018
pierce,centennial elementary bethel,481,3,4,13,17,13,78,311,59,253,228,273,27403,graham,98338,4331,2018
pierce,challenger high,266,3,5,6,11,16,52,167,17,139,127,174,27403,spanaway,98387,1510,2018
pierce,chester h thompson elementary,620,4,9,48,57,40,217,203,99,289,331,434,27403,tacoma,98445,3649,2018
pierce,clover creek elementary,754,4,49,45,94,67,138,351,100,407,347,343,27403,tacoma,98446,2576,2018
pierce,cougar mountain middle,620,9,18,12,30,24,83,429,45,316,304,293,27403,graham,98338,4578,2018
pierce,elk plain school of choice,588,3,16,2,18,36,79,362,90,284,304,163,27403,spanaway,98397,2877,2018
pierce,evergreen elementary,535,2,41,48,89,48,127,180,89,276,259,356,27403,spanaway,98387,4099,2018
pierce,frederickson elementary,647,0,28,19,47,47,168,300,85,322,325,301,27403,puyallup,98375,5159,2018
pierce,frontier middle,737,8,20,11,31,28,88,509,73,392,345,270,27403,graham,98338,4407,2018
pierce,graham elementary,698,1,13,9,22,17,99,444,115,368,330,246,27403,graham,98338,4297,2018
pierce,graham kapowsin high,1971,29,96,37,133,133,289,1235,152,1035,936,603,27403,graham,98338,5033,2018
pierce,kapowsin elementary,408,2,4,2,6,4,39,317,40,235,173,151,27403,graham,98338,2748,2018
pierce,liberty middle,745,5,34,28,62,60,130,385,103,402,343,301,27403,spanaway,98387,5206,2018
pierce,naches trail elementary,552,9,17,19,36,41,84,285,97,288,264,269,27403,tacoma,98446,4102,2018
pierce,nelson elementary,532,2,9,5,14,19,92,349,56,265,267,169,27403,graham,98338,5160,2018
pierce,north star elementary,480,3,11,15,26,23,69,294,65,241,239,236,27403,graham,98338,4538,2018
pierce,pioneer valley elementary,418,2,9,19,28,16,75,246,51,232,186,175,27403,spanaway,98387,4381,2018
pierce,rocky ridge elementary,485,5,7,6,13,9,79,336,43,245,240,254,27403,graham,98338,4227,2018
pierce,roy elementary,353,2,4,3,7,4,39,263,38,195,158,198,27403,roy,98580,2543,2018
pierce,shining mountain elementary,782,5,30,33,63,52,203,314,145,410,372,457,27403,spanaway,98387,4103,2018
pierce,spanaway elementary,384,5,6,16,22,29,80,164,84,198,186,257,27403,spanaway,98387,2399,2018
pierce,spanaway lake high,1581,25,129,80,209,252,304,662,129,801,780,769,27403,spanaway,98387,4158,2018
pierce,spanaway middle,687,8,38,38,76,67,159,266,111,356,331,418,27403,tacoma,98445,3751,2018
pierce,thompson preschool,327,1,6,8,14,22,48,208,34,212,115,144,27403,tacoma,98445,1560,2018
klickitat,bickleton elementary & high,123,0,0,0,0,0,53,68,2,65,58,26,20203,bickleton,99322,3392,2018
whatcom,blaine elementary,493,6,27,2,29,10,51,366,31,247,246,239,37503,blaine,98230,2713,2018
whatcom,blaine high,659,7,18,10,28,9,92,485,38,358,301,280,37503,blaine,98230,3136,2018
whatcom,blaine home connections,69,3,0,0,0,0,3,59,4,32,37,9,37503,blaine,98230,5021,2018
whatcom,blaine middle,501,9,15,5,20,10,65,364,33,270,231,246,37503,blaine,98230,3796,2018
whatcom,blaine primary,523,4,17,2,19,9,75,373,43,279,244,270,37503,blaine,98230,4476,2018
whatcom,blaine re-engagement,19,0,0,0,0,0,2,15,2,15,4,4,37503,blaine,98230,5465,2018
whatcom,point roberts primary,15,2,0,0,0,0,0,13,0,7,8,8,37503,point roberts,98281,4459,2018
lewis,boistfort elem,93,2,0,0,0,0,12,75,4,53,40,44,21234,curtis,98538,2516,2018
kitsap,armin jahr elementary,421,0,16,9,25,22,115,183,76,231,190,308,18100,bremerton,98310,3641,2018
kitsap,bremerton high,1176,10,79,20,99,66,197,612,192,606,570,633,18100,bremerton,98337,3109,2018
kitsap,bremerton home link program,31,2,0,0,0,0,4,25,0,19,12,14,18100,bremerton,98312,1749,2018
kitsap,career & academic re-engagement center,40,1,0,0,0,1,6,26,6,19,21,49,18100,bremerton,98312,5395,2018
kitsap,crownhill elementary,401,2,9,3,12,18,88,217,64,212,189,258,18100,bremerton,98312,3108,2018
kitsap,kitsap lake elementary,397,3,14,4,18,11,59,248,58,181,216,179,18100,bremerton,98312,4421,2018
kitsap,mountain view middle,890,6,36,23,59,60,156,482,127,465,425,572,18100,bremerton,98310,4441,2018
kitsap,naval avenue elementary,352,0,5,9,14,17,111,175,35,165,187,206,18100,bremerton,98312,3171,2018
kitsap,renaissance alternative high,127,0,1,3,4,4,15,74,30,67,60,99,18100,bremerton,98312,1737,2018
kitsap,special services,77,0,2,0,2,0,12,49,14,51,26,38,18100,bremerton,98312,5161,2018
kitsap,view ridge elementary arts academy,463,5,11,7,18,17,92,240,91,222,241,298,18100,bremerton,98310,2853,2018
kitsap,west hills s.t.e.m. academy,657,6,19,14,33,44,137,343,94,338,319,467,18100,bremerton,98312,2613,2018
okanogan,brewster alternative,29,1,0,0,0,0,22,6,0,20,9,11,24111,brewster,98812,5272,2018
okanogan,brewster elementary,496,1,1,0,1,1,461,29,3,240,256,479,24111,brewster,98812,3293,2018
okanogan,brewster high,249,1,0,0,0,0,220,27,1,132,117,217,24111,brewster,98812,2800,2018
okanogan,brewster middle,214,3,0,0,0,0,192,17,2,118,96,209,24111,brewster,98812,4223,2018
douglas,bridgeport aurora high,18,0,0,0,0,0,17,1,0,10,8,13,09075,bridgeport,98813,1900,2018
douglas,bridgeport elementary,360,1,0,0,0,0,340,17,2,173,187,317,09075,bridgeport,98813,2562,2018
douglas,bridgeport high,238,3,1,0,1,0,220,12,2,138,100,212,09075,bridgeport,98813,2788,2018
douglas,bridgeport middle,258,0,1,0,1,0,233,22,2,134,124,231,09075,bridgeport,98813,4213,2018
jefferson,brinnon elementary,68,2,0,2,2,0,1,63,0,45,23,59,16046,brinnon,98320,2836,2018
skagit,allen elementary,447,4,9,5,14,2,287,118,22,239,208,331,29100,bow,98232,3603,2018
skagit,bay view elementary,521,0,13,1,14,1,141,350,15,286,235,172,29100,burlington,98233,4412,2018
skagit,becc,43,1,1,0,1,1,20,18,2,29,14,32,29100,burlington,98233,1650,2018
skagit,burlington edison high,1065,6,21,4,25,10,381,615,28,564,501,412,29100,burlington,98233,2362,2018
skagit,burlington-edison alternative,42,2,0,0,0,1,22,17,0,22,20,37,29100,burlington,98233,1928,2018
skagit,edison elementary - burlington/edison,470,3,8,2,10,3,65,361,27,255,215,106,29100,edison,98232,2379,2018
skagit,lucille umbarger elementary,661,9,12,0,12,1,361,245,31,350,311,418,29100,burlington,98233,3251,2018
skagit,west view elementary,392,1,3,0,3,1,281,97,9,180,212,251,29100,burlington,98233,2946,2018
clark,camas high,2230,6,166,4,170,23,179,1682,170,1128,1102,229,06117,camas,98607,4567,2018
clark,dorothy fox,437,3,28,0,28,4,43,314,45,222,215,35,06117,camas,98607,4182,2018
clark,grass valley elementary,572,0,56,3,59,10,61,401,41,297,275,53,06117,camas,98607,5158,2018
clark,hayes freedom high,136,0,2,0,2,1,11,110,12,61,75,39,06117,camas,98607,5104,2018
clark,helen baller elem,617,5,37,0,37,3,54,458,60,320,297,78,06117,camas,98607,2725,2018
clark,liberty middle,875,2,28,1,29,3,90,685,66,459,416,139,06117,camas,98607,5054,2018
clark,papermaker preschool,46,0,3,0,3,1,7,30,5,28,18,7,06117,camas,98607,5055,2018
clark,prune hill elem,514,1,79,1,80,2,46,336,49,253,261,56,06117,camas,98607,4563,2018
clark,skyridge middle,869,2,101,2,103,9,66,610,79,411,458,86,06117,camas,98607,4508,2018
clark,woodburn elementary,482,0,14,0,14,4,56,353,55,242,240,116,06117,camas,98607,5309,2018
clallam,cape flattery preschool,10,5,0,0,0,0,2,0,3,8,2,0,05401,sekiu,98381,1787,2018
clallam,clallam bay high & elementary,121,18,2,0,2,0,29,46,26,55,66,70,05401,clallam bay,98326,3422,2018
clallam,neah bay elementary,198,116,0,0,0,0,32,9,41,103,95,140,05401,neah bay,98357,2594,2018
clallam,neah bay junior/ senior high,177,107,0,0,0,0,29,5,36,81,96,108,05401,neah bay,98357,3145,2018
thurston,gravity high,391,23,5,4,9,18,64,277,0,214,177,0,34801,tumwater,98512,5305,2018
pierce,carbonado historical school 19,176,0,0,0,0,0,6,164,6,95,81,63,27019,carbonado,98323,2466,2018
chelan,beaver valley,33,0,1,0,1,0,1,31,0,18,15,10,04228,leavenworth,98826,4566,2018
chelan,cascade high,440,3,5,0,5,2,116,306,7,215,225,158,04228,leavenworth,98826,3564,2018
chelan,cascade home-link,26,0,0,0,0,0,1,25,0,9,17,7,04228,leavenworth,98826,5418,2018
chelan,icicle river middle,284,3,0,0,0,0,91,185,5,140,144,118,04228,leavenworth,98826,4403,2018
chelan,cashmere high,499,3,3,0,3,5,178,298,12,243,256,181,04222,cashmere,98815,3268,2018
chelan,cashmere middle,490,0,2,0,2,1,205,262,20,241,249,213,04222,cashmere,98815,2315,2018
chelan,vale elementary,620,0,3,0,3,3,274,328,12,337,283,285,04222,cashmere,98815,2787,2018
cowlitz,castle rock elementary,606,3,4,2,6,1,34,517,45,321,285,311,08401,castle rock,98611,2762,2018
cowlitz,castle rock high,418,7,3,2,5,1,49,331,25,220,198,187,08401,castle rock,98611,2281,2018
cowlitz,castle rock middle,304,2,2,0,2,0,29,261,10,151,153,163,08401,castle rock,98611,3969,2018
klickitat,centerville elementary,95,0,0,1,1,1,8,84,1,57,38,31,20215,centerville,98613,2251,2018
kitsap,barker creek community,361,1,4,1,5,4,37,265,49,169,192,192,18401,silverdale,98383,5472,2018
kitsap,brownsville elementary,454,0,13,3,16,7,33,294,104,247,207,90,18401,bremerton,98311,2994,2018
kitsap,central kitsap high,1527,5,109,18,127,53,196,916,229,748,779,405,18401,silverdale,98383,2615,2018
kitsap,central kitsap middle,715,3,34,5,39,31,77,449,116,368,347,229,18401,silverdale,98383,3237,2018
kitsap,clear creek elementary,529,4,18,4,22,26,110,304,63,285,244,280,18401,silverdale,98383,4016,2018
kitsap,cottonwood elementary,305,4,8,7,15,3,52,162,69,167,138,121,18401,bremerton,98311,4014,2018
kitsap,cougar valley elementary,463,2,7,1,8,17,52,333,51,229,234,153,18401,silverdale,98383,4341,2018
kitsap,emerald heights elementary,479,2,32,8,40,10,55,296,76,254,225,120,18401,silverdale,98383,4444,2018
kitsap,esquire hills elementary,341,1,15,9,24,12,59,177,68,199,142,188,18401,bremerton,98311,4015,2018
kitsap,fairview middle,666,2,43,15,58,34,106,326,140,329,337,347,18401,bremerton,98310,3791,2018
kitsap,green mountain elementary,386,0,0,0,0,10,26,311,39,214,172,150,18401,bremerton,98312,4393,2018
kitsap,john d. bud hawk elementary at jackson park,493,6,10,1,11,30,95,262,89,251,242,235,18401,bremerton,98312,3594,2018
kitsap,klahowya secondary,1087,0,3,0,3,5,85,854,140,543,544,302,18401,silverdale,98383,4509,2018
kitsap,olympic high,1215,5,93,16,109,53,180,601,267,639,576,498,18401,bremerton,98311,4100,2018
kitsap,pinecrest elementary,432,3,6,3,9,18,73,220,109,233,199,207,18401,bremerton,98311,4527,2018
kitsap,ridgetop middle,730,3,35,13,48,17,123,410,129,384,346,280,18401,silverdale,98383,4249,2018
kitsap,silver ridge elementary,378,0,12,5,17,10,57,220,74,180,198,136,18401,silverdale,98383,4372,2018
kitsap,silverdale elementary,431,5,17,4,21,7,43,277,78,235,196,176,18401,silverdale,98383,4101,2018
kitsap,woodlands elementary,387,3,22,10,32,15,82,193,62,201,186,226,18401,bremerton,98311,4135,2018
spokane,adams elementary,427,10,11,7,18,15,51,314,19,227,200,190,32356,spokane valley,99037,3259,2018
spokane,bowdish middle,478,5,5,2,7,8,31,401,26,247,231,210,32356,spokane valley,99206,3260,2018
spokane,broadway elementary,401,8,3,13,16,16,66,274,21,214,187,282,32356,spokane valley,99206,2892,2018
spokane,central valley early learning center,107,3,4,0,4,4,9,81,6,65,42,57,32356,spokane valley,99206,5043,2018
spokane,central valley high,2192,14,67,26,93,23,131,1837,94,1126,1066,495,32356,spokane valley,99037,3065,2018
spokane,chester elementary,504,6,5,6,11,11,29,435,12,273,231,108,32356,spokane valley,99206,3929,2018
spokane,cvsd open doors programs,42,2,0,1,1,2,3,33,1,19,23,31,32356,spokane valley,99016,5328,2018
spokane,evergreen middle,777,10,19,7,26,10,58,651,22,414,363,208,32356,spokane valley,99206,3890,2018
spokane,greenacres elementary,633,4,20,11,31,6,44,521,27,339,294,261,32356,spokane valley,99016,2157,2018
spokane,greenacres middle,777,2,13,2,15,8,57,660,35,407,370,175,32356,spokane valley,99016,3573,2018
spokane,horizon middle,482,2,4,1,5,5,28,422,20,270,212,103,32356,spokane valley,99206,4185,2018
spokane,liberty creek elementary,586,4,4,4,8,7,55,492,20,286,300,133,32356,liberty lake,99019,5507,2018
spokane,liberty lake elementary,570,5,11,4,15,6,29,500,15,299,271,117,32356,liberty lake,99019,4529,2018
spokane,mcdonald elementary,310,5,2,14,16,12,29,233,15,180,130,177,32356,spokane valley,99216,3127,2018
spokane,mica peak high,194,3,1,4,5,2,15,159,10,96,98,87,32356,spokane valley,99037,3918,2018
spokane,north pines middle,518,6,10,24,34,15,61,372,30,273,245,346,32356,spokane valley,99206,2776,2018
spokane,opportunity elementary,552,16,7,7,14,22,54,418,28,291,261,343,32356,spokane valley,99206,2113,2018
spokane,ponderosa elementary,426,4,1,0,1,13,22,369,17,215,211,94,32356,spokane valley,99206,4098,2018
spokane,progress elementary,344,5,3,12,15,7,43,252,22,166,178,181,32356,spokane valley,99037,2953,2018
spokane,school to life,35,0,0,0,0,0,2,31,2,20,15,23,32356,spokane valley,99037,5003,2018
spokane,south pines elementary,316,4,5,1,6,10,36,252,8,178,138,135,32356,spokane valley,99206,3307,2018
spokane,spokane valley learning academy,47,0,0,0,0,0,1,45,1,16,31,21,32356,spokane valley,99216,1964,2018
spokane,summit,418,5,9,0,9,3,12,379,10,221,197,93,32356,spokane valley,99216,3465,2018
spokane,sunrise elementary,625,5,12,2,14,10,30,551,15,315,310,94,32356,spokane valley,99206,4160,2018
spokane,university elementary,297,6,6,1,7,9,36,224,15,144,153,141,32356,spokane valley,99206,3064,2018
spokane,university high,1812,29,18,14,32,42,106,1496,107,941,871,557,32356,spokane valley,99216,3415,2018
lewis,centralia high,1096,11,8,3,11,15,348,682,29,567,529,557,21401,centralia,98531,2166,2018
lewis,centralia middle,492,2,4,1,5,10,162,298,15,262,230,336,21401,centralia,98531,3240,2018
lewis,early learning center,72,1,0,0,0,1,11,58,1,48,24,57,21401,centralia,98531,5463,2018
lewis,edison elementary,341,1,5,0,5,0,134,177,24,172,169,224,21401,centralia,98531,2244,2018
lewis,fords prairie elementary,378,1,0,2,2,2,130,232,11,201,177,275,21401,centralia,98531,2704,2018
lewis,futurus high,57,0,0,0,0,0,17,36,4,20,37,32,21401,centralia,98531,5359,2018
lewis,jefferson lincoln elementary,388,2,1,1,2,1,166,198,19,198,190,304,21401,centralia,98531,3172,2018
lewis,oakview elementary,440,1,1,1,2,4,148,265,20,227,213,322,21401,centralia,98531,2291,2018
lewis,washington elementary,371,2,1,0,1,2,177,176,13,179,192,283,21401,centralia,98531,2768,2018
lewis,chehalis middle,620,0,4,1,5,2,118,458,37,326,294,283,21302,chehalis,98532,4311,2018
lewis,lewis county alternative,22,0,0,0,0,0,7,14,1,9,13,21,21302,chehalis,98532,5369,2018
lewis,olympic elementary,422,3,4,2,6,0,85,300,28,221,201,196,21302,longview,98632,2726,2018
lewis,w f west high,973,3,20,0,20,12,149,735,54,481,492,302,21302,chehalis,98532,2799,2018
spokane,betz elementary,433,1,10,1,11,11,54,342,14,236,197,213,32360,cheney,99004,2954,2018
spokane,birth to three,64,0,0,0,0,3,10,51,0,40,24,25,32360,cheney,99004,5126,2018
spokane,cheney high,1306,18,23,6,29,18,146,1007,88,685,621,485,32360,cheney,99004,3610,2018
spokane,cheney middle,468,8,8,2,10,7,55,355,33,247,221,179,32360,cheney,99004,2447,2018
spokane,cheney open doors,9,0,0,0,0,0,2,7,0,3,6,3,32360,cheney,99004,5396,2018
spokane,homeworks,77,0,0,0,0,0,7,70,0,39,38,26,32360,cheney,99004,5035,2018
spokane,phil snowdon elementary,497,5,5,3,8,5,46,397,36,241,256,227,32360,cheney,99004,5294,2018
spokane,salnave elementary,374,3,2,0,2,3,51,299,16,192,182,214,32360,cheney,99004,3761,2018
spokane,sunset elementary,459,17,17,15,32,7,65,304,34,250,209,338,32360,airway heights,99001,2814,2018
spokane,three springs high,39,3,0,0,0,1,2,32,1,17,22,23,32360,cheney,99004,1769,2018
spokane,westwood middle,578,15,11,8,19,20,54,427,43,310,268,273,32360,spokane,99224,5269,2018
spokane,windsor elementary,538,6,2,1,3,1,38,439,51,283,255,202,32360,spokane,99224,3309,2018
stevens,chewelah alternative educational programs,58,1,0,0,0,0,0,53,4,26,32,37,33036,chewelah,99109,1763,2018
stevens,gess elementary,312,3,3,1,4,0,17,274,14,162,150,195,33036,chewelah,99109,2664,2018
stevens,jenkins junior/senior high,388,2,2,0,2,3,8,366,7,210,178,168,33036,chewelah,99109,2404,2018
jefferson,chimacum creek primary,202,1,1,0,1,0,17,167,16,110,92,97,16049,chimacum,98325,4552,2018
jefferson,chimacum elementary,199,2,1,0,1,1,11,164,20,115,84,112,16049,chimacum,98325,2697,2018
jefferson,chimacum high,324,5,4,0,4,4,24,260,27,144,180,110,16049,chimacum,98325,3275,2018
jefferson,chimacum middle,186,1,4,1,5,0,19,148,13,112,74,91,16049,chimacum,98325,4261,2018
jefferson,open doors reengagement program,13,0,0,0,0,0,2,11,0,8,5,8,16049,chimacum,98325,5397,2018
jefferson,pi program,63,1,0,0,0,0,10,51,1,31,32,25,16049,chimacum,98325,1724,2018
asotin,charles francis adams high,796,25,10,2,12,16,50,676,17,387,409,304,02250,clarkston,99403,2299,2018
asotin,educational opportunity center,101,3,1,0,1,3,9,85,0,51,50,63,02250,clarkston,99403,1617,2018
asotin,educational opportunity center reengagement,13,1,0,0,0,0,1,11,0,8,5,8,02250,clarkston,99403,5413,2018
asotin,grantham elementary,238,3,0,0,0,2,18,195,20,127,111,187,02250,clarkston,99403,2962,2018
asotin,heights elementary,344,0,1,0,1,4,19,296,24,153,191,110,02250,clarkston,99403,4384,2018
asotin,highland elementary,303,6,7,0,7,3,42,225,20,146,157,234,02250,clarkston,99403,3266,2018
asotin,lincoln middle,401,9,4,0,4,7,29,334,18,209,192,223,02250,clarkston,99403,2501,2018
asotin,parkway elementary,335,10,4,0,4,7,26,275,13,173,162,222,02250,clarkston,99403,2823,2018
asotin,special services,75,0,3,0,3,1,4,62,5,47,28,19,02250,clarkston,99403,3616,2018
kittitas,cle elum roslyn elementary,445,3,2,0,2,2,37,377,24,223,222,166,19404,cle elum,98922,2328,2018
kittitas,cle elum roslyn high,264,0,7,0,7,0,24,220,12,139,125,68,19404,cle eum,98922,2329,2018
kittitas,swiftwater learning center,24,0,0,0,0,0,2,19,3,12,12,13,19404,cle elum,98922,1987,2018
kittitas,walter strom middle,183,2,2,0,2,2,20,151,6,99,84,67,19404,cle elum,98922,2570,2018
pierce,alfaretta house,154,1,4,1,5,12,47,71,18,99,55,71,27400,lakewood,98499,1825,2018
pierce,beachwood elementary,328,3,12,10,22,31,79,153,40,149,179,137,27400,jblm lewis north,98433,3454,2018
pierce,carter lake elementary,483,1,12,6,18,47,120,253,44,256,227,203,27400,jblm mcchord field,98439,3457,2018
pierce,clover park early learning program,11,0,1,1,2,3,4,2,0,9,2,14,27400,lakewood,98499,5386,2018
pierce,clover park high,1280,6,79,109,188,166,534,238,147,662,618,901,27400,lakewood,98499,2425,2018
pierce,cpsd open doors program,152,3,4,6,10,18,51,47,23,86,66,92,27400,lakewood,98499,5411,2018
pierce,custer elementary,320,3,10,16,26,71,73,112,35,166,154,222,27400,lakewood,98498,2943,2018
pierce,dower elementary,310,2,9,18,27,54,76,87,64,181,129,229,27400,lakewood,98499,3455,2018
pierce,evergreen elementary,538,3,15,13,28,51,145,251,60,315,223,312,27400,jblm lewis main,98433,4396,2018
pierce,four heroes elementary,708,0,16,34,50,60,398,113,87,350,358,641,27400,lakewood,98499,5387,2018
pierce,harrison prep,689,1,43,12,55,68,260,214,91,312,377,353,27400,lakewood,98499,5027,2018
pierce,hillside elementary,539,4,14,23,37,82,147,212,56,293,246,347,27400,jblm lewis main,98433,3298,2018
pierce,hudtloff middle,752,5,40,27,67,80,302,187,111,410,342,492,27400,lakewood,98498,3248,2018
pierce,idlewild elementary,507,3,21,6,27,30,103,252,92,263,244,178,27400,lakewood,98498,3117,2018
pierce,lake louise elementary,430,3,5,27,32,38,90,138,129,215,215,295,27400,lakewood,98498,3351,2018
pierce,lakes high,1372,8,87,48,135,193,293,540,203,728,644,601,27400,lakewood,98498,3456,2018
pierce,lakeview hope academy,672,0,20,46,66,88,350,92,76,355,317,533,27400,lakewood,98499,2652,2018
pierce,lochburn middle,607,4,38,53,91,85,245,101,81,342,265,501,27400,lakewood,98499,3602,2018
pierce,mann middle,395,5,4,18,22,43,103,142,80,207,188,219,27400,lakewood,98498,3297,2018
pierce,meriwether elementary,338,1,10,8,18,35,82,154,48,164,174,104,27400,jblm lewis north,98433,5364,2018
pierce,oakbrook elementary,360,2,28,12,40,37,85,131,65,182,178,208,27400,lakewood,98498,3763,2018
pierce,park lodge elementary,461,6,9,17,26,73,208,80,68,234,227,384,27400,lakewood,98499,2189,2018
pierce,rainier elementary,492,1,18,10,28,71,139,198,55,259,233,249,27400,jblm lewis main,98433,5365,2018
pierce,special education services/relife,12,0,0,0,0,3,2,6,1,9,3,9,27400,lakewood,98499,1882,2018
pierce,tillicum elementary,347,4,5,31,36,28,136,97,46,179,168,320,27400,lakewood,98498,2651,2018
pierce,transition day students,8,0,0,0,0,0,0,8,0,7,1,3,27400,lakewood,98499,5297,2018
pierce,tyee park elementary,454,1,7,47,54,62,188,70,79,227,227,354,27400,lakewood,98499,3249,2018
pierce,woodbrook middle,509,2,26,30,56,76,151,158,66,274,235,363,27400,lakewood,98439,3500,2018
whitman,colfax high,290,0,2,0,2,0,7,266,15,159,131,87,38300,colfax,99111,3366,2018
whitman,leonard m jennings elementary,297,0,3,0,3,0,11,261,22,156,141,93,38300,colfax,99111,2894,2018
walla walla,college place high,417,0,2,6,8,6,146,242,15,219,198,167,36250,college place,99362,5362,2018
walla walla,davis elementary,670,1,4,4,8,9,304,326,22,333,337,372,36250,college place,99324,2114,2018
walla walla,john sager middle,356,2,3,1,4,0,160,175,15,179,177,199,36250,college place,99324,3541,2018
whitman,colton,159,0,2,0,2,0,3,148,6,88,71,41,38306,colton,99113,2588,2018
stevens,columbia high and elementary,132,32,1,0,1,0,19,65,15,70,62,105,33206,hunters,99137,3508,2018
walla walla,columbia elementary,363,4,0,0,0,2,132,218,5,194,169,214,36400,burbank,99323,3613,2018
walla walla,columbia high,232,1,0,0,0,2,72,150,7,117,115,94,36400,burbank,99323,4049,2018
walla walla,columbia middle,166,0,0,0,0,2,66,93,5,76,90,90,36400,burbank,99323,3012,2018
stevens,colville junior high,403,6,3,1,4,1,16,360,15,208,195,192,33115,colville,99114,3831,2018
stevens,colville senior high,509,7,3,0,3,4,24,441,30,246,263,202,33115,colville,99114,3310,2018
stevens,fort colville elementary,283,5,0,0,0,3,24,243,8,143,140,157,33115,colville,99114,4180,2018
stevens,hofstetter elementary,386,1,2,0,2,2,16,349,16,196,190,216,33115,colville,99114,2957,2018
stevens,panorama,114,2,0,0,0,0,9,101,2,63,51,68,33115,colville,99114,1594,2018
skagit,concrete elementary,296,10,1,0,1,3,29,250,3,155,141,197,29011,concrete,98237,2577,2018
skagit,concrete high,236,5,3,1,4,0,23,201,3,134,102,126,29011,concrete,98237,2810,2018
skagit,special services,9,1,1,0,1,0,0,7,0,6,3,6,29011,concrete,98237,5087,2018
skagit,twin cedars high,7,0,0,0,0,0,0,7,0,4,3,9,29011,concrete,98237,1605,2018
skagit,conway,454,0,3,0,3,6,63,379,3,226,228,95,29317,mount vernon,98274,2578,2018
grays harbor,cosmopolis elementary,152,0,1,0,1,0,18,116,17,77,75,79,14099,cosmopolis,98537,3326,2018
grant,almira coulee hartline high,83,0,0,0,0,0,1,82,0,40,43,26,13151,coulee city,99115,2968,2018
grant,coulee city elementary,83,0,0,0,0,2,2,77,2,53,30,39,13151,coulee city,99115,2693,2018
island,coupeville elementary,443,0,5,0,5,4,68,306,60,207,236,155,15204,coupeville,98239,3664,2018
island,coupeville high,274,0,5,0,5,4,34,206,25,133,141,74,15204,coupeville,98239,2625,2018
island,coupeville middle,227,0,4,1,5,3,29,154,36,94,133,70,15204,coupeville,98239,4004,2018
island,open den,54,1,0,0,0,1,5,41,6,26,28,29,15204,coupeville,98239,5412,2018
clallam,crescent,215,0,0,0,0,0,9,183,23,114,101,119,05313,joyce,98343,3473,2018
clallam,homeconnection,97,0,1,0,1,0,7,87,2,44,53,36,05313,joyce,98343,5030,2018
lincoln,creston elementary,40,1,0,0,0,0,2,34,3,21,19,15,22073,creston,99117,2862,2018
lincoln,creston jr-sr high,50,1,0,0,0,1,3,43,2,30,20,9,22073,creston,99117,2863,2018
ferry,curlew elem & high,174,4,0,0,0,8,12,143,7,83,91,108,10050,curlew,99118,2006,2018
pend oreille,bess herian elementary,114,20,1,0,1,0,11,58,24,61,53,72,26059,cusick,99119,2770,2018
pend oreille,cusick jr sr high,160,39,0,0,0,0,12,98,11,84,76,76,26059,cusick,99119,2423,2018
kittitas,damman elementary,33,3,1,0,1,1,1,27,0,18,15,0,19007,ellensburg,98926,2077,2018
snohomish,darrington elementary,296,12,1,0,1,2,28,233,20,141,155,138,31330,darrington,98241,3609,2018
snohomish,darrington high,122,7,2,0,2,1,5,98,9,65,57,35,31330,darrington,98241,3188,2018
lincoln,davenport elementary,280,5,3,0,3,1,8,255,8,134,146,156,22207,davenport,99122,2668,2018
lincoln,davenport senior high,331,9,3,0,3,1,8,306,4,165,166,158,22207,davenport,99122,3173,2018
columbia,dayton elementary,204,2,1,0,1,2,37,158,4,103,101,133,07002,dayton,99328,2830,2018
columbia,dayton high,131,3,4,0,4,0,19,103,2,68,63,49,07002,dayton,99328,2302,2018
columbia,dayton middle,88,1,2,0,2,1,12,71,1,48,40,34,07002,dayton,99328,4011,2018
spokane,arcadia elementary,459,14,0,0,0,8,30,405,2,247,212,250,32414,deer park,99006,2173,2018
spokane,deer park early learning center,15,0,0,0,0,0,0,15,0,14,1,31,32414,deer park,99006,5270,2018
spokane,deer park elementary,416,11,0,0,0,8,20,377,0,200,216,229,32414,deer park,99006,2430,2018
spokane,deer park high,672,14,6,0,6,11,39,594,8,343,329,294,32414,deer park,99006,4123,2018
spokane,deer park home link program,496,3,2,1,3,7,30,451,2,251,245,102,32414,deer park,99006,1852,2018
spokane,deer park middle,453,7,3,1,4,4,26,411,1,236,217,229,32414,deer park,99006,3261,2018
pierce,dieringer heights elementary,483,2,30,4,34,8,46,343,50,275,208,61,27343,lake tapps,98391,4548,2018
pierce,lake tapps elementary,463,2,30,1,31,11,45,324,50,222,241,64,27343,lake tapps,98391,3683,2018
pierce,north tapps middle,526,3,28,0,28,7,43,405,40,261,265,51,27343,lake tapps,98391,4416,2018
spokane,children first,24,0,0,1,1,0,5,17,1,11,13,11,32361,spokane valley,99216,1937,2018
spokane,continuous curriculum,511,2,8,0,8,7,30,435,29,236,275,156,32361,spokane,99216,1712,2018
spokane,east farms,439,3,5,9,14,7,44,339,32,228,211,229,32361,newman lake,99025,4097,2018
spokane,east valley high,1145,17,12,10,22,7,118,913,68,614,531,505,32361,spokane valley,99216,3360,2018
spokane,east valley middle,503,6,6,5,11,4,58,392,32,252,251,260,32361,spokane valley,99216,5346,2018
spokane,ev online,77,0,0,0,0,1,3,69,3,39,38,33,32361,spokane valley,99216,5432,2018
spokane,ev parent partnership,188,1,1,0,1,1,20,160,5,91,97,71,32361,spokane valley,99216,5433,2018
spokane,otis orchards,426,2,3,1,4,8,37,351,24,216,210,275,32361,otis orchards,99027,2955,2018
spokane,trent,485,10,4,9,13,15,85,307,55,269,216,391,32361,spokane valley,99206,2653,2018
spokane,trentwood,465,9,6,2,8,2,50,359,37,247,218,273,32361,spokane valley,99216,3128,2018
yakima,east valley central middle,772,8,8,0,8,6,365,364,21,390,382,431,39090,yakima,98901,4055,2018
yakima,east valley elementary,570,1,1,1,2,4,284,261,18,311,259,375,39090,yakima,98901,4487,2018
yakima,east valley high,877,11,12,1,13,9,394,440,10,467,410,402,39090,yakima,98901,2344,2018
yakima,moxee elementary,524,0,2,0,2,2,323,184,13,262,262,298,39090,moxee,98936,2530,2018
yakima,terrace heights elementary,511,1,6,0,6,5,213,264,22,258,253,290,39090,yakima,98901,2821,2018
douglas,cascade elementary,513,1,4,0,4,0,179,312,17,258,255,214,09206,east wenatchee,98802,3659,2018
douglas,clovis point,644,3,0,1,1,1,352,275,12,342,302,398,09206,east wenatchee,98802,4590,2018
douglas,eastmont junior high,937,4,9,2,11,5,444,441,32,468,469,516,09206,east wenatchee,98802,3372,2018
douglas,eastmont preschools,69,1,1,0,1,0,30,37,0,55,14,0,09206,east wenatchee,98802,5130,2018
douglas,eastmont senior high,1443,4,17,3,20,8,626,746,39,729,714,651,09206,east wenatchee,98802,2727,2018
douglas,grant elementary,514,0,4,1,5,0,260,238,11,261,253,285,09206,east wenatchee,98802,2966,2018
douglas,kenroy elementary,477,0,4,1,5,0,222,232,18,239,238,294,09206,east wenatchee,98802,3212,2018
douglas,lee elementary,468,1,3,0,3,0,240,205,19,231,237,354,09206,east wenatchee,98802,3083,2018
douglas,rock island elementary,223,1,0,0,0,0,158,60,4,124,99,188,09206,rock island,98850,2563,2018
douglas,sterling,952,5,5,1,6,1,411,503,26,468,484,524,09206,east wenatchee,98802,4095,2018
kittitas,easton,110,1,0,0,0,0,28,75,6,55,55,62,19028,easton,98925,3554,2018
pierce,columbia crest a-stem academy,182,1,3,0,3,1,11,150,16,91,91,105,27404,ashford,98304,2808,2018
pierce,eatonville developmental pre-school,12,0,0,0,0,0,1,10,1,7,5,5,27404,eatonville,98328,5079,2018
pierce,eatonville elementary,382,2,2,1,3,1,32,324,20,190,192,187,27404,eatonville,98328,2205,2018
pierce,eatonville high,633,7,3,3,6,5,48,541,26,324,309,197,27404,eatonville,98328,2206,2018
pierce,eatonville middle,388,3,3,3,6,5,23,322,29,201,187,124,27404,eatonville,98328,4230,2018
pierce,mt. rainier parent partnership,38,0,0,0,0,0,7,31,0,22,16,10,27404,eatonville,98328,5300,2018
pierce,new beginnings,10,0,0,0,0,0,0,8,2,7,3,7,27404,eatonville,98328,5332,2018
pierce,weyerhaeuser elementary,274,1,1,0,1,1,20,230,21,138,136,118,27404,eatonville,98328,2361,2018
snohomish,alderwood middle,826,6,152,10,162,48,231,316,63,415,411,364,31015,lynnwood,98037,3560,2018
snohomish,beverly elementary,581,9,59,12,71,45,139,241,76,304,277,242,31015,lynnwood,98037,3302,2018
snohomish,brier elementary,454,2,37,2,39,11,62,288,52,234,220,51,31015,brier,98036,3536,2018
snohomish,brier terrace middle,637,4,102,4,106,29,93,335,70,326,311,168,31015,brier,98036,3650,2018
snohomish,cedar valley community,438,3,36,1,37,47,238,92,21,234,204,338,31015,lynnwood,98036,3409,2018
snohomish,cedar way elementary,561,1,68,5,73,75,100,230,82,286,275,281,31015,mtlk terrace,98043,3304,2018
snohomish,challenge elementary,331,0,97,0,97,19,21,158,36,186,145,30,31015,mtlk terrace,98043,1520,2018
snohomish,chase lake elementary,373,1,23,9,32,33,95,165,47,211,162,205,31015,edmonds,98020,3534,2018
snohomish,college place elementary,497,7,41,9,50,70,208,119,43,267,230,336,31015,lynnwood,98036,3691,2018
snohomish,college place middle,453,5,42,3,45,31,128,201,43,249,204,186,31015,lynnwood,98036,3754,2018
snohomish,contracted schools,207,0,18,0,18,20,50,95,24,130,77,37,31015,lynnwood,98036,1830,2018
snohomish,early childhood center,170,1,15,0,15,16,31,77,30,114,56,82,31015,lynnwood,98036,3185,2018
snohomish,edmonds career access program,268,2,14,2,16,13,83,127,27,132,136,56,31015,lynnwood,98036,5358,2018
snohomish,edmonds elearning academy,70,1,4,1,5,0,7,48,9,32,38,42,31015,lynnwood,98036,1519,2018
snohomish,edmonds elementary,334,1,12,0,12,12,31,236,42,179,155,47,31015,edmonds,98020,3606,2018
snohomish,edmonds heights k-12,545,1,30,1,31,7,57,384,65,274,271,73,31015,edmonds,98020,1966,2018
snohomish,edmonds woodway high,1640,11,236,3,239,111,299,825,155,828,812,443,31015,edmonds,98026,3123,2018
snohomish,hazelwood elementary,488,3,84,0,84,32,91,230,48,262,226,133,31015,lynnwood,98036,3607,2018
snohomish,hilltop elementary,526,1,89,4,93,17,55,297,63,281,245,98,31015,lynnwood,98036,3689,2018
snohomish,lynndale elementary,437,4,39,2,41,32,121,198,41,240,197,186,31015,lynnwood,98036,3122,2018
snohomish,lynnwood elementary,525,2,95,7,102,31,123,211,56,277,248,230,31015,lynnwood,98037,3503,2018
snohomish,lynnwood high,1417,8,327,11,338,98,333,513,127,729,688,539,31015,bothell,98012,3755,2018
snohomish,madrona k-8,633,1,58,0,58,35,83,382,74,301,332,78,31015,lynnwood,98036,3463,2018
snohomish,maplewood parent coop,479,0,41,2,43,32,30,330,44,259,220,50,31015,edmonds,98026,1685,2018
snohomish,martha lake elementary,467,4,114,16,130,27,106,163,37,233,234,202,31015,lynnwood,98037,2887,2018
snohomish,meadowdale elementary,531,1,81,2,83,52,130,205,60,281,250,222,31015,lynnwood,98037,3504,2018
snohomish,meadowdale high,1622,8,236,14,250,109,329,793,133,861,761,459,31015,lynnwood,98037,3464,2018
snohomish,meadowdale middle,741,4,99,8,107,55,172,324,79,383,358,293,31015,lynnwood,98037,3353,2018
snohomish,mountlake terrace elementary,402,1,38,10,48,16,112,180,45,221,181,166,31015,mountlake terrace,98043,3254,2018
snohomish,mountlake terrace high,1363,5,151,12,163,69,222,757,147,726,637,333,31015,mtlk terrace,98043,3303,2018
snohomish,oak heights elementary,625,1,95,2,97,40,130,294,63,294,331,232,31015,lynnwood,98037,3608,2018
snohomish,scriber lake high,244,1,12,2,14,15,54,141,19,127,117,124,31015,edmonds,98020,3854,2018
snohomish,seaview elementary,400,0,20,0,20,12,54,252,62,221,179,86,31015,edmonds,98020,3461,2018
snohomish,sherwood elementary,533,3,25,1,26,23,87,325,69,260,273,127,31015,edmonds,98020,3605,2018
snohomish,spruce elementary,542,2,83,11,94,79,138,172,57,287,255,297,31015,lynnwood,98037,3410,2018
snohomish,terrace park elementary,325,1,30,6,36,23,68,157,40,166,159,104,31015,mtlk terrace,98043,2888,2018
snohomish,unassigned,55,2,2,0,2,0,14,32,5,35,20,6,31015,lynnwood,98036,1558,2018
snohomish,westgate elementary,505,2,39,8,47,36,81,269,70,259,246,160,31015,edmonds,98020,3186,2018
spokane,newesd 101 open doors,128,11,1,0,1,13,15,84,4,72,56,13,32801,spokane,99202,5434,2018
spokane,structural alt confinement,20,0,0,0,0,4,0,16,0,10,10,31,32801,spokane,99205,3507,2018
clark,esd 112 open doors reengagement,111,1,1,1,2,2,16,80,10,67,44,0,06801,vancouver,98661,5398,2018
franklin,ugrad – esd123 re-engagement program,30,1,0,0,0,1,15,13,0,18,12,0,11801,pasco,99301,5403,2018
kittitas,ellensburg developmental preschool,85,0,0,0,0,1,28,53,3,53,32,1,19401,ellensburg,98926,1924,2018
kittitas,ellensburg high,997,6,15,2,17,9,163,777,25,491,506,327,19401,ellensburg,98926,2996,2018
kittitas,k-12 ellensburg learning center,20,0,1,0,1,0,2,15,2,8,12,6,19401,ellensburg,98926,5097,2018
kittitas,lincoln elementary,520,8,12,3,15,4,100,392,1,267,253,187,19401,ellensburg,98926,2741,2018
kittitas,morgan middle,724,9,11,2,13,10,132,543,17,370,354,276,19401,ellensburg,98926,2453,2018
kittitas,mt. stuart elementary,493,9,10,0,10,10,125,338,1,270,223,302,19401,ellensburg,98926,3596,2018
kittitas,valley view elementary,558,0,8,0,8,3,89,431,27,293,265,201,19401,ellensburg,98936,4411,2018
grays harbor,east grays harbor high,25,1,0,0,0,0,4,18,2,13,12,18,14068,elma,98541,1629,2018
grays harbor,east grays harbor open doors,26,0,0,0,0,0,4,21,1,13,13,19,14068,elma,98541,5416,2018
grays harbor,elma elementary,646,7,5,0,5,4,156,422,52,335,311,514,14068,elma,98541,3217,2018
grays harbor,elma high,470,3,3,0,3,0,75,345,44,238,232,324,14068,elma,98541,2137,2018
grays harbor,elma middle,323,4,4,0,4,3,71,216,25,166,157,229,14068,elma,98541,4245,2018
whitman,endicott/st john elem and middle,101,2,0,0,0,0,8,87,4,61,40,60,38308,endicott,99125,2207,2018
chelan,entiat middle and high,172,2,5,1,6,0,63,95,6,89,83,88,04127,entiat,98822,3317,2018
chelan,paul rumburg elementary,154,0,3,0,3,0,59,92,0,89,65,93,04127,entiat,98822,2688,2018
king,black diamond elementary,293,2,3,2,5,0,47,213,26,146,147,92,17216,black diamond,98010,3430,2018
king,byron kibler elementary,486,1,2,1,3,0,90,375,17,260,226,186,17216,enumclaw,98022,2980,2018
king,enumclaw middle,476,3,4,3,7,2,64,385,15,235,241,156,17216,enumclaw,98022,4210,2018
king,enumclaw sr high,1310,22,7,2,9,6,166,1055,52,702,608,308,17216,enumclaw,98022,3330,2018
king,southwood elementary,302,2,2,0,2,3,37,246,12,150,152,90,17216,enumclaw,98022,3739,2018
king,special ed,35,0,1,0,1,0,9,22,3,23,12,18,17216,enumclaw,98022,1523,2018
king,sunrise elementary,422,4,4,3,7,3,71,322,15,235,187,130,17216,enumclaw,98022,4289,2018
king,thunder mountain middle,464,6,5,2,7,6,95,328,22,248,216,116,17216,enumclaw,98022,4550,2018
king,westwood elementary,342,3,0,0,0,2,54,273,10,180,162,84,17216,enumclaw,98022,3585,2018
grant,beezley springs elementary,35,0,0,0,0,0,11,24,0,25,10,25,13165,ephrata,98823,4229,2018
grant,columbia ridge elementary,476,0,1,1,2,0,193,273,8,244,232,309,13165,ephrata,98823,2793,2018
grant,ephrata high,762,0,7,0,7,1,215,531,8,396,366,315,13165,ephrata,98823,2920,2018
grant,ephrata middle,374,1,3,0,3,4,110,246,10,182,192,190,13165,ephrata,98823,3373,2018
grant,grant elementary,506,0,0,0,0,3,172,323,8,267,239,284,13165,ephrata,98823,3092,2018
grant,parkway,400,1,2,0,2,1,124,266,6,212,188,211,13165,ephrata,98823,2695,2018
lewis,evaline elementary,58,0,0,0,0,0,10,43,5,36,22,32,21036,winlock,98596,2355,2018
snohomish,cascade high,1791,16,262,28,290,85,384,925,91,968,823,739,31002,everett,98203,3407,2018
snohomish,cedar wood elementary,752,1,297,1,298,19,54,331,49,397,355,58,31002,bothell,98012,4382,2018
snohomish,eisenhower middle,913,3,123,14,137,58,183,477,55,453,460,398,31002,everett,98208,3752,2018
snohomish,emerson elementary,661,0,76,8,84,46,228,248,55,331,330,430,31002,everett,98208,3184,2018
snohomish,everett high,1432,18,100,46,146,76,305,824,63,710,722,617,31002,everett,98201,2126,2018
snohomish,everett reengagement academy,59,2,3,0,3,5,11,35,3,37,22,32,31002,everett,98213,5330,2018
snohomish,evergreen middle,1058,1,92,11,103,53,295,546,60,533,525,591,31002,everett,98203,3253,2018
snohomish,forest view elementary,773,2,236,0,236,16,53,418,48,396,377,51,31002,everett,98208,5091,2018
snohomish,garfield elementary,409,6,11,11,22,8,126,201,46,200,209,264,31002,everett,98201,2065,2018
snohomish,gateway middle,892,2,217,2,219,25,75,496,75,455,437,92,31002,everett,98208,4437,2018
snohomish,hawthorne elementary school - everett,453,3,26,36,62,34,140,179,35,238,215,390,31002,everett,98201,2883,2018
snohomish,heatherwood middle,1006,4,163,8,171,29,160,561,81,521,485,231,31002,mill creek,98012,4334,2018
snohomish,henry m. jackson high,2195,7,428,6,434,75,290,1215,174,1119,1076,386,31002,mill creek,98012,4438,2018
snohomish,jackson elementary,342,2,9,2,11,17,81,191,40,175,167,220,31002,everett,98201,2751,2018
snohomish,jefferson elementary,543,0,66,0,66,16,75,346,40,273,270,204,31002,everett,98208,3533,2018
snohomish,lowell elementary - everett,522,3,42,4,46,13,151,258,51,265,257,339,31002,everett,98203,2811,2018
snohomish,madison elementary,420,0,33,13,46,18,169,153,34,215,205,303,31002,everett,98203,2669,2018
snohomish,mill creek elementary,667,3,148,1,149,18,61,379,57,352,315,78,31002,mill creek,98012,4316,2018
snohomish,monroe elementary,587,0,57,12,69,39,104,330,45,309,278,234,31002,everett,98208,3686,2018
snohomish,north middle,765,10,41,34,75,42,179,401,58,401,364,458,31002,everett,98201,2364,2018
snohomish,nw learning center,1,0,0,0,0,0,0,1,0,1,0,1,31002,everett,98213,1663,2018
snohomish,penny creek elementary,749,1,152,3,155,30,92,402,69,374,375,150,31002,everett,98208,4530,2018
snohomish,port gardner,125,0,5,0,5,2,9,100,9,57,68,18,31002,everett,98201,1907,2018
snohomish,sequoia high,182,2,3,7,10,9,34,109,18,77,105,113,31002,everett,98201,4137,2018
snohomish,silver firs elementary,527,2,89,4,93,12,77,304,39,275,252,92,31002,everett,98208,4298,2018
snohomish,silver lake elementary - everett,728,4,102,8,110,38,166,340,70,352,376,366,31002,everett,98208,2545,2018
snohomish,special services,175,0,15,1,16,3,33,116,7,109,66,19,31002,everett,98213,3903,2018
snohomish,view ridge elementary,587,0,30,5,35,17,104,383,48,293,294,224,31002,everett,98203,3002,2018
snohomish,whittier elementary,486,6,15,0,15,15,74,322,54,244,242,186,31002,everett,98201,2752,2018
snohomish,woodside elementary,660,0,79,1,80,23,175,315,67,332,328,215,31002,bothell,98012,4125,2018
clark,49th street academy,104,1,7,0,7,11,11,71,3,79,25,72,06114,vancouver,98682,1646,2018
clark,burnt bridge creek elementary,481,1,19,10,29,8,79,316,48,258,223,225,06114,vancouver,98682,4299,2018
clark,burton elementary,387,5,8,6,14,6,117,222,23,191,196,257,06114,vancouver,98682,3736,2018
clark,cascade middle,964,4,44,33,77,22,251,528,82,520,444,593,06114,vancouver,98684,3785,2018
clark,columbia valley elementary,571,1,51,3,54,25,112,318,61,309,262,230,06114,vancouver,98683,4587,2018
clark,covington middle,1082,6,38,27,65,27,306,594,84,530,552,698,06114,vancouver,98662,3320,2018
clark,crestline elementary,582,1,12,24,36,12,233,246,54,290,292,383,06114,vancouver,98683,3822,2018
clark,early childhood center,4,0,0,0,0,2,0,1,1,3,1,8,06114,vancouver,98682,1530,2018
clark,ellsworth elementary,407,2,18,7,25,13,131,183,53,204,203,234,06114,vancouver,98664,3148,2018
clark,endeavour elementary,712,3,35,29,64,20,207,352,66,367,345,423,06114,vancouver,98684,5136,2018
clark,evergreen high,1722,14,80,54,134,61,418,972,123,895,827,851,06114,vancouver,98684,2724,2018
clark,fircrest elementary,470,4,19,25,44,9,89,285,39,244,226,304,06114,vancouver,98684,3971,2018
clark,fishers landing elementary,593,3,109,1,110,15,51,358,56,286,307,109,06114,vancouver,98683,4499,2018
clark,frontier middle,814,5,38,17,55,16,155,534,49,412,402,363,06114,vancouver,98682,4498,2018
clark,harmony elementary,651,0,34,8,42,22,82,444,61,324,327,201,06114,vancouver,98684,4380,2018
clark,hearthwood elementary,460,0,19,6,25,12,89,279,55,260,200,261,06114,vancouver,98684,4163,2018
clark,henrietta lacks health and bioscience high,635,3,54,7,61,10,108,415,38,242,393,244,06114,vancouver,98664,5310,2018
clark,heritage high,1766,11,75,35,110,51,428,1065,101,959,807,870,06114,vancouver,98682,4523,2018
clark,home choice academy,152,0,7,0,7,0,20,115,10,79,73,58,06114,vancouver,98682,1926,2018
clark,illahee elementary,614,1,85,10,95,14,89,356,59,295,319,173,06114,camas,98607,4560,2018
clark,image elementary,687,2,29,16,45,20,146,402,72,364,323,394,06114,vancouver,98682,3994,2018
clark,legacy high,280,0,5,5,10,9,46,191,24,143,137,187,06114,vancouver,98684,4042,2018
clark,marrion elementary,527,0,6,11,17,15,215,236,44,280,247,364,06114,vancouver,98664,3618,2018
clark,mill plain elementary,476,4,18,14,32,17,152,224,47,243,233,285,06114,vancouver,98684,2829,2018
clark,mountain view high,1905,17,188,14,202,78,460,997,151,1014,891,685,06114,vancouver,98683,4162,2018
clark,open doors evergreen,13,0,0,1,1,0,2,10,0,8,5,8,06114,vancouver,98682,5435,2018
clark,orchards elementary,555,4,19,16,35,11,167,278,60,300,255,384,06114,vancouver,98662,2912,2018
clark,pacific middle,961,4,68,16,84,20,171,591,91,513,448,350,06114,vancouver,98684,4209,2018
clark,pioneer elementary,694,0,32,14,46,17,228,370,33,347,347,372,06114,vancouver,98682,4445,2018
clark,riverview elementary,463,3,20,3,23,12,108,269,48,234,229,197,06114,vancouver,98684,3995,2018
clark,shahala middle,1114,1,152,8,160,39,206,608,100,576,538,309,06114,vancouver,98683,4561,2018
clark,sifton elementary,480,0,20,7,27,4,142,268,39,221,259,303,06114,vancouver,98682,3149,2018
clark,silver star elementary,467,1,8,4,12,7,71,333,43,258,209,270,06114,vancouver,98662,3823,2018
clark,sunset elementary,537,4,25,7,32,20,84,357,40,300,237,304,06114,vancouver,98662,3970,2018
clark,union high,1990,9,224,29,253,48,265,1248,167,1047,943,492,06114,camas,98607,5111,2018
clark,wyeast middle,874,5,20,16,36,24,299,423,87,459,415,487,06114,vancouver,98683,4051,2018
clark,york elementary,518,0,24,2,26,4,92,356,40,264,254,197,06114,vancouver,98682,4579,2018
stevens,evergreen,33,10,0,0,0,0,0,14,9,16,17,25,33205,gifford,99131,3197,2018
king,adelaide elementary,382,0,29,43,72,35,116,107,52,220,162,239,17210,federal way,98023,3519,2018
king,birth to three development center,135,0,9,4,13,15,54,32,21,91,44,57,17210,federal way,98093,5279,2018
king,brigadoon elementary,370,2,31,7,38,44,98,119,69,198,172,212,17210,federal way,98023,3700,2018
king,camelot elementary,307,2,40,7,47,16,71,121,50,153,154,172,17210,auburn,98001,3547,2018
king,career academy at truman high,93,1,3,11,14,13,26,25,14,42,51,57,17210,federal way,98003,5163,2018
king,decatur high,1407,7,131,71,202,205,353,494,146,752,655,609,17210,federal way,98023,3766,2018
king,dynamic family services,6,0,0,0,0,0,1,3,2,5,1,5,17210,kent,98030,5280,2018
king,employment transition program,43,0,6,2,8,7,9,17,2,28,15,26,17210,federal way,98023,1950,2018
king,enterprise elementary,439,1,53,24,77,50,105,140,66,246,193,246,17210,federal way,98023,4470,2018
king,federal way high,1582,5,174,151,325,250,524,304,174,802,780,880,17210,federal way,98003,2417,2018
king,federal way public academy,310,1,47,1,48,19,53,136,53,159,151,85,17210,federal way,98003,1789,2018
king,federal way public school eceap,10,0,0,0,0,0,6,3,1,7,3,14,17210,federal way,98003,5218,2018
king,federal way public schools headstart,4,0,0,0,0,0,2,0,2,3,1,4,17210,federal way,98003,5219,2018
king,federal way running start home,2,0,0,0,0,0,0,1,1,2,0,0,17210,federal way,98003,5107,2018
king,gateway to college,36,0,1,1,2,5,17,6,6,20,16,10,17210,federal way,98003,5255,2018
king,green gables elementary,394,0,29,9,38,49,72,166,69,184,210,156,17210,federal way,98023,4426,2018
king,illahee middle,809,9,120,49,169,136,179,215,101,409,400,453,17210,federal way,98003,3898,2018
king,internet academy,252,3,12,6,18,15,37,149,30,106,146,76,17210,federal way,98003,1759,2018
king,kilo middle,604,3,69,13,82,38,211,190,80,283,321,373,17210,auburn,98001,3701,2018
king,lake dolloff elementary,489,7,60,34,94,73,106,126,83,261,228,342,17210,auburn,98001,3738,2018
king,lake grove elementary,428,5,24,20,44,47,164,99,69,215,213,308,17210,federal way,98023,3568,2018
king,lakeland elementary,435,1,46,18,64,46,73,208,43,206,229,226,17210,auburn,98001,2841,2018
king,lakota middle,783,2,62,37,99,105,200,254,123,411,372,402,17210,federal way,98023,3381,2018
king,mark twain elementary,537,0,60,46,106,114,231,51,35,267,270,429,17210,federal way,98003,3627,2018
king,meredith hill elementary,471,1,85,11,96,33,115,179,47,266,205,205,17210,auburn,98001,4480,2018
king,mirror lake elementary,487,1,40,29,69,138,134,90,55,247,240,375,17210,federal way,98003,3159,2018
king,nautilus k-8,544,0,45,30,75,52,159,186,72,268,276,282,17210,federal way,98003,3625,2018
king,olympic view elementary,450,2,14,30,44,55,230,72,47,258,192,365,17210,federal way,98023,3432,2018
king,open doors youth reengagement (1418),233,1,11,16,27,39,60,69,37,122,111,175,17210,federal way,98003,5348,2018
king,panther lake elementary,449,5,59,55,114,85,120,65,60,237,212,328,17210,federal way,98003,3329,2018
king,rainier view elementary,523,1,40,22,62,122,131,123,84,292,231,359,17210,federal way,98003,4422,2018
king,sacajawea middle,790,3,88,51,139,104,281,176,87,403,387,487,17210,federal way,98003,3626,2018
king,sequoyah middle,578,1,74,29,103,98,150,147,79,290,288,380,17210,auburn,98001,5029,2018
king,sherwood forest elementary,452,2,84,12,96,41,97,147,69,253,199,207,17210,federal way,98023,4374,2018
king,silver lake elementary school - federal way,428,1,33,29,62,103,124,82,56,223,205,286,17210,federal way,98023,4343,2018
king,star lake elementary,430,4,49,21,70,68,124,92,72,236,194,239,17210,kent,98031,3160,2018
king,sunnycrest elementary,620,4,68,33,101,77,259,102,77,314,306,442,17210,kent,98032,3567,2018
king,support,97,0,4,2,6,12,18,36,25,67,30,35,17210,federal way,98003,1951,2018
king,tafa at saghalie,696,4,66,42,108,98,233,166,87,397,299,411,17210,federal way,98023,5473,2018
king,thomas jefferson high,1699,4,337,61,398,217,454,452,174,837,862,849,17210,auburn,98001,3584,2018
king,todd beamer high,1611,6,232,84,316,201,332,539,217,813,798,722,17210,federal way,98003,4570,2018
king,totem middle,690,5,82,43,125,126,229,109,96,346,344,497,17210,kent,98031,3431,2018
king,twin lakes elementary,353,3,26,17,43,65,92,100,50,196,157,226,17210,federal way,98023,3628,2018
king,valhalla elementary,587,1,60,22,82,52,281,122,49,285,302,427,17210,auburn,98001,3582,2018
king,wildwood elementary,587,0,39,31,70,74,321,63,59,304,283,430,17210,federal way,98003,3583,2018
king,woodmont k-8,500,1,60,16,76,77,153,137,56,236,264,282,17210,des moines,98198,3328,2018
whatcom,beach elem,43,7,0,0,0,0,2,26,8,24,19,18,37502,lummi island,98262,2263,2018
whatcom,cascadia elementary,448,7,26,0,26,3,108,275,29,231,217,239,37502,ferndale,98248,5207,2018
whatcom,central elementary,342,1,10,3,13,2,79,213,34,182,160,180,37502,ferndale,98248,2458,2018
whatcom,custer elem,351,6,5,1,6,0,68,259,12,177,174,185,37502,custer,98240,2607,2018
whatcom,eagleridge elementary,474,111,8,0,8,2,85,211,57,244,230,306,37502,ferndale,98248,4482,2018
whatcom,ferndale high,1496,92,62,1,63,14,286,959,82,764,732,583,37502,ferndale,98248,2488,2018
whatcom,ferndale re-engagement,45,8,3,0,3,0,9,20,5,21,24,24,37502,ferndale,98248,5464,2018
whatcom,ferndale special services,69,17,3,0,3,0,14,28,7,47,22,8,37502,ferndale,98248,5084,2018
whatcom,horizon middle,448,50,12,1,13,5,86,259,35,260,188,250,37502,ferndale,98248,4554,2018
whatcom,skyline elementary,433,84,11,0,11,5,55,247,31,211,222,211,37502,ferndale,98248,4130,2018
whatcom,vista middle,605,33,25,3,28,6,131,361,46,289,316,294,37502,ferndale,98248,3762,2018
whatcom,windward high,92,4,3,0,3,1,6,71,7,35,57,23,37502,ferndale,98248,5245,2018
pierce,columbia junior high,596,3,50,29,79,28,131,284,71,298,298,236,27417,tacoma,98424,4582,2018
pierce,discovery primary,632,5,40,36,76,29,136,273,113,349,283,289,27417,milton,98354,2878,2018
pierce,endeavour intermediate,583,4,54,40,94,33,139,228,85,290,293,324,27417,milton,98354,2809,2018
pierce,fife high,863,6,77,42,119,37,147,454,100,444,419,308,27417,tacoma,98424,2773,2018
pierce,hedden elementary,567,3,36,17,53,22,98,298,93,294,273,200,27417,edgewood,98372,4557,2018
pierce,surprise lake middle,600,4,55,32,87,29,120,280,80,292,308,237,27417,milton,98354,3798,2018
benton,finley elementary,382,0,0,0,0,0,170,194,18,191,191,278,03053,kennewick,99337,3078,2018
benton,finley middle,202,0,0,0,0,1,96,100,5,113,89,151,03053,kennewick,99337,4031,2018
benton,river view high,339,1,2,0,2,2,147,174,13,190,149,224,03053,kennewick,99337,2367,2018
pierce,brookdale elementary,467,6,38,44,82,28,119,146,86,233,234,343,27402,tacoma,98444,3180,2018
pierce,central avenue elementary,476,3,46,5,51,18,96,239,69,247,229,289,27402,tacoma,98446,2398,2018
pierce,christensen elementary,460,4,26,44,70,65,134,124,63,225,235,368,27402,tacoma,98444,3301,2018
pierce,collins elementary,444,6,29,8,37,22,104,227,48,218,226,258,27402,tacoma,98446,2257,2018
pierce,elmhurst elementary,453,3,19,25,44,50,99,156,101,251,202,301,27402,tacoma,98445,3532,2018
pierce,franklin pierce high,1202,6,94,42,136,107,300,527,126,641,561,674,27402,tacoma,98445,2876,2018
pierce,gates secondary,136,3,3,15,18,19,27,45,24,65,71,99,27402,tacoma,98444,4063,2018
pierce,harvard elementary,436,1,32,13,45,22,254,59,55,202,234,368,27402,tacoma,98445,3000,2018
pierce,james sales elementary,452,7,10,29,39,52,143,128,83,229,223,369,27402,tacoma,98444,2945,2018
pierce,midland elementary,584,6,30,32,62,56,168,165,127,303,281,465,27402,tacoma,98445,2340,2018
pierce,morris ford middle,925,7,81,30,111,74,272,344,117,496,429,615,27402,tacoma,98445,3300,2018
pierce,perry g keithley middle,811,8,28,64,92,106,235,236,134,415,396,607,27402,tacoma,98444,3401,2018
pierce,washington high,990,12,43,99,142,130,255,322,129,471,519,654,27402,tacoma,98444,3648,2018
spokane,freeman elementary,365,1,1,1,2,1,15,341,5,194,171,95,32358,rockford,99030,3794,2018
spokane,freeman high,336,2,10,0,10,3,20,298,3,162,174,57,32358,rockford,99030,3192,2018
spokane,freeman middle,203,1,5,1,6,3,11,176,6,115,88,52,32358,rockford,99030,4593,2018
whitman,garfield at palouse high,28,0,0,0,0,0,2,26,0,14,14,10,38302,palouse,99161,1962,2018
whitman,garfield elementary,59,1,0,0,0,0,3,53,2,32,27,28,38302,garfield,99130,2895,2018
whitman,garfield middle,26,0,0,0,0,0,2,23,1,13,13,10,38302,garfield,99130,2896,2018
klickitat,glenwood elementary,29,3,0,0,0,1,4,16,5,20,9,23,20401,glenwood,98619,3047,2018
klickitat,glenwood secondary,40,3,0,0,0,0,1,26,10,22,18,16,20401,glenwood,98619,3048,2018
klickitat,goldendale high,305,18,2,0,2,1,43,229,12,164,141,113,20404,goldendale,98620,2856,2018
klickitat,goldendale middle,294,13,4,0,4,3,37,226,11,156,138,174,20404,goldendale,98620,3393,2018
klickitat,goldendale primary,363,13,2,1,3,2,52,268,25,192,171,225,20404,goldendale,98620,2677,2018
klickitat,goldendale support service center,17,4,0,0,0,0,3,9,1,11,6,11,20404,goldendale,98620,5012,2018
grant,lake roosevelt elementary,382,124,1,0,1,1,45,120,91,195,187,290,13301,coulee dam,99116,2802,2018
grant,lake roosevelt jr/sr high,342,144,1,0,1,1,31,95,70,194,148,215,13301,coulee dam,99116,2801,2018
yakima,contract learning center,24,0,0,0,0,0,19,5,0,9,15,20,39200,grandview,98930,1776,2018
yakima,grandview high,915,0,1,0,1,1,849,62,2,449,466,646,39200,grandview,98930,2555,2018
yakima,grandview middle,857,0,1,0,1,0,795,59,2,448,409,691,39200,grandview,98930,3071,2018
yakima,mcclure elementary,546,0,0,0,0,1,513,30,2,285,261,458,39200,grandview,98930,2345,2018
yakima,smith elementary,460,0,1,0,1,0,423,31,5,238,222,347,39200,grandview,98930,3013,2018
yakima,step up to college open doors high,10,0,0,0,0,0,9,1,0,3,7,14,39200,grandview,98930,5399,2018
yakima,thompson elementary,586,0,0,0,0,1,520,65,0,292,294,476,39200,grandview,98930,2756,2018
yakima,granger high,429,14,0,0,0,0,393,17,5,220,209,376,39204,granger,98932,3314,2018
yakima,roosevelt elementary,590,18,0,0,0,2,545,20,5,278,312,556,39204,granger,98932,4535,2018
snohomish,crossroads high,165,7,0,0,0,4,13,131,10,79,86,113,31332,granite falls,98252,5171,2018
snohomish,granite falls high,518,3,2,3,5,4,49,430,27,283,235,144,31332,granite falls,98252,2580,2018
snohomish,granite falls middle,399,9,2,2,4,8,38,324,16,223,176,165,31332,granite falls,98252,4113,2018
snohomish,granite falls open doors,91,3,2,1,3,3,13,61,8,39,52,75,31332,granite falls,98252,5349,2018
snohomish,monte cristo elementary,461,10,3,0,3,7,49,369,23,216,245,214,31332,granite falls,98252,4479,2018
snohomish,mountain way elementary,402,10,1,0,1,2,40,339,10,210,192,196,31332,granite falls,98252,4330,2018
mason,grapeview elementary & middle,220,2,4,2,6,1,16,177,18,128,92,106,23054,grapeview,98546,2145,2018
spokane,great northern elementary,53,1,0,0,0,0,2,48,2,25,28,8,32312,spokane,99224,2097,2018
pierce,destiny middle,278,6,5,15,20,73,66,62,51,139,139,172,27904,tacoma,98404,5378,2018
king,excel public charter,161,0,10,1,11,72,14,52,12,91,70,86,17906,kent,98031,5377,2018
clark,green mountain,162,2,1,0,1,0,7,145,7,81,81,60,06103,woodland,98674,2484,2018
thurston,griffin,657,8,12,0,12,9,59,511,58,337,320,131,34324,olympia,98502,2406,2018
lincoln,harrington elementary,63,3,0,0,0,1,2,52,5,41,22,43,22204,harrington,99134,2743,2018
lincoln,harrington high,57,2,1,0,1,1,2,49,2,31,26,30,22204,harrington,99134,3113,2018
yakima,highland high,337,3,0,0,0,1,250,76,7,166,171,253,39203,cowiche,98923,4559,2018
yakima,highland junior high,197,0,0,0,0,1,161,35,0,89,108,168,39203,cowiche,98923,2718,2018
yakima,marcus whitman-cowiche elementary,347,0,0,0,0,1,274,69,3,189,158,266,39203,cowiche,98923,3072,2018
yakima,tieton intermediate,275,0,1,0,1,0,198,70,6,146,129,220,39203,tieton,98947,3073,2018
king,beverly park elem at glendale,438,7,47,16,63,78,208,61,21,224,214,339,17401,seattle,98168,2765,2018
king,big picture,180,2,5,2,7,16,57,82,16,93,87,91,17401,burien,98148,5028,2018
king,bow lake elementary,720,2,104,48,152,197,250,80,39,362,358,557,17401,seatac,98188,2982,2018
king,cascade middle,572,8,107,28,135,53,292,56,28,294,278,429,17401,seattle,98146,3163,2018
king,cedarhurst elementary,608,1,98,20,118,59,288,104,38,309,299,445,17401,burien,98168,2926,2018
king,chinook middle,560,1,96,45,141,109,213,72,24,280,280,424,17401,seatac,98188,3098,2018
king,choice academy,165,1,12,1,13,19,40,71,21,77,88,55,17401,seattle,98148,1539,2018
king,des moines elementary,395,2,32,4,36,78,97,148,34,209,186,191,17401,des moines,98198,2418,2018
king,evergreen high,1007,15,222,40,262,133,437,109,51,533,474,696,17401,seattle,98146,3099,2018
king,gregory heights elementary,656,5,63,17,80,50,219,271,31,352,304,325,17401,burien,98166,2844,2018
king,hazel valley elementary,689,10,103,12,115,53,353,116,42,354,335,520,17401,burien,98146,2699,2018
king,highline high,1198,11,223,44,267,72,541,246,61,621,577,705,17401,burien,98148,2325,2018
king,highline home school center,13,0,0,0,0,4,0,9,0,6,7,0,17401,burien,98148,5371,2018
king,highline open doors 1418,411,4,41,6,47,81,170,84,25,197,214,93,17401,burien,98146,5370,2018
king,hilltop elementary,629,0,120,25,145,57,349,49,29,315,314,487,17401,seattle,98168,3165,2018
king,madrona elementary,670,2,32,64,96,191,309,37,35,363,307,534,17401,seatac,98198,3278,2018
king,marvista elementary,612,3,36,8,44,87,142,302,34,316,296,219,17401,normandy park,98166,3097,2018
king,mcmicken heights elementary,583,1,114,47,161,169,143,85,24,323,260,457,17401,seatac,98188,2734,2018
king,midway elementary,693,5,57,55,112,121,349,65,41,343,350,507,17401,des moines,98198,2984,2018
king,mount rainier high,1629,11,239,61,300,201,471,521,125,829,800,751,17401,des moines,98198,3279,2018
king,mount view elementary,666,3,100,15,115,62,409,55,22,331,335,486,17401,seattle,98146,2144,2018
king,new start,99,1,5,5,10,8,56,16,8,53,46,62,17401,seattle,98146,1972,2018
king,north hill elementary,605,6,55,14,69,60,113,282,75,307,298,243,17401,des moines,98148,2983,2018
king,pacific middle,628,11,65,23,88,97,204,176,52,320,308,358,17401,des moines,98198,3333,2018
king,parkside elementary,643,7,80,30,110,98,193,187,48,330,313,392,17401,des moines,98198,3335,2018
king,puget sound high,91,0,5,1,6,10,45,27,3,53,38,58,17401,burien,98148,5172,2018
king,raisbeck aviation high,410,1,100,0,100,35,39,214,21,254,156,68,17401,tukwila,98108,3553,2018
king,seahurst elementary,538,9,43,13,56,52,292,93,36,293,245,408,17401,burien,98166,3382,2018
king,shorewood elementary,626,5,122,7,129,50,164,225,53,331,295,326,17401,burien,98146,2842,2018
king,southern heights elementary,300,6,50,15,65,23,131,39,36,175,125,219,17401,seattle,98168,3032,2018
king,sylvester middle,660,10,104,24,128,43,285,152,42,343,317,435,17401,burien,98166,2927,2018
king,tyee high,1018,10,168,73,241,201,412,119,35,530,488,731,17401,seatac,98188,3483,2018
king,valley view early childhood center,261,1,15,3,18,35,104,78,25,170,91,58,17401,seatac,98188,5119,2018
king,white center heights elementary,616,7,169,12,181,167,173,71,17,324,292,430,17401,seattle,98146,2639,2018
clark,hockinson heights elementary,822,3,24,1,25,7,47,694,46,409,413,168,06098,brush prairie,98606,5311,2018
clark,hockinson high,684,3,17,0,17,4,35,615,10,366,318,69,06098,brush prairie,98606,4568,2018
clark,hockinson middle,455,2,8,1,9,5,19,410,10,229,226,76,06098,brush prairie,98606,3319,2018
grays harbor,central elementary,246,13,0,0,0,0,47,156,30,124,122,139,14028,hoquiam,98550,2972,2018
grays harbor,emerson elementary,243,14,0,0,0,11,46,162,10,131,112,171,14028,hoquiam,98550,2268,2018
grays harbor,hoquiam high,487,19,6,1,7,6,82,352,21,255,232,231,14028,hoquiam,98550,3622,2018
grays harbor,hoquiam homelink,85,2,0,0,0,0,17,65,1,38,47,53,14028,hoquiam,98550,5191,2018
grays harbor,hoquiam middle,365,23,2,0,2,3,60,252,25,196,169,178,14028,hoquiam,98550,2391,2018
grays harbor,lincoln elementary,258,17,5,0,5,8,48,167,13,141,117,175,14028,hoquiam,98550,3621,2018
ferry,inchelium elementary,110,86,0,0,0,0,2,4,18,50,60,92,10070,inchelium,99138,4215,2018
ferry,inchelium high,69,60,2,0,2,0,1,0,6,31,38,42,10070,inchelium,99138,2603,2018
ferry,inchelium middle,49,43,0,0,0,0,0,0,6,23,26,39,10070,inchelium,99138,4214,2018
snohomish,index elementary,33,0,0,0,0,0,0,30,3,13,20,5,31063,index,98256,2948,2018
king,apollo elementary,673,0,209,2,211,12,86,295,69,339,334,97,17411,renton,98059,3746,2018
king,beaver lake middle,844,1,269,4,273,4,66,440,60,421,423,44,17411,issaquah,98029,4460,2018
king,briarwood elementary,699,0,161,2,163,14,50,409,63,358,341,72,17411,renton,98059,3440,2018
king,cascade ridge elementary,515,0,212,0,212,10,20,219,54,281,234,8,17411,sammamish,98075,4565,2018
king,challenger elementary,617,0,211,0,211,4,65,268,69,320,297,42,17411,issaquah,98029,4300,2018
king,clark elementary,740,2,163,1,164,28,90,368,88,380,360,138,17411,issaquah,98027,2738,2018
king,cougar ridge elementary,583,1,215,0,215,6,33,288,40,312,271,16,17411,bellevue,98006,4375,2018
king,creekside elementary,751,0,232,0,232,5,46,413,55,396,355,15,17411,sammamish,98075,5201,2018
king,discovery elementary,650,0,354,0,354,4,40,197,55,344,306,11,17411,issaquah,98075,4376,2018
king,endeavour elementary,664,1,242,2,244,4,37,327,51,338,326,35,17411,issaquah,98029,4493,2018
king,gibson ek high,150,1,17,0,17,1,12,113,6,65,85,9,17411,issaquah,98027,5437,2018
king,grand ridge elementary,751,0,280,0,280,16,41,349,65,387,364,41,17411,issaquah,98029,5056,2018
king,issaquah high,2395,7,579,7,586,56,182,1422,142,1207,1188,174,17411,issaquah,98027,3385,2018
king,issaquah middle,1020,3,217,3,220,26,110,581,80,504,516,116,17411,issaquah,98027,3038,2018
king,issaquah special services,142,0,33,0,33,5,20,70,14,97,45,6,17411,issaquah,98027,1624,2018
king,issaquah valley elementary,623,0,90,1,91,12,111,353,56,310,313,135,17411,issaquah,98027,3673,2018
king,liberty sr high,1401,3,286,6,292,35,148,845,78,710,691,128,17411,renton,98059,3962,2018
king,maple hills elementary,442,1,5,0,5,7,29,349,51,223,219,36,17411,renton,98059,3637,2018
king,maywood middle,1139,0,247,3,250,17,130,655,87,564,575,134,17411,renton,98059,3636,2018
king,newcastle elementary,633,0,213,1,214,19,50,271,79,299,334,30,17411,newcastle,98059,4592,2018
king,pacific cascade middle,973,0,318,4,322,22,68,500,61,523,450,40,17411,issaquah,98029,5200,2018
king,pine lake middle,946,1,404,1,405,7,58,428,47,474,472,27,17411,sammamish,98075,3879,2018
king,skyline high,2210,2,723,6,729,39,144,1202,94,1187,1023,82,17411,sammamish,98075,4495,2018
king,sunny hills elementary,686,0,246,3,249,6,45,327,59,338,348,26,17411,sammamish,98075,3386,2018
king,sunset elementary,626,1,135,3,138,13,42,379,53,336,290,49,17411,bellevue,98008,3228,2018
franklin,kahlotus elem & high,47,0,0,0,0,0,8,37,2,20,27,26,11056,kahlotus,99335,3214,2018
cowlitz,kalama elem,498,5,8,3,11,6,36,438,2,264,234,181,08402,kalama,98625,2915,2018
ferry,keller elementary,23,20,0,0,0,0,0,0,1,11,12,15,10003,keller,99140,2602,2018
cowlitz,barnes elementary,372,3,1,5,6,2,69,275,17,199,173,281,08458,kelso,98626,3323,2018
cowlitz,beacon hill elementary,513,0,7,1,8,0,83,382,40,251,262,265,08458,longview,98632,3578,2018
cowlitz,butler acres elementary,411,5,7,1,8,0,47,337,14,201,210,190,08458,kelso,98626,3082,2018
cowlitz,carrolls elementary,141,2,7,0,7,0,12,112,8,67,74,46,08458,carrolls,98609,2913,2018
cowlitz,catlin elementary,373,1,1,8,9,3,58,277,25,207,166,299,08458,kelso,98626,2691,2018
cowlitz,coweeman middle,583,10,4,5,9,3,111,423,27,308,275,295,08458,kelso,98626,3322,2018
cowlitz,huntington middle,550,1,2,9,11,1,120,392,25,273,277,328,08458,kelso,98626,2916,2018
cowlitz,kelso high,1661,34,16,15,31,8,254,1222,112,852,809,705,08458,kelso,98626,2266,2018
cowlitz,kelso virtual academy,37,0,0,1,1,0,7,26,3,11,26,17,08458,kelso,98626,5194,2018
cowlitz,loowit high,18,1,0,0,0,0,3,14,0,6,12,19,08458,kelso,98626,1934,2018
cowlitz,rose valley elementary,145,1,0,2,2,3,11,127,1,72,73,33,08458,kelso,98626,2596,2018
cowlitz,special education,47,0,0,1,1,0,6,35,5,29,18,45,08458,kelso,98626,5076,2018
cowlitz,wallace elementary,354,1,3,16,19,2,112,209,11,187,167,316,08458,kelso,98626,2624,2018
benton,amistad elementary,527,0,12,1,13,19,318,166,11,285,242,508,03017,kennewick,99336,4418,2018
benton,canyon view elementary,530,0,0,0,0,12,220,275,23,254,276,384,03017,kennewick,99337,4072,2018
benton,cascade elementary,605,0,1,0,1,8,160,409,27,318,287,257,03017,kennewick,99337,4202,2018
benton,chinook middle,896,2,30,3,33,17,240,553,51,458,438,440,03017,kennewick,99338,5439,2018
benton,cottonwood elementary,753,0,6,1,7,12,64,643,27,386,367,126,03017,kennewick,99338,5220,2018
benton,desert hills middle,868,5,14,1,15,20,122,669,37,420,448,227,03017,kennewick,99338,4028,2018
benton,eastgate elementary,574,1,4,0,4,9,425,127,8,284,290,536,03017,kennewick,99336,2824,2018
benton,edison elementary school - kennewick,612,5,1,0,1,16,326,244,20,297,315,476,03017,kennewick,99336,3315,2018
benton,hawthorne elementary school - kennewick,554,0,4,5,9,6,304,209,26,294,260,438,03017,kennewick,99336,3077,2018
benton,highlands middle,812,5,12,3,15,28,418,315,31,404,408,641,03017,kennewick,99336,3267,2018
benton,horse heaven hills middle,814,1,7,1,8,7,265,483,50,431,383,446,03017,kennewick,99337,4429,2018
benton,kamiakin high,1755,10,38,2,40,28,479,1159,39,950,805,600,03017,kennewick,99336,3731,2018
benton,keewaydin discovery center,205,0,1,0,1,5,70,125,4,131,74,116,03017,kennewick,99336,2000,2018
benton,kennewick high,1702,11,60,4,64,61,839,668,59,930,772,1108,03017,kennewick,99336,2826,2018
benton,legacy high,223,5,3,3,6,8,85,112,7,118,105,137,03017,kennewick,99336,1884,2018
benton,lincoln elementary,568,1,4,0,4,14,173,342,34,276,292,349,03017,kennewick,99338,4181,2018
benton,mid-columbia parent partnership,310,2,2,0,2,3,40,256,7,169,141,94,03017,kennewick,99336,1941,2018
benton,park middle,711,0,29,1,30,31,465,156,29,376,335,651,03017,kennewick,99336,3472,2018
benton,phoenix high,62,0,0,0,0,0,17,45,0,32,30,46,03017,kennewick,99338,5106,2018
benton,ridge view elementary,648,3,20,0,20,0,87,483,55,332,316,139,03017,kennewick,99338,4446,2018
benton,sage crest elementary,545,0,10,0,10,10,107,392,26,287,258,231,03017,kennewick,99338,5438,2018
benton,southgate elementary,467,0,3,0,3,13,155,268,28,234,233,301,03017,kennewick,99337,4073,2018
benton,southridge high,1713,6,26,8,34,31,576,996,70,869,844,766,03017,kennewick,99338,4484,2018
benton,sunset view elementary,556,1,16,0,16,24,85,392,38,291,265,254,03017,kennewick,99336,4136,2018
benton,vista elementary,576,2,4,1,5,21,208,292,48,316,260,409,03017,kennewick,99336,3369,2018
benton,washington elementary,488,0,3,2,5,14,193,257,19,273,215,405,03017,kennewick,99337,3144,2018
benton,westgate elementary,547,0,46,6,52,30,152,294,19,295,252,485,03017,kennewick,99336,2825,2018
king,birth to age 2,211,4,23,4,27,16,54,64,46,124,87,0,17415,kent,98030,5150,2018
king,carriage crest elementary,490,0,92,2,94,38,73,230,55,244,246,112,17415,renton,98058,4353,2018
king,cedar heights middle,642,1,66,9,75,64,120,327,55,344,298,306,17415,covington,98042,4440,2018
king,cedar valley elementary,254,2,11,0,11,10,76,133,22,136,118,138,17415,covington,98042,3676,2018
king,covington elementary,581,4,77,3,80,50,137,262,48,306,275,307,17415,covington,98042,3388,2018
king,crestwood elementary,498,1,23,1,24,20,84,314,55,242,256,136,17415,covington,98042,4126,2018
king,east hill elementary,529,0,111,14,125,111,154,83,56,260,269,394,17415,kent,98031,2851,2018
king,emerald park elementary,541,0,167,19,186,76,95,122,62,282,259,265,17415,kent,98031,4545,2018
king,fairwood elementary,393,2,48,5,53,46,64,171,57,190,203,142,17415,renton,98058,3678,2018
king,george t. daniel elementary,507,1,66,21,87,92,142,143,42,293,214,326,17415,kent,98030,4413,2018
king,glenridge elementary,475,0,173,10,183,70,63,112,47,235,240,257,17415,kent,98031,4489,2018
king,grass lake elementary,409,1,15,4,19,11,71,277,30,199,210,102,17415,kent,98042,3708,2018
king,horizon elementary,468,1,87,9,96,52,83,197,39,229,239,249,17415,kent,98042,4345,2018
king,igrad,399,2,34,14,48,47,113,152,37,204,195,209,17415,kent,98030,5275,2018
king,jenkins creek elementary,439,3,28,5,33,34,80,228,61,225,214,181,17415,covington,98042,4301,2018
king,kent elementary,731,0,58,58,116,73,381,107,54,370,361,550,17415,kent,98032,4520,2018
king,kent mountain view academy,288,1,64,4,68,26,32,125,36,145,143,85,17415,des moines,98198,3014,2018
king,kent phoenix academy,257,4,11,5,16,40,65,97,35,112,145,143,17415,kent,98030,5098,2018
king,kent-meridian high,2030,3,430,94,524,395,617,373,118,1055,975,1284,17415,kent,98030,2797,2018
king,kentlake high,1554,10,143,24,167,115,264,857,141,823,731,527,17415,kent,98042,4492,2018
king,kentridge high,2195,7,609,43,652,227,274,815,220,1141,1054,620,17415,kent,98031,3640,2018
king,kentwood high,2072,13,475,55,530,202,382,783,162,1088,984,711,17415,covington,98042,4128,2018
king,lake youngs elementary,507,3,122,3,125,26,75,227,51,260,247,129,17415,kent,98042,3550,2018
king,martin sortun elementary,661,1,225,16,241,95,106,171,47,320,341,336,17415,kent,98030,4294,2018
king,mattson middle,629,3,92,7,99,34,140,292,61,350,279,252,17415,covington,98042,4127,2018
king,meadow ridge elementary,554,2,154,10,164,86,111,157,34,296,258,400,17415,kent,98030,4465,2018
king,meeker middle,598,0,183,14,197,85,120,145,51,305,293,337,17415,renton,98058,3764,2018
king,meridian elementary,598,2,105,18,123,43,131,234,65,321,277,273,17415,kent,98042,2565,2018
king,meridian middle,620,1,172,20,192,75,160,142,50,320,300,360,17415,kent,98031,3233,2018
king,mill creek middle,814,2,124,42,166,133,322,103,88,414,400,611,17415,kent,98032,5016,2018
king,millennium elementary,606,4,136,24,160,78,152,169,43,314,292,446,17415,kent,98030,4581,2018
king,neely o brien elementary,824,3,137,46,183,170,282,109,77,420,404,632,17415,kent,98032,4356,2018
king,northwood middle,582,2,138,8,146,56,72,235,71,291,291,163,17415,renton,98058,4485,2018
king,panther lake elementary,694,0,138,17,155,126,196,137,80,359,335,473,17415,kent,98031,5178,2018
king,park orchard elementary,483,3,93,10,103,84,175,67,51,254,229,312,17415,kent,98031,3491,2018
king,pine tree elementary,436,2,74,20,94,72,103,118,47,226,210,294,17415,kent,98030,3593,2018
king,regional justice center,22,0,1,2,3,8,6,1,4,22,0,7,17415,kent,98030,1807,2018
king,ridgewood elementary,491,0,133,2,135,39,55,197,65,254,237,79,17415,renton,98058,4293,2018
king,sawyer woods elementary,467,3,24,2,26,6,38,341,53,242,225,92,17415,black diamond,98010,4466,2018
king,scenic hill elementary,663,2,58,21,79,86,269,144,83,352,311,422,17415,kent,98030,3389,2018
king,soos creek elementary,415,1,86,19,105,45,73,134,57,240,175,190,17415,kent,98031,3707,2018
king,springbrook elementary,537,3,96,24,120,73,208,84,49,273,264,387,17415,kent,98031,3677,2018
king,sunrise elementary,672,0,226,6,232,68,70,209,93,334,338,226,17415,kent,98042,4420,2018
king,the outreach program,80,0,13,1,14,14,10,32,10,47,33,49,17415,kent,98030,5440,2018
stevens,columbia virtual academy - kettle falls,249,5,2,1,3,6,32,190,13,115,134,39,33212,kettle falls,99141,5180,2018
stevens,kettle falls elementary,302,6,0,0,0,1,12,258,25,148,154,180,33212,kettle falls,99141,2385,2018
stevens,kettle falls high,223,8,5,1,6,0,10,198,1,112,111,104,33212,kettle falls,99141,4206,2018
stevens,kettle falls middle,232,1,2,0,2,2,14,202,11,115,117,157,33212,kettle falls,99141,3198,2018
benton,kiona-benton city high,464,0,2,0,2,2,191,262,7,246,218,222,03052,benton city,99320,2904,2018
benton,kiona-benton city middle,315,2,0,0,0,0,139,166,8,165,150,207,03052,benton city,99320,3961,2018
benton,kiona-benton city primary,334,1,1,0,1,1,143,183,5,169,165,226,03052,benton city,99320,2759,2018
benton,kiona-benton intermediate,359,2,1,0,1,0,165,178,13,186,173,256,03052,benton city,99320,4217,2018
kittitas,kittitas b-5 special ed program,17,0,0,0,0,0,2,15,0,13,4,9,19403,kittitas,98934,5086,2018
kittitas,kittitas elementary,288,0,1,0,1,0,55,226,6,138,150,137,19403,kittitas,98934,2569,2018
kittitas,kittitas high,382,0,5,0,5,1,91,280,5,195,187,140,19403,kittitas,98934,2766,2018
klickitat,klickitat elem & high,72,0,0,0,0,0,6,62,4,49,23,38,20402,klickitat,98628,3494,2018
clark,la center elementary,743,0,5,3,8,3,47,662,23,387,356,202,06101,la center,98629,2558,2018
clark,la center high,557,2,7,0,7,3,26,510,9,287,270,79,06101,la center,98629,4431,2018
clark,la center home school academy,21,1,0,0,0,0,2,18,0,10,11,4,06101,la center,98629,5326,2018
clark,la center middle,390,2,1,0,1,3,33,339,12,218,172,101,06101,la center,98629,3371,2018
skagit,la conner elementary,262,97,2,0,2,0,24,123,16,136,126,163,29311,la conner,98257,2522,2018
skagit,la conner high,199,65,4,0,4,0,27,98,5,111,88,97,29311,la conner,98257,2276,2018
skagit,la conner middle,144,44,1,0,1,0,9,81,9,69,75,78,29311,la conner,98257,3900,2018
whitman,lacrosse elementary,26,0,0,0,0,0,0,26,0,15,11,5,38126,lacrosse,99143,2087,2018
whitman,lacrosse high,31,0,0,0,0,0,2,26,3,12,19,10,38126,lacrosse,99143,2088,2018
chelan,chelan high,468,0,2,0,2,1,255,206,4,256,212,259,04129,chelan,98816,4260,2018
chelan,chelan middle,322,0,2,0,2,1,157,156,6,162,160,189,04129,chelan,98816,2317,2018
chelan,chelan school of innovation,31,0,0,0,0,0,12,19,0,23,8,22,04129,chelan,98816,1940,2018
chelan,holden village community,1,0,0,0,0,0,0,1,0,0,1,0,04129,chelan,98816,3861,2018
chelan,lake chelan preschool,12,0,0,0,0,0,7,5,0,10,2,9,04129,chelan,98816,1675,2018
chelan,morgen owings elementary,604,2,6,0,6,1,363,224,7,327,277,419,04129,chelan,98816,2689,2018
snohomish,cavelero mid high,1337,5,56,6,62,15,189,939,127,685,652,325,31004,lake stevens,98258,5099,2018
snohomish,early learning center,174,0,4,0,4,3,31,121,15,112,62,30,31004,lake stevens,98258,5441,2018
snohomish,glenwood elementary,551,2,9,2,11,7,45,431,55,302,249,116,31004,lake stevens,98258,4391,2018
snohomish,highland elementary,647,4,15,0,15,11,62,509,46,341,306,105,31004,lake stevens,98258,4534,2018
snohomish,hillcrest elementary,818,3,33,1,34,19,174,524,64,408,410,241,31004,lake stevens,98258,2885,2018
snohomish,homelink,123,0,1,0,1,2,11,100,9,55,68,23,31004,lake stevens,98258,1753,2018
snohomish,lake stevens middle,645,0,25,4,29,14,106,437,59,342,303,182,31004,lake stevens,98258,3408,2018
snohomish,lake stevens sr high,1909,11,78,8,86,37,259,1366,150,1027,882,371,31004,lake stevens,98258,2426,2018
snohomish,mt. pilchuck elementary,638,3,11,4,15,6,78,485,51,323,315,212,31004,lake stevens,98258,2884,2018
snohomish,north lake middle,749,4,28,1,29,13,92,546,65,391,358,175,31004,lake stevens,98258,4139,2018
snohomish,skyline elementary,579,0,31,3,34,14,114,366,51,293,286,189,31004,lake stevens,98258,4392,2018
snohomish,sunnycrest elementary,791,2,34,0,34,19,96,556,84,413,378,145,31004,lake stevens,98258,3753,2018
king,lake washington technical academy,308,1,15,1,16,7,42,228,14,186,122,0,17937,kirkland,98034,5953,2018
king,open doors at lwit,428,5,19,4,23,15,59,309,17,245,183,0,17937,kirkland,98034,5306,2018
king,alcott elementary,739,0,478,0,478,9,35,184,33,368,371,31,17414,redmond,98053,4256,2018
king,audubon elementary,596,0,306,0,306,6,30,227,27,271,325,19,17414,redmond,98052,3548,2018
king,bell elementary,425,0,52,0,52,17,70,252,34,229,196,89,17414,kirkland,98033,3592,2018
king,blackwell elementary,559,0,225,0,225,4,38,255,37,288,271,6,17414,sammamish,98074,4532,2018
king,carson elementary,464,0,167,0,167,3,29,226,39,235,229,10,17414,sammamish,98074,5139,2018
king,community,71,0,9,0,9,1,3,51,7,36,35,1,17414,kirkland,98033,3856,2018
king,contractual schools,31,0,2,0,2,1,3,25,0,24,7,6,17414,redmond,98073,1649,2018
king,dickinson elementary,608,2,211,0,211,12,84,262,37,328,280,70,17414,redmond,98053,4018,2018
king,discovery,67,0,15,0,15,0,2,45,5,30,37,0,17414,kirkland,98034,1658,2018
king,eastlake high,1873,4,342,4,346,16,140,1242,125,945,928,72,17414,sammamish,98074,4439,2018
king,einstein elementary,454,0,118,0,118,18,104,174,40,246,208,132,17414,redmond,98052,4424,2018
king,emerson high,54,2,3,0,3,0,9,38,2,21,33,13,17414,kirkland,98033,3855,2018
king,emerson k-12,67,0,5,0,5,0,5,50,7,38,29,8,17414,kirkland,98033,1688,2018
king,environmental & adventure,137,1,26,0,26,2,4,93,11,74,63,4,17414,kirkland,98034,1800,2018
king,evergreen middle,1199,2,487,1,488,22,86,532,69,647,552,66,17414,redmond,98053,4148,2018
king,explorer community,71,0,29,0,29,0,2,38,2,29,42,0,17414,redmond,98052,1687,2018
king,finn hill middle,633,2,60,0,60,23,76,406,66,343,290,103,17414,kirkland,98034,3590,2018
king,franklin elementary,455,1,135,0,135,4,39,241,35,229,226,24,17414,kirkland,98033,3591,2018
king,frost elementary,424,2,40,1,41,14,121,205,41,215,209,142,17414,kirkland,98034,3675,2018
king,futures,27,0,1,0,1,2,3,19,2,10,17,11,17414,kirkland,98034,1804,2018
king,inglewood middle,1203,1,295,1,296,15,78,734,79,607,596,33,17414,sammamish,98074,4386,2018
king,international community,431,0,220,1,221,1,18,170,21,201,230,8,17414,kirkland,98033,1706,2018
king,juanita elementary,398,0,60,0,60,11,66,209,52,214,184,87,17414,kirkland,98034,2796,2018
king,juanita high,1494,3,258,7,265,39,226,837,124,774,720,299,17414,kirkland,98034,3771,2018
king,kamiakin middle,584,0,121,0,121,12,113,274,64,310,274,184,17414,kirkland,98034,3922,2018
king,keller elementary,366,3,30,2,32,10,56,209,56,190,176,87,17414,kirkland,98034,3704,2018
king,kirk elementary,562,1,57,0,57,12,34,390,68,281,281,21,17414,kirkland,98033,3941,2018
king,kirkland middle,615,1,67,0,67,10,52,443,42,296,319,56,17414,kirkland,98033,2308,2018
king,lake washington high,1708,2,185,0,185,42,193,1156,130,915,793,197,17414,kirkland,98033,2739,2018
king,lakeview elementary,562,4,85,2,87,17,71,329,54,283,279,64,17414,kirkland,98033,3041,2018
king,mann elementary,460,0,125,1,126,5,32,260,36,247,213,12,17414,redmond,98052,3529,2018
king,mcauliffe elementary,492,0,154,1,155,9,33,265,30,257,235,17,17414,sammamish,98074,4354,2018
king,mead elementary,604,3,190,3,193,5,34,329,40,313,291,23,17414,sammamish,98074,4096,2018
king,muir elementary,431,2,106,0,106,6,79,202,36,208,223,147,17414,kirkland,98034,3748,2018
king,northstar middle,81,0,31,1,32,1,3,42,3,44,37,2,17414,kirkland,98033,4167,2018
king,ready start preschool,2,0,0,0,0,0,0,2,0,2,0,0,17414,redmond,98052,3549,2018
king,redmond elementary,768,3,397,0,397,21,72,222,52,399,369,102,17414,redmond,98052,2289,2018
king,redmond high,1911,4,417,4,421,42,207,1089,148,947,964,210,17414,redmond,98052,3528,2018
king,redmond middle,1034,0,315,3,318,23,143,454,96,550,484,161,17414,redmond,98052,3232,2018
king,renaissance,91,0,16,0,16,0,6,61,8,26,65,2,17414,sammamish,98074,5057,2018
king,rockwell elementary,631,0,287,0,287,4,40,253,47,318,313,18,17414,redmond,98052,4147,2018
king,rosa parks elementary,637,4,328,1,329,11,36,218,39,332,305,10,17414,redmond,98053,5053,2018
king,rose hill elementary,478,0,124,1,125,8,97,199,49,239,239,99,17414,kirkland,98033,2992,2018
king,rose hill middle,889,2,196,0,196,17,145,453,76,471,418,156,17414,redmond,98052,3706,2018
king,rush elementary,631,2,325,1,326,7,39,210,47,325,306,32,17414,redmond,98052,3703,2018
king,sandburg elementary,459,0,38,0,38,0,34,347,40,243,216,21,17414,kirkland,98034,3747,2018
king,smith elementary,672,3,374,0,374,2,34,217,42,359,313,9,17414,sammamish,98074,4302,2018
king,stella schola,87,0,38,0,38,0,3,35,11,42,45,1,17414,redmond,98052,1975,2018
king,tesla stem high,603,1,297,0,297,3,26,240,36,365,238,8,17414,redmond,98053,5265,2018
king,thoreau elementary,461,1,75,0,75,3,50,279,53,247,214,61,17414,kirkland,98034,3490,2018
king,twain elementary,605,3,119,1,120,11,86,320,65,294,311,94,17414,kirkland,98033,3441,2018
king,wilder elementary,601,1,217,0,217,8,50,294,31,322,279,13,17414,woodinville,98077,4336,2018
snohomish,cougar creek elementary,401,2,10,1,11,6,77,269,36,216,185,139,31306,n. lakewood,98259,4576,2018
snohomish,english crossing elementary,327,4,9,1,10,8,67,206,32,170,157,133,31306,n. lakewood,98259,4477,2018
snohomish,lakewood elementary,416,4,3,17,20,13,69,267,43,229,187,190,31306,n. lakewood,98259,3255,2018
snohomish,lakewood high,745,5,14,12,26,13,118,533,50,392,353,165,31306,n lakewood,98259,4204,2018
snohomish,lakewood middle,572,7,7,13,20,9,92,388,56,285,287,207,31306,n. lakewood,98259,3893,2018
snohomish,lakewood nwesd 189 open door program,4,0,0,0,0,1,1,2,0,2,2,1,31306,marysville,98270,5404,2018
whitman,lamont middle,40,0,0,0,0,0,2,37,1,13,27,28,38264,lamont,99017,3137,2018
spokane,liberty high,159,2,1,0,1,2,12,139,3,87,72,53,32362,spangle,99031,3416,2018
spokane,liberty jr high & elementary,355,0,3,0,3,0,29,308,15,179,176,125,32362,spangle,99031,4226,2018
adams,lind elementary,91,0,0,0,0,0,29,57,5,47,44,65,01158,lind,99341,3421,2018
adams,lind-ritzville high,57,0,4,0,4,1,23,28,1,23,34,30,01158,ritzville,99169,2903,2018
adams,lind-ritzville middle,42,0,0,0,0,1,16,25,0,18,24,32,01158,lind,99341,5293,2018
cowlitz,broadway learning center,103,0,1,0,1,1,20,75,6,75,28,117,08122,longview,98632,2665,2018
cowlitz,cascade middle,552,6,6,2,8,4,142,351,41,281,271,331,08122,longview,98632,3475,2018
cowlitz,columbia heights elementary,355,3,5,0,5,2,43,267,35,175,180,166,08122,longview,98632,3211,2018
cowlitz,columbia valley garden elem,413,2,11,0,11,3,51,320,26,207,206,191,08122,longview,98632,2369,2018
cowlitz,discovery high,141,2,2,0,2,3,35,87,12,63,78,107,08122,longview,98632,5312,2018
cowlitz,discovery high school-achieve,41,0,0,2,2,0,15,22,2,26,15,37,08122,longview,98632,5400,2018
cowlitz,kessler elementary,317,3,4,2,6,0,87,187,34,166,151,260,08122,longview,98632,2319,2018
cowlitz,longview school district special services,66,0,0,0,0,0,13,46,7,43,23,52,08122,longview,98632,3913,2018
cowlitz,mark morris high,997,13,22,3,25,7,161,714,77,478,519,403,08122,longview,98632,3151,2018
cowlitz,mint valley elementary,433,9,4,1,5,8,88,295,28,230,203,316,08122,longview,98632,3658,2018
cowlitz,monticello middle,506,11,9,9,18,7,129,318,23,242,264,381,08122,longview,98632,2831,2018
cowlitz,mt. solo middle,428,7,6,0,6,1,63,324,27,206,222,205,08122,longview,98632,4574,2018
cowlitz,northlake elementary,303,2,5,0,5,4,112,162,18,154,149,254,08122,longview,98632,2914,2018
cowlitz,olympic elementary,393,13,9,3,12,13,103,231,21,196,197,303,08122,longview,98632,2726,2018
cowlitz,r a long high,912,14,30,11,41,11,180,609,57,476,436,468,08122,longview,98632,2416,2018
cowlitz,robert gray elementary,447,4,2,0,2,3,39,369,30,217,230,193,08122,longview,98632,3019,2018
cowlitz,saint helens elementary,357,4,6,8,14,8,124,181,26,199,158,317,08122,longview,98632,2370,2018
stevens,loon lake elementary,119,0,0,0,0,1,18,93,7,60,59,90,33183,loon lake,99148,2480,2018
stevens,loon lake homelink program,100,0,3,0,3,1,8,79,9,57,43,23,33183,loon lake,99148,1922,2018
san juan,cva-lopez island,24,0,2,0,2,2,0,20,0,14,10,6,28144,lopez island,98261,5299,2018
san juan,decatur elementary,3,0,0,0,0,0,0,2,1,2,1,0,28144,anacortes,98221,4178,2018
san juan,lopez elementary,127,0,0,0,0,0,38,87,2,67,60,60,28144,lopez island,98261,4107,2018
san juan,lopez middle high,97,1,13,0,13,0,19,63,1,48,49,27,28144,lopez island,98261,2632,2018
whatcom,lummi nation,311,271,0,1,1,0,12,5,22,176,135,289,37903,bellingham,98226,5373,2018
klickitat,dallesport elementary,100,11,0,0,0,0,12,70,7,55,45,67,20406,lyle,98635,3049,2018
klickitat,lyle high,79,8,0,0,0,1,18,46,6,42,37,45,20406,lyle,98635,3111,2018
klickitat,lyle middle,57,7,0,0,0,1,6,40,3,30,27,31,20406,lyle,98635,3643,2018
whatcom,fisher elementary,430,2,11,1,12,2,144,258,12,232,198,202,37504,lynden,98264,3417,2018
whatcom,isom elementary,523,9,16,0,16,7,130,346,15,261,262,169,37504,lynden,98264,4324,2018
whatcom,lynden academy,231,0,1,0,1,2,9,217,2,108,123,10,37504,lynden,98264,1983,2018
whatcom,lynden high,882,4,17,2,19,8,206,593,52,434,448,255,37504,lynden,98264,4201,2018
whatcom,lynden middle,667,2,17,0,17,5,181,431,31,363,304,225,37504,lynden,98264,2219,2018
whatcom,lynden special services,88,2,4,0,4,3,16,60,3,66,22,0,37504,lynden,98264,1914,2018
whatcom,vossbeck elementary,455,3,18,0,18,16,114,289,15,240,215,158,37504,lynden,98264,4517,2018
yakima,artz fox elementary,527,3,0,0,0,0,514,10,0,263,264,480,39120,mabton,98935,3070,2018
yakima,mabton jr. sr. high,363,0,0,0,0,0,356,7,0,180,183,320,39120,mabton,98935,5289,2018
douglas,mansfield elem and high,86,4,1,0,1,2,16,63,0,45,41,68,09207,mansfield,98830,2233,2018
chelan,manson elementary,296,4,0,0,0,1,197,94,0,156,140,208,04019,manson,98831,2196,2018
chelan,manson high,189,2,0,0,0,1,124,62,0,101,88,137,04019,manson,98831,2623,2018
chelan,manson middle,150,2,1,0,1,1,91,54,1,79,71,104,04019,manson,98831,5286,2018
mason,mary m. knight,166,2,0,0,0,1,6,147,10,88,78,93,23311,elma,98541,5444,2018
mason,washington connections academy,882,10,13,4,17,69,110,573,103,434,448,356,23311,tumwater,98501,5445,2018
stevens,mary walker high,182,20,0,0,0,0,22,122,18,100,82,124,33207,springdale,99173,3311,2018
stevens,springdale academy,4,0,0,0,0,0,0,4,0,3,1,4,33207,springdale,99173,1857,2018
stevens,springdale elementary,199,32,0,0,0,3,15,131,18,94,105,166,33207,springdale,99173,2297,2018
stevens,springdale middle,104,19,0,0,0,1,10,67,7,60,44,85,33207,springdale,99173,3894,2018
snohomish,10th street,178,9,7,0,7,2,20,119,21,77,101,33,31025,marysville,98271,1656,2018
snohomish,allen creek elementary,505,14,33,2,35,10,92,303,51,262,243,243,31025,marysville,98270,4454,2018
snohomish,cascade elementary,444,8,38,6,44,6,129,212,45,226,218,246,31025,marysville,98270,3059,2018
snohomish,cedarcrest,784,20,49,9,58,10,168,440,88,415,369,376,31025,marysville,98270,4357,2018
snohomish,grove elementary,488,13,29,4,33,6,97,266,73,250,238,192,31025,marysville,98270,5123,2018
snohomish,heritage,96,63,0,0,0,1,16,4,12,42,54,57,31025,marysville,98271,1657,2018
snohomish,kellogg marsh elementary,553,6,15,13,28,8,108,334,69,294,259,287,31025,marysville,98270,4323,2018
snohomish,liberty elementary,440,28,17,7,24,7,179,173,29,233,207,330,31025,marysville,98270,3964,2018
snohomish,marshall elementary,358,13,6,4,10,4,86,186,59,176,182,189,31025,marysville,98271,4150,2018
snohomish,marysville coop program,273,14,4,0,4,1,35,172,47,141,132,45,31025,marysville,98270,1862,2018
snohomish,marysville getchell high,1678,33,147,12,159,39,357,919,171,846,832,550,31025,marysville,98270,5478,2018
snohomish,marysville middle,795,28,42,8,50,15,217,405,80,421,374,438,31025,marysville,98270,3355,2018
snohomish,marysville nwesd 189 youth engagement,82,10,1,1,2,2,14,50,4,42,40,39,31025,marysville,98270,5402,2018
snohomish,marysville pilchuck high,1273,57,51,8,59,26,303,712,116,644,629,509,31025,marysville,98271,5213,2018
snohomish,marysville sd special,163,10,3,0,3,4,34,88,24,102,61,71,31025,marysville,98270,1910,2018
snohomish,pinewood elementary,565,5,24,2,26,4,149,321,60,281,284,259,31025,marysville,98270,3651,2018
snohomish,quil ceda tulalip elementary,553,216,6,3,9,5,93,137,93,253,300,448,31025,tulalip,98271,5350,2018
snohomish,school home partnership program,33,1,2,0,2,0,5,21,4,15,18,18,31025,marysville,98271,1744,2018
snohomish,shoultes elementary,477,5,34,8,42,9,125,242,54,238,239,267,31025,marysville,98271,3187,2018
snohomish,sunnyside elementary,527,9,47,3,50,12,102,322,32,254,273,203,31025,marysville,98270,3537,2018
snohomish,totem middle,559,86,35,3,38,7,113,251,64,287,272,296,31025,marysville,98270,2813,2018
grays harbor,mccleary elem,320,3,4,1,5,3,15,284,10,175,145,190,14065,mccleary,98557,2835,2018
spokane,brentwood elementary,574,0,3,0,3,9,33,475,54,311,263,169,32354,spokane,99218,3693,2018
spokane,colbert elementary,538,0,4,0,4,4,28,479,23,269,269,137,32354,colbert,99005,3562,2018
spokane,evergreen elementary,609,2,10,11,21,11,32,489,54,308,301,254,32354,spokane,99208,3414,2018
spokane,farwell elementary,606,4,6,2,8,11,54,474,55,305,301,216,32354,spokane,99208,3759,2018
spokane,mead alternative high,85,1,0,0,0,0,4,75,5,34,51,59,32354,spokane,99218,1803,2018
spokane,mead education partnership prog,478,0,0,0,0,3,27,421,27,226,252,104,32354,spokane,99208,1858,2018
spokane,mead open doors,11,0,0,0,0,1,0,8,2,7,4,2,32354,mead,99021,5401,2018
spokane,mead preschool,87,1,0,1,1,2,6,73,4,55,32,0,32354,mead,99021,5122,2018
spokane,mead senior high,1636,5,13,2,15,23,104,1326,163,837,799,342,32354,spokane,99218,2402,2018
spokane,meadow ridge elementary,591,1,4,2,6,2,35,521,26,315,276,184,32354,mead,99021,4400,2018
spokane,midway elementary,604,3,6,0,6,2,37,521,35,293,311,91,32354,colbert,99005,4133,2018
spokane,mountainside middle,726,3,10,23,33,11,42,594,43,356,370,248,32354,colbert,99005,3191,2018
spokane,mt spokane high,1575,7,25,43,68,26,81,1286,107,764,811,406,32354,mead,99021,4491,2018
spokane,northwood middle,917,7,12,1,13,17,65,730,85,473,444,222,32354,spokane,99208,3851,2018
spokane,prairie view elementary,661,1,6,0,6,5,25,563,61,336,325,78,32354,spokane,99208,5094,2018
spokane,riverpoint academy,171,0,0,0,0,1,14,148,8,110,61,28,32354,spokane,99218,5268,2018
spokane,shiloh hills elementary,555,5,5,22,27,10,58,365,90,273,282,384,32354,spokane,99208,4134,2018
spokane,hallett elementary,501,3,3,1,4,9,40,427,18,250,251,250,32326,medical lake,99022,4483,2018
spokane,medical lake endeavors,26,0,0,0,0,0,1,20,5,13,13,22,32326,medical lake,99022,5042,2018
spokane,medical lake high,538,1,3,2,5,17,52,420,43,302,236,141,32326,medical lake,99022,2890,2018
spokane,medical lake middle,396,2,7,1,8,6,38,298,44,208,188,135,32326,medical lake,99022,3965,2018
spokane,michael anderson elementary,435,0,13,4,17,23,81,274,40,241,194,111,32326,fairchild afb,99011,4577,2018
king,island park elementary,420,0,70,0,70,2,24,268,56,243,177,4,17400,mercer island,98040,3162,2018
king,islander middle,1146,1,235,4,239,11,37,755,103,612,534,45,17400,mercer island,98040,3219,2018
king,lakeridge elementary,471,0,85,0,85,3,21,297,65,245,226,5,17400,mercer island,98040,2981,2018
king,mercer island high,1524,5,297,1,298,13,61,1061,86,816,708,44,17400,mercer island,98040,3029,2018
king,northwood elementary,466,0,127,0,127,9,30,255,45,258,208,28,17400,mercer island,98040,5447,2018
king,west mercer elementary,506,0,133,0,133,2,35,261,75,265,241,19,17400,mercer island,98040,3433,2018
whatcom,irene reither elementary,695,8,38,3,41,4,156,451,35,359,336,289,37505,everson,98226,2584,2018
whatcom,meridian high,509,1,47,1,48,2,107,322,29,264,245,196,37505,bellingham,98226,2554,2018
whatcom,meridian middle,303,1,18,0,18,2,66,191,25,153,150,124,37505,lynden,98264,3930,2018
whatcom,meridian parent partnership program,262,1,4,0,4,6,14,221,16,140,122,23,37505,bellingham,98226,5047,2018
whatcom,meridian special programs,26,2,3,0,3,1,5,15,0,17,9,0,37505,bellingham,98226,1743,2018
okanogan,alternative,21,1,0,0,0,0,0,19,1,9,12,14,24350,winthrop,98862,1621,2018
okanogan,home school experience,13,0,0,0,0,0,0,13,0,4,9,2,24350,winthrop,98862,1845,2018
okanogan,liberty bell jr sr high,285,2,4,0,4,2,18,248,11,136,149,110,24350,winthrop,98862,2146,2018
okanogan,methow valley elementary,334,4,0,1,1,3,21,299,6,194,140,140,24350,winthrop,98862,4501,2018
skamania,mill a elementary,21,4,0,0,0,0,2,14,1,13,8,16,30031,cook,98605,3406,2018
skamania,pacific crest innovation academy,7,0,0,0,0,0,2,5,0,4,3,0,30031,cook,98605,5480,2018
snohomish,chain lake elementary,531,2,11,0,11,4,67,416,31,252,279,89,31103,snohomish,98290,4362,2018
snohomish,frank wagner elementary,587,0,17,1,18,6,352,180,31,293,294,400,31103,monroe,98272,3060,2018
snohomish,fryelands elementary,454,0,6,0,6,1,128,293,26,253,201,155,31103,monroe,98272,4594,2018
snohomish,hidden river middle,442,4,16,0,16,1,91,312,18,222,220,107,31103,snohomish,98296,4544,2018
snohomish,leaders in learning,76,0,0,0,0,2,17,52,5,36,40,42,31103,monroe,98272,1806,2018
snohomish,maltby elementary,455,1,17,2,19,0,66,350,19,224,231,108,31103,snohomish,98296,2546,2018
snohomish,monroe high,1742,10,49,5,54,15,378,1208,77,901,841,456,31103,monroe,98272,4528,2018
snohomish,monroe special ed preschool,50,0,2,0,2,2,8,37,1,34,16,20,31103,monroe,98272,1570,2018
snohomish,out of district special ed,15,0,0,0,0,0,4,11,0,10,5,3,31103,monroe,98272,1643,2018
snohomish,park place middle,763,7,15,1,16,3,215,483,39,406,357,275,31103,monroe,98272,5040,2018
snohomish,salem woods elementary,496,7,2,0,2,1,61,394,31,253,243,104,31103,monroe,98272,4159,2018
snohomish,shoreline-monroe high,342,4,19,0,19,31,54,202,26,184,158,35,31103,monroe,98272,5154,2018
snohomish,sky valley education center,871,2,14,3,17,6,62,740,44,420,451,61,31103,monroe,98272,1777,2018
snohomish,youth re-engagement,224,2,1,0,1,10,26,185,0,111,113,21,31103,monroe,98272,1883,2018
grays harbor,beacon avenue elementary,323,6,4,1,5,0,20,271,21,177,146,127,14066,montesano,98563,3661,2018
grays harbor,montesano jr-sr high,657,13,8,0,8,0,78,516,42,343,314,203,14066,montesano,98563,2180,2018
grays harbor,simpson avenue elementary,413,6,4,1,5,0,46,323,33,210,203,141,14066,montesano,98563,3374,2018
lewis,morton elementary,159,1,3,0,3,0,16,125,14,77,82,104,21214,morton,98356,2678,2018
lewis,morton junior-senior high,151,2,6,0,6,0,17,117,9,82,69,84,21214,morton,98356,3112,2018
grant,chief moses middle,938,3,9,1,10,10,432,458,25,476,462,535,13161,moses lake,98837,3022,2018
grant,endeavor middle,258,1,1,0,1,6,168,70,12,118,140,231,13161,moses lake,98837,5354,2018
grant,frontier middle,761,2,10,0,10,12,353,363,21,385,376,443,13161,moses lake,98837,2673,2018
grant,garden heights elementary,530,2,3,0,3,3,234,267,21,280,250,274,13161,moses lake,98837,3091,2018
grant,knolls vista elementary,460,1,9,0,9,5,253,180,12,234,226,345,13161,moses lake,98837,2833,2018
grant,lakeview terrace elementary,439,1,2,0,2,6,206,218,6,226,213,263,13161,moses lake,98837,2969,2018
grant,larson heights elementary,340,1,1,0,1,4,181,147,6,169,171,300,13161,moses lake,98837,3021,2018
grant,longview elementary,459,0,0,2,2,2,229,220,6,249,210,324,13161,moses lake,98837,3153,2018
grant,midway elementary,346,0,2,1,3,2,171,162,8,181,165,289,13161,moses lake,98837,2970,2018
grant,moses lake high,2396,13,28,0,28,26,1103,1175,51,1189,1207,1209,13161,moses lake,98837,3215,2018
grant,north elementary,281,0,2,0,2,2,172,93,12,136,145,265,13161,moses lake,98837,3779,2018
grant,park orchard elementary,469,7,4,0,4,4,235,208,11,223,246,316,13161,moses lake,98837,5251,2018
grant,peninsula elementary,476,1,7,0,7,2,231,221,14,239,237,311,13161,moses lake,98837,2832,2018
grant,sage point elementary,436,0,7,0,7,0,110,312,7,212,224,138,13161,moses lake,98837,5173,2018
grant,skill source learning center,113,1,1,0,1,1,63,47,0,51,62,76,13161,moses lake,98837,5323,2018
lewis,mossyrock academy,10,0,0,0,0,0,1,9,0,6,4,9,21206,mossyrock,98564,5415,2018
lewis,mossyrock elementary,296,4,1,2,3,2,84,203,0,156,140,194,21206,mossyrock,98564,2572,2018
lewis,mossyrock jr./sr. high,225,6,4,1,5,1,58,153,2,116,109,124,21206,mossyrock,98564,3238,2018
yakima,harrah elementary,556,303,0,0,0,1,203,21,28,300,256,521,39209,harrah,98933,2506,2018
whatcom,acme elementary,232,25,0,0,0,2,21,149,35,122,110,120,37507,acme,98220,2585,2018
whatcom,educational resource center,34,3,0,0,0,0,6,21,4,21,13,0,37507,deming,98244,1936,2018
whatcom,harmony elementary,338,26,1,0,1,1,40,241,29,183,155,139,37507,bellingham,98226,3365,2018
whatcom,kendall elementary,414,15,7,1,8,8,61,302,20,211,203,302,37507,maple falls,98266,4533,2018
whatcom,mount baker academy,22,0,0,0,0,0,4,17,1,10,12,6,37507,acme,98220,5112,2018
whatcom,mount baker junior high,312,16,2,0,2,4,34,240,16,169,143,174,37507,deming,98244,3003,2018
whatcom,mount baker senior high,532,29,5,1,6,1,68,397,31,287,245,243,37507,deming,98244,2343,2018
skamania,mount pleasant,66,0,0,0,0,0,8,54,4,36,30,8,30029,washougal,98671,3459,2018
skagit,jefferson elementary,527,2,12,9,21,2,264,230,8,276,251,322,29320,mount vernon,98273,3183,2018
skagit,la venture middle,649,4,8,4,12,2,453,163,15,308,341,488,29320,mount vernon,98273,3821,2018
skagit,lincoln elementary,356,0,10,7,17,6,183,136,14,166,190,233,29320,mount vernon,98274,2579,2018
skagit,little mountain elementary,636,4,18,5,23,10,325,251,23,315,321,392,29320,mount vernon,98274,4013,2018
skagit,madison elementary,531,0,3,0,3,8,378,140,2,272,259,308,29320,mount vernon,98273,3001,2018
skagit,mount baker middle,671,3,21,5,26,6,359,256,21,346,325,399,29320,mount vernon,98274,4511,2018
skagit,mount vernon high,1982,6,50,21,71,19,1013,818,55,988,994,1028,29320,mount vernon,98273,2295,2018
skagit,mount vernon open doors,64,0,0,0,0,0,52,10,2,34,30,55,29320,mount vernon,98273,5449,2018
skagit,mount vernon special ed,133,0,2,0,2,1,76,50,4,86,47,83,29320,mount vernon,98273,3829,2018
skagit,skagit academy,341,3,4,0,4,4,16,310,4,173,168,67,29320,mount vernon,98273,1992,2018
skagit,washington elementary,416,0,4,0,4,3,260,141,8,221,195,334,29320,mount vernon,98273,2880,2018
king,muckleshoot tribal,496,463,0,0,0,1,16,2,14,251,245,326,17903,auburn,98092,1986,2018
snohomish,aces high,181,2,7,6,13,10,69,70,17,109,72,113,31006,everett,98204,4247,2018
snohomish,challenger elementary,687,0,46,6,52,55,280,204,96,340,347,494,31006,everett,98204,4303,2018
snohomish,columbia elementary,581,1,67,5,72,32,90,312,74,313,268,161,31006,mukilteo,98275,4342,2018
snohomish,discovery elementary,603,0,51,6,57,30,268,198,50,308,295,397,31006,everett,98208,4304,2018
snohomish,endeavour elementary,489,1,179,1,180,18,49,185,56,256,233,96,31006,mukilteo,98275,4469,2018
snohomish,explorer middle,954,2,133,12,145,52,406,269,80,516,438,590,31006,everett,98204,4231,2018
snohomish,fairmount elementary,549,1,86,11,97,61,157,182,51,286,263,356,31006,everett,98204,2886,2018
snohomish,harbour pointe middle,778,1,194,1,195,31,101,363,87,396,382,152,31006,mukilteo,98275,4430,2018
snohomish,horizon elementary,702,1,14,10,24,39,402,155,81,382,320,556,31006,everett,98204,4344,2018
snohomish,kamiak high,2084,3,450,6,456,70,243,1110,202,1086,998,325,31006,mukilteo,98275,4433,2018
snohomish,lake stickney elementary,565,1,114,2,116,64,130,200,54,296,269,333,31006,lynnwood,98087,5450,2018
snohomish,mariner high,2256,20,308,40,348,214,836,694,144,1186,1070,1257,31006,everett,98204,3688,2018
snohomish,mukilteo elementary,630,0,74,3,77,19,58,398,78,332,298,104,31006,mukilteo,98275,4164,2018
snohomish,odyssey elementary,567,10,56,8,64,77,198,161,57,267,300,351,31006,everett,98204,4583,2018
snohomish,olivia park elementary,596,2,63,12,75,39,241,184,55,306,290,399,31006,everett,98204,3121,2018
snohomish,olympic view middle,939,2,112,9,121,64,217,442,93,478,461,415,31006,mukilteo,98275,3120,2018
snohomish,pathfinder kindergarten center,486,4,54,5,59,49,167,155,52,266,220,282,31006,everett,98204,5482,2018
snohomish,picnic point elementary,441,1,49,7,56,39,90,207,48,230,211,177,31006,edmonds,98026,4165,2018
snohomish,serene lake elementary,421,1,50,2,52,31,69,209,59,211,210,184,31006,edmonds,98026,3687,2018
snohomish,special services,94,1,11,0,11,4,22,44,12,51,43,18,31006,everett,98204,1848,2018
snohomish,voyager middle,869,4,135,14,149,73,334,224,85,467,402,541,31006,everett,98204,4425,2018
yakima,naches valley elementary,509,3,0,0,0,5,115,369,17,263,246,268,39003,naches,98937,5451,2018
yakima,naches valley high,419,2,4,0,4,1,83,317,12,227,192,155,39003,naches,98937,2591,2018
yakima,naches valley middle,399,2,1,0,1,1,88,293,14,201,198,197,39003,naches,98937,2898,2018
lewis,napavine elementary,454,0,3,0,3,1,71,351,28,250,204,218,21014,napavine,98565,3288,2018
lewis,napavine jr sr high,392,2,2,0,2,3,46,326,13,205,187,168,21014,napavine,98565,2273,2018
pacific,naselle elementary,167,1,2,1,3,6,14,142,1,80,87,91,25155,naselle,98638,2868,2018
pacific,naselle jr sr high schools,173,0,5,1,6,1,23,138,5,97,76,89,25155,naselle,98638,3295,2018
pend oreille,newport high,396,4,2,1,3,2,19,345,23,217,179,175,26056,newport,99156,2518,2018
pend oreille,pend oreille river,24,4,0,0,0,0,2,18,0,15,9,29,26056,newport,99156,5118,2018
pend oreille,sadie halstead middle,347,2,2,0,2,0,16,312,15,184,163,210,26056,newport,99156,3968,2018
pend oreille,stratton elementary,383,1,1,1,2,0,22,337,21,220,163,261,26056,newport,99156,4478,2018
spokane,lake spokane elementary,472,4,3,2,5,1,41,387,34,263,209,157,32325,nine mile falls,99026,4036,2018
spokane,lakeside high,480,5,2,1,3,4,19,418,31,231,249,98,32325,nine mile falls,99026,4333,2018
spokane,lakeside middle,318,8,2,1,3,6,17,268,16,166,152,86,32325,nine mile falls,99026,4521,2018
spokane,nine mile falls elementary,146,0,0,0,0,0,12,126,8,73,73,30,32325,nine mile falls,99026,2341,2018
spokane,re-engagement school (nine mile falls),4,0,0,0,0,0,0,4,0,3,1,1,32325,nine mile falls,99026,5417,2018
whatcom,everson elementary,274,26,1,0,1,0,123,106,18,145,129,177,37506,everson,98247,4428,2018
whatcom,nooksack elementary,389,3,3,0,3,2,123,238,20,207,182,197,37506,everson,98247,4525,2018
whatcom,nooksack valley high,475,14,4,0,4,3,143,294,17,240,235,203,37506,everson,98247,2459,2018
whatcom,nooksack valley middle,355,16,2,2,4,1,112,204,18,176,179,174,37506,everson,98247,2687,2018
whatcom,nooksack valley special services,35,1,0,0,0,0,10,23,1,26,9,20,37506,everson,98247,1823,2018
whatcom,sumas elementary,266,9,4,0,4,4,82,152,15,147,119,149,37506,sumas,98295,2489,2018
grays harbor,north beach junior high,107,15,1,0,1,2,7,74,8,53,54,74,14064,ocean shores,98569,3788,2018
grays harbor,north beach senior high,208,27,4,0,4,6,21,139,11,118,90,106,14064,ocean shores,98569,2728,2018
grays harbor,ocean shores elementary,248,18,6,1,7,5,26,187,5,123,125,166,14064,ocean shores,98569,3787,2018
grays harbor,pacific beach elementary,156,53,0,0,0,1,20,54,28,80,76,128,14064,pacific beach,98571,3155,2018
franklin,basin city elem,408,0,1,0,1,0,322,79,6,197,211,331,11051,connell,99326,3325,2018
franklin,connell elem,574,1,13,0,13,0,415,134,11,285,289,445,11051,connell,99326,2918,2018
franklin,connell high,597,0,6,0,6,3,396,187,5,306,291,379,11051,connell,99326,3272,2018
franklin,connell preschool,41,0,0,0,0,0,32,9,0,29,12,14,11051,connell,99326,1889,2018
franklin,crcc-open doors,20,0,1,0,1,1,6,12,0,15,5,4,11051,connell,99326,5499,2018
franklin,mesa elem,168,0,0,0,0,0,107,60,1,87,81,120,11051,mesa,99343,3086,2018
franklin,north franklin virtual academy,4,0,0,0,0,0,0,4,0,0,4,0,11051,connell,99326,5261,2018
franklin,palouse junction high,27,0,0,0,0,0,22,5,0,16,11,34,11051,connell,99326,1754,2018
franklin,robert l olds junior high,355,0,5,0,5,2,261,87,0,193,162,265,11051,connell,99326,2198,2018
kitsap,david wolfle elementary,390,73,1,3,4,1,57,186,69,205,185,219,18400,kingston,98346,2798,2018
kitsap,hilder pearson elementary,316,2,11,1,12,9,50,209,34,164,152,96,18400,poulsbo,98370,2854,2018
kitsap,kingston high,756,61,13,3,16,5,77,509,88,398,358,212,18400,kingston,98346,5085,2018
kitsap,kingston middle,488,42,7,4,11,5,72,295,63,268,220,199,18400,kingston,98346,4359,2018
kitsap,middle school options,23,0,0,0,0,0,0,22,1,11,12,3,18400,kingston,98346,3126,2018
kitsap,north kitsap high,1144,10,47,6,53,9,146,813,113,544,600,229,18400,poulsbo,98370,3236,2018
kitsap,pal program,61,0,0,0,0,0,5,55,1,28,33,24,18400,kingston,98346,1733,2018
kitsap,poulsbo elementary,558,10,32,3,35,6,85,366,56,264,294,196,18400,poulsbo,98370,2026,2018
kitsap,poulsbo middle,814,11,39,4,43,12,134,529,85,420,394,244,18400,poulsbo,98370,2476,2018
kitsap,richard gordon elementary,459,5,4,0,4,3,46,342,59,217,242,148,18400,kingston,98346,4467,2018
kitsap,special programs,3,0,0,0,0,0,0,2,1,2,1,1,18400,poulsbo,98370,1677,2018
kitsap,suquamish elementary,399,49,5,1,6,2,58,230,54,187,212,180,18400,suquamish,98392,3391,2018
kitsap,vinland elementary,611,5,23,1,24,6,131,384,61,333,278,180,18400,poulsbo,98370,4461,2018
mason,belfair elementary,531,6,5,2,7,0,134,339,45,264,267,297,23403,belfair,98528,2662,2018
mason,hawkins middle,462,3,0,3,3,2,113,313,28,224,238,266,23403,belfair,98528,3174,2018
mason,james a. taylor high,47,1,0,0,0,0,4,41,1,26,21,28,23403,belfair,98528,1680,2018
mason,north mason homelink program,8,0,0,0,0,0,1,7,0,3,5,3,23403,belfair,98528,1861,2018
mason,north mason senior high,750,10,5,3,8,5,143,547,37,408,342,323,23403,belfair,98528,3175,2018
mason,sand hill elementary,462,4,5,4,9,2,107,302,38,245,217,303,23403,belfair,98528,4320,2018
pacific,north river,70,2,0,0,0,5,20,40,3,40,30,51,25200,cosmopolis,98537,2292,2018
thurston,aspire middle,303,0,17,3,20,7,45,184,47,112,191,72,34003,lacey,98513,5168,2018
thurston,chambers prairie elementary,518,5,27,19,46,38,120,217,92,273,245,273,34003,lacey,98513,5167,2018
thurston,chinook middle,743,12,83,23,106,36,156,346,87,385,358,332,34003,lacey,98516,3361,2018
thurston,evergreen forest elementary,585,13,12,17,29,24,98,302,119,276,309,182,34003,lacey,98503,4058,2018
thurston,horizons elementary,528,4,24,8,32,40,79,294,79,280,248,134,34003,lacey,98513,4408,2018
thurston,komachin middle,693,2,41,16,57,67,132,335,100,373,320,290,34003,lacey,98503,4409,2018
thurston,lacey elementary,489,4,20,11,31,21,119,236,78,270,219,285,34003,lacey,98503,3653,2018
thurston,lakes elementary,614,2,43,17,60,22,99,345,86,325,289,232,34003,lacey,98503,3539,2018
thurston,lydia hawk elementary,466,2,24,11,35,17,161,187,64,239,227,377,34003,lacey,98503,3262,2018
thurston,meadows elementary,650,3,44,10,54,21,124,310,138,328,322,198,34003,lacey,98513,4255,2018
thurston,mountain view elementary,669,5,47,9,56,19,172,329,88,337,332,344,34003,lacey,98503,3130,2018
thurston,nisqually middle,799,11,48,31,79,49,157,399,104,415,384,357,34003,lacey,98503,3611,2018
thurston,north thurston high,1443,17,139,19,158,62,271,793,142,749,694,471,34003,lacey,98506,3010,2018
thurston,olympic view elementary,549,8,33,11,44,16,114,271,96,291,258,224,34003,lacey,98516,3709,2018
thurston,pleasant glade elementary,404,3,65,5,70,15,86,163,67,203,201,238,34003,lacey,98516,4271,2018
thurston,river ridge high,1360,30,92,39,131,88,314,591,206,704,656,486,34003,lacey,98513,4427,2018
thurston,salish middle,749,12,63,17,80,31,143,373,110,382,367,278,34003,lacey,98516,5452,2018
thurston,seven oaks elementary,472,1,27,11,38,24,87,233,89,240,232,215,34003,lacey,98503,4368,2018
thurston,south bay elementary,852,7,22,8,30,29,142,533,111,426,426,251,34003,lacey,98506,2754,2018
thurston,south sound high,200,12,6,7,13,7,45,91,32,96,104,121,34003,lacey,98516,4314,2018
thurston,timberline high,1594,14,106,50,156,101,247,863,213,821,773,562,34003,lacey,98503,3710,2018
thurston,woodland elementary,533,3,18,14,32,19,109,309,61,290,243,182,34003,lacey,98503,4122,2018
stevens,northport elementary,100,0,2,2,4,0,15,78,3,50,50,88,33211,northport,99157,2062,2018
stevens,northport high,57,1,1,0,1,0,5,48,2,35,22,48,33211,northport,99157,2958,2018
stevens,northport homelink program,83,2,3,0,3,0,8,67,3,43,40,35,33211,northport,99157,5252,2018
king,arrowhead elementary,410,1,41,1,42,13,44,269,41,195,215,54,17417,kenmore,98028,3107,2018
king,bear creek elementary,345,0,140,0,140,2,12,167,24,182,163,14,17417,woodinville,98077,4305,2018
king,bothell high,1577,10,170,6,176,52,234,980,125,833,744,267,17417,bothell,98011,3106,2018
king,c o sorenson,135,0,25,1,26,0,19,77,13,98,37,14,17417,bothell,98011,2493,2018
king,canyon creek elementary,697,4,217,0,217,18,79,320,59,365,332,101,17417,bothell,98021,4017,2018
king,canyon park middle,910,1,135,1,136,13,107,563,90,447,463,128,17417,bothell,98021,3493,2018
king,cottage lake elementary,317,0,18,1,19,3,39,231,25,187,130,30,17417,woodinville,98077,3234,2018
king,crystal springs elementary,601,0,181,0,181,17,110,226,67,306,295,119,17417,bothell,98021,3105,2018
king,east ridge elementary,363,0,15,0,15,1,24,286,37,191,172,6,17417,woodinville,98077,4379,2018
king,fernwood elementary,781,0,354,1,355,11,43,318,54,380,401,36,17417,bothell,98012,4306,2018
king,frank love elementary,639,1,141,1,142,24,81,336,55,302,337,112,17417,bothell,98021,4355,2018
king,hollywood hill elementary,335,0,16,1,17,6,34,239,39,166,169,39,17417,woodinville,98072,4124,2018
king,inglemoor hs,1749,8,282,8,290,35,233,1044,139,878,871,243,17417,kenmore,98028,3492,2018
king,kenmore elementary,505,1,33,2,35,11,134,265,59,248,257,191,17417,kenmore,98028,2993,2018
king,kenmore middle,710,1,84,0,84,20,135,400,70,357,353,151,17417,kenmore,98028,3345,2018
king,kokanee elementary,696,1,277,3,280,13,50,300,52,379,317,53,17417,woodinville,98072,4455,2018
king,leota middle,886,2,197,5,202,15,114,487,66,475,411,119,17417,woodinville,98072,3790,2018
king,lockwood elementary,647,1,159,0,159,13,58,356,60,346,301,41,17417,bothell,98021,3390,2018
king,maywood hills elementary,621,3,90,0,90,18,64,380,66,326,295,125,17417,bothell,98011,3344,2018
king,moorlands elementary,623,0,82,0,82,12,51,432,46,302,321,48,17417,kenmore,98028,3442,2018
king,north creek high,1281,9,369,2,371,24,150,639,88,636,645,157,17417,bothell,98012,5481,2018
king,northshore middle,895,3,152,1,153,10,147,501,81,472,423,130,17417,bothell,98011,4021,2018
king,northshore networks,138,2,8,1,9,2,15,102,8,61,77,17,17417,bothell,98021,1814,2018
king,northshore online,19,1,0,1,1,0,1,15,1,13,6,2,17417,bothell,98021,5331,2018
king,northshore special services,220,0,32,0,32,8,31,127,22,140,80,2,17417,bothell,98021,1815,2018
king,secondary academy for success,102,0,0,1,1,2,15,70,14,41,61,38,17417,bothell,98021,3811,2018
king,shelton view elementary,447,1,131,1,132,13,44,203,54,222,225,60,17417,bothell,98021,3679,2018
king,skyview middle,954,3,310,2,312,25,96,438,80,493,461,130,17417,bothell,98021,4371,2018
king,sunrise elementary,349,0,78,0,78,3,23,213,32,166,183,5,17417,redmond,98052,4187,2018
king,timbercrest middle,737,0,48,1,49,4,58,576,50,372,365,44,17417,woodinville,98077,4516,2018
king,wellington elementary,457,2,63,0,63,3,28,319,42,250,207,32,17417,woodinville,98072,4069,2018
king,westhill elementary,463,1,61,1,62,8,65,276,51,255,208,73,17417,bothell,98011,3287,2018
king,woodin elementary,526,2,70,0,70,12,182,227,33,269,257,151,17417,bothell,98011,3749,2018
king,woodinville hs,1763,3,178,3,181,19,168,1243,149,917,846,142,17417,woodinville,98072,4208,2018
king,woodmoor elementary,794,4,165,0,165,10,153,382,80,404,390,172,17417,bothell,98011,4377,2018
island,broadview elementary,434,0,35,7,42,17,78,240,57,227,207,142,15201,oak harbor,98277,3477,2018
island,crescent harbor elem,493,3,11,2,13,17,99,300,61,253,240,250,15201,oak harbor,98277,3377,2018
island,hillcrest elementary,569,0,25,6,31,15,91,366,66,290,279,144,15201,oak harbor,98277,4328,2018
island,homeconnection,302,0,4,0,4,7,21,255,15,147,155,49,15201,oak harbor,98277,1758,2018
island,igrad academy,8,0,0,0,0,0,2,5,1,4,4,6,15201,oak harbor,98277,5343,2018
island,north whidbey middle,773,4,60,9,69,32,139,449,80,414,359,284,15201,oak harbor,98277,3939,2018
island,oak harbor elementary,404,0,22,3,25,13,82,223,61,201,203,124,15201,oak harbor,98277,2696,2018
island,oak harbor high,1561,5,169,11,180,70,227,933,146,811,750,484,15201,oak harbor,98277,2974,2018
island,oak harbor intermediate,903,4,50,9,59,35,156,524,125,461,442,335,15201,oak harbor,98277,3274,2018
island,olympic view elem,457,1,18,2,20,27,117,220,72,241,216,229,15201,oak harbor,98277,3566,2018
island,special education,152,0,6,1,7,5,30,93,17,110,42,96,15201,oak harbor,98277,3662,2018
whitman,oakesdale elementary,48,0,0,0,0,0,2,44,2,31,17,21,38324,oakesdale,99158,3205,2018
whitman,oakesdale high,69,0,0,0,0,0,7,61,1,27,42,21,38324,oakesdale,99158,2432,2018
grays harbor,oakville elementary,114,30,1,0,1,0,18,56,9,64,50,73,14400,oakville,98568,2922,2018
grays harbor,oakville high,121,23,1,0,1,0,14,77,6,58,63,79,14400,oakville,98568,2283,2018
pacific,hilltop,328,4,2,0,2,0,58,248,16,170,158,198,25101,ilwaco,98624,2517,2018
pacific,ilwaco high,272,4,4,0,4,0,34,217,12,147,125,143,25101,ilwaco,98624,4220,2018
pacific,long beach elementary,239,0,2,1,3,0,46,178,12,130,109,167,25101,long beach,98631,3531,2018
pacific,ocean beach alternative,32,1,0,0,0,0,3,27,1,13,19,29,25101,long beach,98631,5454,2018
pacific,ocean beach early childhood center,14,0,0,0,0,0,2,11,1,7,7,12,25101,long beach,98631,5179,2018
pacific,ocean park elementary,152,1,1,0,1,0,39,98,13,81,71,109,25101,ocean park,98640,4039,2018
grays harbor,ocosta elementary,297,7,2,0,2,2,66,195,25,163,134,203,14172,westport,98595,3025,2018
grays harbor,ocosta junior - senior high,291,14,3,0,3,3,53,185,33,149,142,170,14172,westport,98595,3024,2018
lincoln,odessa high,113,4,0,0,0,1,11,97,0,60,53,42,22105,odessa,99159,2443,2018
lincoln,p c jantz elementary,127,1,0,0,0,3,18,105,0,65,62,74,22105,odessa,99159,2769,2018
okanogan,grainger elementary,477,36,0,0,0,2,149,255,35,268,209,310,24105,okanogan,98840,2539,2018
okanogan,okanogan alternative high,22,3,0,0,0,0,7,9,3,9,13,20,24105,omak,98841,1980,2018
okanogan,okanogan high,300,22,3,0,3,1,73,183,18,153,147,127,24105,okanogan,98840,2246,2018
okanogan,okanogan middle,254,20,1,0,1,2,65,147,19,136,118,114,24105,okanogan,98840,2245,2018
okanogan,okanogan outreach alternative,78,19,0,0,0,0,15,35,9,25,53,66,24105,okanogan,98840,5151,2018
thurston,avanti high,145,0,1,0,1,0,15,113,16,61,84,39,34111,olympia,98501,1768,2018
thurston,boston harbor elementary,184,2,1,0,1,2,10,153,16,86,98,33,34111,olympia,98506,2487,2018
thurston,capital high,1405,11,114,4,118,30,162,967,117,710,695,363,34111,olympia,98502,3960,2018
thurston,centennial elementary olympia,531,0,64,2,66,8,64,329,64,260,271,74,34111,olympia,98501,4367,2018
thurston,garfield elementary,385,3,39,1,40,21,72,197,52,205,180,222,34111,olympia,98502,2448,2018
thurston,jefferson middle,434,2,52,2,54,18,59,246,55,222,212,185,34111,olympia,98502,3133,2018
thurston,julia butler hansen elementary,455,11,30,0,30,28,78,246,62,257,198,214,34111,olympia,98502,4472,2018
thurston,leland p brown elementary,379,3,2,2,4,10,59,260,43,200,179,214,34111,olympia,98502,3540,2018
thurston,lincoln elementary,278,0,3,1,4,3,33,217,21,152,126,60,34111,olympia,98501,2342,2018
thurston,madison elementary,259,1,21,3,24,8,39,153,34,142,117,117,34111,olympia,98501,3066,2018
thurston,mckenny elementary,378,4,26,1,27,11,50,237,49,209,169,114,34111,olympia,98501,4458,2018
thurston,mclane elementary,312,4,38,1,39,8,33,200,28,185,127,91,34111,olympia,98502,2621,2018
thurston,olympia high,1839,7,182,4,186,40,151,1280,175,932,907,274,34111,olympia,98501,3132,2018
thurston,olympia regional learning academy,453,4,3,0,3,4,31,371,40,233,220,130,34111,olympia,98501,5078,2018
thurston,olympia regional learning academy - montessori,210,1,15,0,15,2,18,148,25,108,102,35,34111,olympia,98501,5248,2018
thurston,pioneer elementary,486,1,28,1,29,4,37,370,45,263,223,80,34111,olympia,98501,3697,2018
thurston,reeves middle,442,0,13,2,15,10,61,316,40,226,216,137,34111,olympia,98506,3696,2018
thurston,roosevelt elementary,409,1,13,0,13,5,63,280,47,217,192,169,34111,olympia,98506,2778,2018
thurston,thurgood marshall middle,385,5,22,2,24,15,58,239,44,205,180,144,34111,olympia,98502,4473,2018
thurston,washington middle,808,1,68,2,70,9,65,590,73,429,379,120,34111,olympia,98501,3711,2018
okanogan,e omak elementary,370,80,3,0,3,0,104,149,34,184,186,193,24019,omak,98841,3051,2018
okanogan,highlands high,17,7,0,0,0,0,5,5,0,8,9,16,24019,omak,98841,4279,2018
okanogan,n omak elementary,505,85,2,0,2,4,125,252,37,274,231,307,24019,omak,98841,2999,2018
okanogan,omak high,395,100,0,0,0,3,75,190,27,201,194,145,24019,omak,98841,2031,2018
okanogan,omak middle,351,75,2,0,2,0,83,145,46,176,175,176,24019,omak,98841,4237,2018
okanogan,washington virtual academy omak elementary,1235,34,86,24,110,129,131,796,35,618,617,560,24019,omak,98841,5195,2018
okanogan,washington virtual academy omak high,1246,21,43,14,57,90,86,976,16,539,707,397,24019,omak,98841,5197,2018
okanogan,washington virtual academy omak middle,1270,24,52,24,76,101,115,940,14,603,667,560,24019,omak,98841,5196,2018
lewis,onalaska elementary,392,3,0,1,1,0,55,312,21,209,183,224,21300,onalaska,98570,3239,2018
lewis,onalaska high,235,1,2,0,2,0,21,200,11,115,120,114,21300,onalaska,98570,2331,2018
lewis,onalaska middle,187,1,0,0,0,0,19,158,9,94,93,109,21300,onalaska,98570,4335,2018
stevens,onion creek elementary,31,0,0,0,0,0,1,27,3,18,13,23,33030,colville,99114,2049,2018
san juan,oasis k-12,367,1,6,0,6,9,9,319,23,160,207,35,28137,eastsound,98245,1892,2018
san juan,orcas island elementary,187,2,1,1,2,0,46,125,12,107,80,96,28137,eastsound,98245,2749,2018
san juan,orcas island high,114,1,6,1,7,1,10,88,7,50,64,42,28137,eastsound,98245,2750,2018
san juan,orcas island middle,89,1,3,1,4,0,18,61,5,50,39,43,28137,eastsound,98245,4558,2018
san juan,waldron island,8,0,0,0,0,0,0,7,1,5,3,2,28137,waldron island,98297,3808,2018
spokane,orchard prairie elementary,73,0,0,0,0,2,5,66,0,33,40,0,32123,spokane,99217,3723,2018
ferry,orient elem,39,0,1,0,1,0,0,38,0,23,16,23,10065,orient,99160,2136,2018
douglas,orondo elementary and middle,184,0,0,0,0,0,163,21,0,86,98,154,09013,orondo,98843,2666,2018
okanogan,oroville elementary,332,7,1,0,1,1,134,182,7,168,164,255,24410,oroville,98844,2422,2018
okanogan,oroville middle-high,276,6,4,2,6,0,97,163,4,144,132,176,24410,oroville,98844,2706,2018
pierce,orting high,812,3,11,5,16,10,114,610,59,426,386,218,27344,orting,98360,2942,2018
pierce,orting middle,598,2,8,3,11,7,87,428,63,304,294,166,27344,orting,98360,4262,2018
pierce,orting primary,591,4,3,2,5,6,64,443,69,300,291,190,27344,orting,98360,2360,2018
pierce,orting special education,14,0,0,1,1,2,1,10,0,8,6,6,27344,orting,98360,5011,2018
pierce,ptarmigan ridge elementary,672,5,10,0,10,9,111,476,61,343,329,223,27344,orting,98360,4547,2018
adams,desert oasis high,77,0,0,0,0,0,74,3,0,50,27,69,01147,othello,99344,5367,2018
adams,hiawatha elementary,559,0,2,0,2,0,496,60,1,287,272,493,01147,othello,99344,2961,2018
adams,lutacaga elementary,580,0,2,0,2,1,551,24,2,295,285,464,01147,othello,99344,2902,2018
adams,mcfarland middle,988,0,1,0,1,0,897,86,4,509,479,784,01147,othello,99344,3471,2018
adams,othello high,1126,0,5,1,6,2,985,126,7,602,524,815,01147,othello,99344,3015,2018
adams,scootney springs elementary,547,0,1,0,1,1,485,58,2,302,245,458,01147,othello,99344,3730,2018
adams,wahitis elementary,532,0,0,0,0,2,471,58,1,279,253,450,01147,othello,99344,5285,2018
douglas,palisades elementary,24,1,0,0,0,0,15,8,0,13,11,22,09102,palisades,98845,2502,2018
whitman,palouse at garfield middle,42,0,0,0,0,0,4,34,4,16,26,15,38301,palouse,99161,1961,2018
whitman,palouse elementary,89,0,0,0,0,0,0,88,1,42,47,26,38301,palouse,99161,2622,2018
whitman,palouse high,60,0,0,0,0,0,3,52,5,39,21,16,38301,palouse,99161,2634,2018
franklin,barbara mcclintock stem elementary,784,0,10,1,11,4,403,336,30,380,404,379,11001,pasco,99301,5391,2018
franklin,captain gray stem elementary,590,0,1,0,1,9,533,43,4,310,280,503,11001,pasco,99301,5392,2018
franklin,chiawana high,2724,7,48,7,55,44,1731,798,89,1403,1321,1620,11001,pasco,99301,5164,2018
franklin,edwin markham elementary,402,0,0,0,0,0,142,253,7,224,178,177,11001,pasco,99301,3425,2018
franklin,ellen ochoa middle,703,1,2,0,2,6,665,20,9,333,370,634,11001,pasco,99301,4564,2018
franklin,emerson elementary,691,3,0,1,1,3,644,34,6,334,357,547,11001,pasco,99301,2967,2018
franklin,internet pasco academy of learning,16,0,0,0,0,0,10,6,0,6,10,11,11001,pasco,99301,5393,2018
franklin,james mcgee elementary,666,0,10,3,13,16,360,239,38,358,308,372,11001,pasco,99301,4155,2018
franklin,longfellow elementary,483,0,1,0,1,1,462,18,1,248,235,403,11001,pasco,99301,2790,2018
franklin,marie curie stem elementary,840,0,4,0,4,7,781,38,10,415,425,733,11001,pasco,99301,5394,2018
franklin,mark twain elementary,754,0,3,1,4,14,493,219,24,363,391,532,11001,pasco,99301,3085,2018
franklin,maya angelou elementary,899,1,22,3,25,7,478,347,41,462,437,440,11001,pasco,99301,4595,2018
franklin,mcloughlin middle,1286,4,23,7,30,17,617,560,58,647,639,673,11001,pasco,99301,2267,2018
franklin,new horizons high,271,0,1,1,2,4,225,34,6,156,115,185,11001,pasco,99301,3912,2018
franklin,pasco early childhood,37,1,0,0,0,1,21,13,1,22,15,19,11001,pasco,99301,1970,2018
franklin,pasco early learning center,4,0,0,0,0,0,2,2,0,3,1,105,11001,pasco,99301,5483,2018
franklin,pasco senior high,2244,1,19,0,19,35,1817,338,34,1153,1091,1593,11001,pasco,99301,2917,2018
franklin,robert frost elementary,650,0,1,1,2,6,475,159,8,334,316,539,11001,pasco,99301,3515,2018
franklin,rosalind franklin stem elementary,814,2,5,0,5,10,415,351,31,440,374,398,11001,pasco,99301,5345,2018
franklin,rowena chess elementary,534,0,0,0,0,5,496,26,7,277,257,456,11001,pasco,99301,4555,2018
franklin,ruth livingston elementary,780,1,17,3,20,11,269,432,47,408,372,330,11001,pasco,99301,4041,2018
franklin,stevens middle,715,0,3,0,3,8,643,56,5,355,360,588,11001,pasco,99301,3324,2018
franklin,virgie robinson elementary,777,0,3,0,3,6,734,29,5,393,384,687,11001,pasco,99301,5020,2018
franklin,whittier elementary,612,0,6,0,6,4,570,25,7,320,292,531,11001,pasco,99301,4526,2018
okanogan,pateros elementary,176,0,2,0,2,1,98,73,2,100,76,126,24122,pateros,98846,2396,2018
okanogan,pateros high,147,0,0,0,0,0,82,60,5,70,77,98,24122,pateros,98846,2397,2018
benton,paterson elementary,124,0,0,0,0,0,63,61,0,74,50,102,03050,paterson,99345,2133,2018
lewis,pe ell,254,3,0,0,0,1,21,213,16,144,110,127,21301,pe ell,98572,2858,2018
pierce,artondale elementary,486,3,11,1,12,2,54,369,46,244,242,89,27401,gig harbor,98335,3299,2018
pierce,discovery elementary,518,1,13,0,13,4,41,407,52,263,255,111,27401,gig harbor,98335,4080,2018
pierce,evergreen elementary,269,2,1,0,1,3,24,216,23,142,127,156,27401,lakebay,98349,3055,2018
pierce,gig harbor high,1626,7,41,8,49,16,129,1301,124,829,797,250,27401,gig harbor,98335,4081,2018
pierce,goodman middle,572,5,11,1,12,5,56,432,62,298,274,140,27401,gig harbor,98335,2294,2018
pierce,harbor heights elementary,590,0,7,2,9,8,79,423,71,285,305,168,27401,gig harbor,98335,2944,2018
pierce,harbor ridge middle,601,4,17,1,18,9,45,472,53,289,312,117,27401,gig harbor,98332,4387,2018
pierce,henderson bay alt high,130,1,1,0,1,3,7,103,15,69,61,64,27401,gig harbor,98332,1516,2018
pierce,key peninsula middle,481,2,4,0,4,0,40,394,41,254,227,235,27401,lakebay,98349,4156,2018
pierce,kopachuck middle,520,2,6,0,6,5,32,434,41,264,256,84,27401,gig harbor,98335,4219,2018
pierce,minter creek elementary,393,1,5,0,5,1,29,318,39,212,181,152,27401,gig harbor,98329,4189,2018
pierce,peninsula high,1411,4,23,6,29,14,111,1126,127,710,701,440,27401,gig harbor,98332,2681,2018
pierce,purdy elementary,604,3,20,3,23,8,60,459,51,301,303,133,27401,gig harbor,98332,3685,2018
pierce,vaughn elementary,398,1,0,0,0,4,43,298,52,218,180,162,27401,vaughn,98394,3056,2018
pierce,voyager elementary,631,4,9,1,10,4,50,509,54,325,306,90,27401,gig harbor,98335,4307,2018
mason,pioneer elementary,523,10,2,0,2,5,73,397,36,279,244,351,23402,shelton,98584,4463,2018
mason,pioneer middle,255,5,0,0,0,2,31,202,15,138,117,154,23402,shelton,98584,2865,2018
garfield,pomeroy elementary,184,0,2,0,2,2,17,161,2,98,86,93,12110,pomeroy,99347,3087,2018
garfield,pomeroy jr sr high,150,0,4,0,4,0,9,131,6,79,71,61,12110,pomeroy,99347,2241,2018
clallam,dry creek elementary,388,85,4,1,5,2,33,195,68,206,182,251,05121,port angeles,98363,4494,2018
clallam,franklin elementary,420,19,10,0,10,3,38,315,35,227,193,234,05121,port angeles,98362,2909,2018
clallam,hamilton elementary,387,10,6,0,6,1,39,293,38,195,192,213,05121,port angeles,98363,3079,2018
clallam,jefferson elementary,321,13,2,0,2,7,42,224,33,163,158,201,05121,port angeles,98362,2368,2018
clallam,lincoln high,73,6,0,0,0,1,2,51,13,27,46,73,05121,port angeles,98363,4003,2018
clallam,parents as partners,4,0,0,0,0,0,0,3,1,2,2,6,05121,port angeles,98362,1715,2018
clallam,port angeles high,1138,38,21,2,23,10,96,867,104,575,563,428,05121,port angeles,98362,2908,2018
clallam,roosevelt elementary,525,7,4,0,4,1,31,424,58,272,253,274,05121,port angeles,98362,5115,2018
clallam,special education,28,1,2,0,2,0,1,23,1,15,13,22,05121,port angeles,98362,1897,2018
clallam,stevens middle,557,26,9,1,10,2,49,413,57,289,268,282,05121,port angeles,98363,3318,2018
jefferson,blue heron middle,419,5,8,3,11,5,37,337,24,205,214,213,16050,port townsend,98368,4475,2018
jefferson,ocean,72,2,1,0,1,0,1,65,3,29,43,28,16050,port townsend,98368,1798,2018
jefferson,port townsend high,341,3,10,1,11,4,29,274,20,164,177,139,16050,port townsend,98368,2503,2018
jefferson,salish coast elementary,341,4,7,0,7,6,28,286,10,171,170,173,16050,port townsend,98368,3094,2018
walla walla,prescott elementary,139,0,0,0,0,1,112,26,0,78,61,120,36402,prescott,99348,3574,2018
walla walla,prescott special ed pre-school,4,0,0,0,0,0,3,1,0,4,0,6,36402,prescott,99348,5157,2018
spokane,pride prep,396,23,7,5,12,38,10,287,26,221,175,194,32907,spokane,99202,5339,2018
benton,housel middle,617,6,4,0,4,1,386,202,18,287,330,411,03116,prosser,99350,2906,2018
benton,keene-riverview elementary,483,3,8,0,8,3,313,147,9,262,221,335,03116,prosser,99350,2195,2018
benton,prosser heights elementary,474,3,7,0,7,2,307,145,10,227,247,332,03116,prosser,99350,3316,2018
benton,prosser high,904,2,13,2,15,6,557,302,22,462,442,510,03116,prosser,99350,2508,2018
benton,whitstran elementary,269,1,2,0,2,0,203,58,5,131,138,231,03116,prosser,99350,2905,2018
whitman,franklin elementary,469,2,48,0,48,13,37,334,35,232,237,167,38267,pullman,99163,2587,2018
whitman,jefferson elementary,536,2,41,2,43,16,83,358,34,292,244,185,38267,pullman,99163,3203,2018
whitman,lincoln middle,642,4,55,1,56,19,66,450,47,332,310,188,38267,pullman,99163,3419,2018
whitman,pullman high,849,4,86,3,89,21,84,598,53,424,425,187,38267,pullman,99163,2499,2018
whitman,sunnyside elementary,440,4,54,0,54,10,42,297,33,243,197,128,38267,pullman,99163,3614,2018
pierce,aylen jr high,801,8,40,5,45,24,144,493,87,416,385,242,27003,puyallup,98371,3447,2018
pierce,ballou jr high,871,8,68,11,79,43,151,477,113,451,420,315,27003,puyallup,98373,3750,2018
pierce,brouillet elementary,755,4,31,15,46,13,115,473,104,407,348,195,27003,puyallup,98375,4361,2018
pierce,carson elementary,955,6,66,25,91,58,144,514,142,499,456,302,27003,puyallup,98375,5088,2018
pierce,edgemont jr high,496,6,32,10,42,23,73,311,41,237,259,194,27003,edgewood,98372,2575,2018
pierce,edgerton elementary,755,5,22,9,31,51,96,483,89,389,366,186,27003,puyallup,98374,5093,2018
pierce,emerald ridge high,1523,13,57,22,79,74,218,953,186,823,700,367,27003,puyallup,98374,4540,2018
pierce,ferrucci jr high,718,13,29,8,37,27,134,406,101,396,322,270,27003,puyallup,98374,4183,2018
pierce,firgrove elementary,746,2,53,22,75,44,247,288,90,424,322,423,27003,puyallup,98373,2496,2018
pierce,fruitland elementary,579,6,27,5,32,11,70,377,83,290,289,154,27003,puyallup,98371,3557,2018
pierce,glacier view junior high,840,1,38,8,46,37,138,490,128,434,406,232,27003,puyallup,98374,5142,2018
pierce,hunt elementary,656,11,32,3,35,21,123,370,96,334,322,266,27003,puyallup,98374,4360,2018
pierce,kalles junior high,897,8,68,7,75,25,120,578,91,468,429,210,27003,puyallup,98372,3052,2018
pierce,karshner elementary,359,15,13,3,16,6,134,148,40,193,166,199,27003,puyallup,98371,2870,2018
pierce,maplewood elementary,447,2,12,0,12,4,38,315,76,234,213,101,27003,puyallup,98371,2498,2018
pierce,meeker elementary,409,5,16,4,20,14,59,266,45,217,192,124,27003,puyallup,98371,2334,2018
pierce,mt view elementary,330,3,7,6,13,14,39,223,38,150,180,118,27003,edgewood,98372,3572,2018
pierce,northwood elementary,457,3,52,8,60,15,73,239,67,255,202,165,27003,edgewood,98371,3927,2018
pierce,pope elementary,570,7,22,1,23,25,99,359,57,288,282,187,27003,puyallup,98374,4146,2018
pierce,psd special services,133,2,3,2,5,11,16,84,15,86,47,26,27003,puyallup,98371,3951,2018
pierce,puyallup high,1823,13,107,16,123,57,256,1205,169,925,898,468,27003,puyallup,98371,2125,2018
pierce,puyallup online academy/poa,129,1,6,2,8,3,22,81,14,53,76,75,27003,puyallup,98373,1640,2018
pierce,puyallup open doors/pod,142,2,1,0,1,3,25,91,20,74,68,68,27003,puyalllup,98373,5321,2018
pierce,puyallup parent partnership program,1,0,0,0,0,0,0,1,0,0,1,3,27003,puyallup,98373,5322,2018
pierce,ridgecrest elementary,519,2,11,7,18,14,96,353,36,260,259,212,27003,puyallup,98374,4121,2018
pierce,rogers high,1840,18,114,42,156,117,285,1017,247,948,892,477,27003,puyallup,98373,3645,2018
pierce,shaw road elementary,679,1,45,5,50,15,71,451,91,358,321,165,27003,puyallup,98372,4414,2018
pierce,spinning elementary,331,5,10,4,14,4,79,190,39,166,165,177,27003,puyallup,98372,2497,2018
pierce,stahl junior high,831,7,68,36,104,43,171,374,132,422,409,307,27003,puyallup,98375,4443,2018
pierce,stewart elementary,350,2,10,8,18,16,82,181,51,169,181,209,27003,puyallup,98372,2311,2018
pierce,sunrise elementary,477,3,21,12,33,11,101,262,67,251,226,228,27003,puyallup,98374,3896,2018
pierce,walker high,118,3,1,1,2,4,24,67,18,59,59,75,27003,puyallup,98372,3972,2018
pierce,waller road elementary,371,23,7,2,9,14,64,199,62,198,173,180,27003,tacoma,98443,2495,2018
pierce,wildwood elementary,491,2,18,7,25,21,124,259,60,237,254,258,27003,puyallup,98374,3558,2018
pierce,woodland elementary,701,7,17,15,32,17,109,437,99,350,351,267,27003,puyallup,98373,2519,2018
pierce,zeiger elementary,731,5,55,9,64,25,130,414,93,376,355,241,27003,puyallup,98373,4496,2018
jefferson,pearl,278,0,2,1,3,5,20,238,12,136,142,0,16048,quilcene,98376,5236,2018
jefferson,quilcene high and elementary,225,6,3,0,3,2,9,182,23,117,108,95,16048,quilcene,98376,2474,2018
clallam,quileute tribal,71,43,0,2,2,3,11,10,1,39,32,62,05903,la push,98350,5430,2018
clallam,district run home,15,1,0,0,0,0,1,11,2,9,6,13,05402,forks,98331,1671,2018
clallam,forks alternative,25,6,0,0,0,0,3,13,3,12,13,17,05402,forks,98331,1500,2018
clallam,forks elementary,317,25,1,0,1,0,113,146,32,166,151,214,05402,forks,98331,3737,2018
clallam,forks intermediate,229,21,1,0,1,0,80,103,24,113,116,145,05402,forks,98331,5363,2018
clallam,forks junior-senior high,456,46,5,0,5,3,146,227,29,242,214,242,05402,forks,98331,2349,2018
clallam,insight school of washington,1914,21,38,17,55,87,351,1210,190,770,1144,1215,05402,forks,98331,5071,2018
grant,george elementary,200,0,0,0,0,0,179,20,1,86,114,182,13144,quincy,98848,3426,2018
grant,monument elementary,666,1,0,0,0,0,611,50,4,345,321,578,13144,quincy,98848,4536,2018
grant,mountain view elementary,448,0,1,0,1,4,397,45,1,224,224,382,13144,quincy,98848,3020,2018
grant,pioneer elementary,441,0,0,0,0,0,402,38,1,213,228,375,13144,quincy,98848,2919,2018
grant,quincy high,802,1,3,0,3,5,664,128,1,403,399,573,13144,quincy,98848,3088,2018
grant,quincy innovation academy,38,0,0,0,0,1,34,3,0,25,13,37,13144,quincy,98848,1506,2018
grant,quincy junior high,393,1,0,0,0,1,352,38,1,190,203,334,13144,quincy,98848,2510,2018
king,rainier prep,335,1,30,3,33,119,94,62,26,174,161,249,17908,seattle,98168,5380,2018
thurston,rainier elementary,432,5,1,1,2,1,39,354,31,229,203,205,34307,rainier,98576,4486,2018
thurston,rainier middle,194,1,2,1,3,0,22,149,19,88,106,92,34307,rainier,98576,2158,2018
thurston,rainier senior high,252,2,2,0,2,0,23,202,23,127,125,88,34307,rainier,98576,2468,2018
pacific,developmental preschool,3,0,0,0,0,0,0,3,0,1,2,4,25116,raymond,98577,1672,2018
pacific,raymond elementary,279,4,13,1,14,0,74,178,9,141,138,211,25116,raymond,98577,2803,2018
pacific,raymond jr sr high,250,8,17,2,19,1,70,143,9,140,110,153,25116,raymond,98577,2357,2018
lincoln,reardan elementary,224,10,1,0,1,0,4,200,9,117,107,91,22009,reardan,99029,2864,2018
lincoln,reardan middle-senior high,286,5,0,0,0,0,14,253,14,150,136,90,22009,reardan,99029,2478,2018
king,benson hill elementary,541,2,191,7,198,65,89,116,71,268,273,234,17403,renton,98058,3587,2018
king,bryn mawr elementary,463,3,124,5,129,102,113,57,59,227,236,298,17403,seattle,98178,2439,2018
king,campbell hill elementary,451,6,87,13,100,175,108,30,32,221,230,341,17403,seattle,98178,3034,2018
king,cascade elementary,528,4,102,14,116,77,156,99,76,236,292,318,17403,renton,98058,3337,2018
king,dimmitt middle,644,4,162,10,172,220,124,58,66,313,331,447,17403,seattle,98178,3280,2018
king,h.o.m.e. program,131,0,2,0,2,5,3,116,5,59,72,12,17403,renton,98055,1784,2018
king,hazelwood elementary,659,5,151,1,152,27,73,313,89,348,311,117,17403,newcastle,98056,3485,2018
king,hazen senior high,1649,8,506,4,510,98,383,585,65,835,814,475,17403,renton,98059,3630,2018
king,highlands elementary,514,2,97,3,100,44,242,72,54,267,247,341,17403,renton,98056,2640,2018
king,honey dew elementary,492,1,79,3,82,28,250,103,28,239,253,329,17403,renton,98058,5229,2018
king,kennydale elementary,653,3,182,2,184,41,114,247,64,348,305,195,17403,renton,98056,2597,2018
king,lakeridge elementary,423,3,57,8,65,225,67,36,27,202,221,335,17403,seattle,98178,2929,2018
king,lindbergh senior high,1258,7,346,16,362,193,252,383,61,654,604,544,17403,renton,98058,3741,2018
king,maplewood heights elementary,792,1,268,3,271,34,145,269,72,414,378,216,17403,renton,98059,3586,2018
king,mcknight middle,874,0,219,2,221,58,312,225,58,434,440,414,17403,renton,98056,3035,2018
king,meadow crest early childhood education center,333,2,56,2,58,52,100,92,29,219,114,180,17403,renton,98056,5313,2018
king,nelsen middle,1012,1,251,17,268,174,199,268,102,538,474,556,17403,renton,98055,3434,2018
king,open door youth reengagement renton,39,2,1,0,1,10,10,13,3,21,18,50,17403,renton,98055,5335,2018
king,out of district facility,17,0,0,0,0,3,2,11,1,13,4,5,17403,renton,98055,1648,2018
king,renton academy,40,1,1,0,1,15,5,15,3,33,7,22,17403,renton,98055,5070,2018
king,renton park elementary,486,3,58,9,67,87,132,143,54,240,246,300,17403,renton,98058,3521,2018
king,renton senior high,1340,6,419,23,442,352,325,144,71,676,664,770,17403,renton,98055,2475,2018
king,risdon middle,818,3,230,4,234,49,186,285,61,413,405,320,17403,newcastle,98056,5484,2018
king,sierra heights elementary,587,2,138,6,144,29,168,185,59,307,280,252,17403,renton,98059,3668,2018
king,talbot hill elementary,535,3,160,7,167,83,92,110,80,282,253,216,17403,renton,98055,3740,2018
king,talley high,312,4,30,3,33,68,93,76,38,167,145,174,17403,seattle,98178,5282,2018
king,tiffany park elementary,470,0,78,3,81,80,102,159,48,252,218,238,17403,renton,98058,3702,2018
ferry,republic elementary,145,4,2,0,2,2,9,111,17,87,58,108,10309,republic,99166,2789,2018
ferry,republic junior high,75,8,1,0,1,0,3,58,5,43,32,46,10309,republic,99166,3559,2018
ferry,republic parent partner,67,0,0,0,0,0,1,66,0,35,32,2,10309,republic,99166,1898,2018
ferry,republic senior high,96,12,0,0,0,1,7,70,6,57,39,34,10309,republic,99166,3579,2018
benton,badger mountain elementary,617,0,34,0,34,16,125,409,33,319,298,192,03400,richland,99352,4060,2018
benton,carmichael middle,812,2,25,1,26,17,203,526,38,409,403,368,03400,richland,99352,2721,2018
benton,chief joseph middle,757,2,25,3,28,19,162,513,33,383,374,405,03400,richland,99352,2785,2018
benton,enterprise middle,690,3,22,0,22,4,138,500,23,383,307,225,03400,west richland,99353,3926,2018
benton,hanford high,2166,12,111,4,115,48,316,1595,80,1080,1086,482,03400,richland,99352,3833,2018
benton,jason lee elementary,547,0,7,0,7,3,117,374,46,266,281,344,03400,richland,99352,2786,2018
benton,jefferson elementary,486,0,15,6,21,29,124,290,22,248,238,340,03400,richland,99352,2642,2018
benton,leona libby middle,680,4,39,0,39,8,61,536,32,334,346,79,03400,west richland,99353,5493,2018
benton,lewis & clark elementary,556,3,31,2,33,6,123,365,26,307,249,321,03400,richland,99352,2657,2018
benton,marcus whitman elementary,565,6,4,0,4,5,146,369,35,285,280,404,03400,richland,99352,2656,2018
benton,orchard elementary,700,0,53,1,54,11,114,474,47,364,336,121,03400,richland,99352,5419,2018
benton,richland high,2036,11,61,3,64,47,309,1547,58,1034,1002,537,03400,richland,99352,3511,2018
benton,rivers edge high,227,3,1,0,1,3,67,146,7,132,95,125,03400,richland,99352,4295,2018
benton,sacajawea elementary,560,4,19,4,23,13,140,360,20,285,275,292,03400,richland,99352,3732,2018
benton,special programs,121,1,2,0,2,1,21,90,6,79,42,3,03400,richland,99352,2001,2018
benton,tapteal elementary,658,4,10,0,10,5,158,428,53,305,353,341,03400,west richland,99353,4059,2018
benton,three rivers home link,446,3,10,0,10,10,22,393,8,244,202,83,03400,richland,99352,5165,2018
benton,white bluffs elementary,748,1,33,0,33,7,89,578,40,393,355,110,03400,richland,99352,5092,2018
benton,william wiley elementary,533,6,8,0,8,6,66,426,21,268,265,109,03400,west richland,99353,4543,2018
clark,ridgefield high,885,2,14,6,20,6,86,716,55,465,420,178,06122,ridgefield,98642,2390,2018
clark,south ridge elementary,809,6,11,4,15,2,113,627,46,406,403,202,06122,ridgefield,98642,3321,2018
clark,union ridge elementary,914,2,6,2,8,2,89,756,57,446,468,202,06122,ridgefield,98642,3786,2018
clark,view ridge middle,451,2,12,0,12,4,63,348,22,229,222,107,06122,ridgefield,98642,3891,2018
adams,lind ritzville middle,64,2,1,0,1,0,7,53,1,30,34,25,01160,lind,99341,5303,2018
adams,ritzville grade,167,1,3,0,3,2,20,140,1,98,69,82,01160,ritzville,99169,2719,2018
adams,ritzville high,134,4,1,0,1,1,10,114,4,62,72,40,01160,ritzville,99169,2132,2018
spokane,chattaroy elementary,222,1,3,1,4,1,12,195,9,107,115,128,32416,chattaroy,99003,2525,2018
spokane,independent scholar,79,3,0,0,0,2,3,71,0,38,41,42,32416,chattaroy,99003,1919,2018
spokane,riverside elementary,336,10,2,0,2,0,19,294,11,180,156,174,32416,chattaroy,99003,4033,2018
spokane,riverside high,470,12,3,1,4,4,26,420,4,258,212,188,32416,chattaroy,99003,4228,2018
spokane,riverside middle,315,8,2,1,3,2,13,278,11,174,141,158,32416,chattaroy,99003,3466,2018
king,carnation elementary,458,1,24,0,24,6,54,359,14,239,219,84,17407,carnation,98014,2485,2018
king,cedarcrest high,992,7,23,3,26,4,110,805,40,484,508,103,17407,duvall,98019,3524,2018
king,cherry valley elementary,518,2,20,0,20,4,77,388,27,261,257,71,17407,duvall,98019,3101,2018
king,choice,12,0,1,0,1,0,2,8,1,5,7,6,17407,carnation,98014,5244,2018
king,clip,30,0,0,0,0,0,1,24,5,15,15,12,17407,carnation,98014,1756,2018
king,eagle rock multiage,68,0,1,0,1,0,3,64,0,33,35,1,17407,duvall,98019,3006,2018
king,parade,123,0,1,0,1,0,6,110,6,56,67,11,17407,carnation,98014,1854,2018
king,stillwater elementary,473,0,5,0,5,1,65,375,27,239,234,63,17407,carnation,98014,4332,2018
king,tolt middle,745,3,27,3,30,4,110,564,34,358,387,96,17407,carnation,98014,4318,2018
thurston,grand mound elementary,526,15,2,3,5,2,123,341,40,263,263,264,34401,rochester,98579,3801,2018
thurston,h.e.a.r.t. high,38,1,0,0,0,0,11,22,4,22,16,16,34401,rochester,98579,1735,2018
thurston,rochester high,665,22,2,3,5,7,125,474,32,358,307,246,34401,rochester,98579,4326,2018
thurston,rochester middle,532,22,2,0,2,1,112,346,49,283,249,241,34401,rochester,98579,3067,2018
thurston,rochester primary,572,16,0,3,3,2,129,373,49,314,258,301,34401,rochester,98579,2527,2018
klickitat,roosevelt elementary,25,0,0,0,0,0,20,5,0,10,15,0,20403,roosevelt,99356,3530,2018
whitman,rosalia elementary & secondary,173,3,1,0,1,1,6,158,4,79,94,96,38320,rosalia,99170,3204,2018
grant,red rock elementary,572,0,0,0,0,0,462,109,1,283,289,459,13160,royal city,99357,3090,2018
grant,royal high,498,0,0,0,0,1,409,88,0,268,230,323,13160,royal city,99357,3516,2018
grant,royal intermediate,432,0,0,0,0,0,360,72,0,206,226,351,13160,royal city,99357,5388,2018
grant,royal middle,263,0,1,0,1,0,209,52,1,141,122,176,13160,royal city,99357,3620,2018
san juan,friday harbor elementary,316,4,3,0,3,1,58,238,12,153,163,127,28149,friday harbor,98250,2520,2018
san juan,friday harbor high,229,2,6,0,6,1,30,180,10,114,115,63,28149,friday harbor,98250,2879,2018
san juan,friday harbor middle,203,1,1,0,1,0,47,146,8,95,108,81,28149,friday harbor,98250,3011,2018
san juan,griffin bay,24,0,0,0,0,0,7,16,1,11,13,16,28149,friday harbor,98250,1963,2018
grays harbor,satsop elementary,66,0,0,0,0,0,11,51,4,28,38,27,14104,satsop,98583,2010,2018
king,adams elementary,553,3,10,1,11,21,46,408,64,291,262,66,17001,seattle,98107,2138,2018
king,aki kurose middle,685,1,232,13,245,260,112,24,43,378,307,505,17001,seattle,98118,3774,2018
king,alki elementary,373,2,14,0,14,22,34,255,46,198,175,57,17001,seattle,98116,2181,2018
king,arbor heights elementary,520,1,34,1,35,35,60,315,74,269,251,119,17001,seattle,98146,2730,2018
king,b f day elementary,283,0,13,1,14,34,14,175,46,156,127,66,17001,seattle,98103,3717,2018
king,bailey gatzert elementary,298,0,35,0,35,165,47,16,35,179,119,232,17001,seattle,98122,2307,2018
king,ballard high,1932,13,129,3,132,53,173,1444,117,990,942,176,17001,seattle,98117,2220,2018
king,beacon hill international,416,2,113,0,113,28,145,68,60,209,207,221,17001,seattle,98144,2070,2018
king,birth to 3 contracts,499,0,63,1,64,46,69,256,64,313,186,20,17001,seattle,98124,5048,2018
king,bridges transition,133,1,29,0,29,31,15,49,8,82,51,48,17001,seattle,98108,5406,2018
king,broadview-thomson k-8,544,2,65,0,65,121,123,175,58,293,251,299,17001,seattle,98133,2209,2018
king,bryant elementary,585,2,43,0,43,6,28,430,76,275,310,25,17001,seattle,98115,2372,2018
king,cascade parent partnership program,193,4,11,0,11,12,14,111,41,120,73,27,17001,seattle,98119,1751,2018
king,cascadia elementary,525,0,52,1,53,3,15,373,81,291,234,21,17001,seattle,98115,5292,2018
king,catharine blaine k-8,782,2,39,4,43,17,46,583,91,420,362,50,17001,seattle,98199,2838,2018
king,cedar park elementary,57,0,11,0,11,2,3,31,10,19,38,10,17001,seattle,98125,5487,2018
king,chief sealth international high,1064,17,181,12,193,231,301,253,69,563,501,630,17001,seattle,98126,3096,2018
king,cleveland high school stem,871,7,438,1,439,216,98,68,43,442,429,469,17001,seattle,98108,2392,2018
king,concord international,347,0,33,5,38,36,205,48,20,168,179,253,17001,seattle,98108,2199,2018
king,daniel bagley elementary,425,0,40,0,40,17,33,272,63,205,220,51,17001,seattle,98103,2450,2018
king,david t. denny international middle,834,18,134,12,146,191,250,174,55,456,378,581,17001,seattle,98126,2839,2018
king,dearborn park international,352,2,131,0,131,119,34,32,34,184,168,237,17001,seattle,98108,3803,2018
king,decatur elementary,242,0,45,0,45,1,11,135,50,123,119,4,17001,seattle,98115,5488,2018
king,dunlap elementary,291,0,72,5,77,127,53,8,26,156,135,219,17001,seattle,98118,2321,2018
king,eckstein middle,966,3,96,0,96,39,72,656,100,487,479,113,17001,seattle,98115,2729,2018
king,emerson elementary,305,1,55,1,56,131,65,20,32,154,151,193,17001,seattle,98118,2118,2018
king,fairmount park elementary,546,0,30,1,31,27,58,329,101,266,280,70,17001,seattle,98126,3518,2018
king,franklin high,1286,8,598,4,602,352,144,104,76,638,648,796,17001,seattle,98144,2182,2018
king,frantz coe elementary,560,2,26,0,26,13,47,402,70,295,265,41,17001,seattle,98119,2090,2018
king,garfield high,1857,10,305,7,312,426,144,797,168,908,949,495,17001,seattle,98122,2306,2018
king,gatewood elementary,376,1,7,2,9,29,41,238,58,193,183,73,17001,seattle,98136,2139,2018
king,genesee hill elementary,718,2,19,0,19,14,36,542,105,383,335,63,17001,seattle,98116,3429,2018
king,graham hill elementary,358,0,67,5,72,108,64,68,46,189,169,210,17001,seattle,98118,3378,2018
king,green lake elementary,437,2,36,0,36,9,26,308,56,202,235,46,17001,seattle,98103,2061,2018
king,greenwood elementary,361,1,16,3,19,24,39,239,39,176,185,55,17001,seattle,98117,2123,2018
king,hamilton international middle,986,3,81,1,82,30,82,697,92,540,446,89,17001,seattle,98103,2371,2018
king,hawthorne elementary school - seattle,407,2,57,1,58,111,77,112,47,208,199,219,17001,seattle,98118,4248,2018
king,hazel wolf k-8,736,5,44,5,49,69,67,468,78,360,376,142,17001,seattle,98125,5175,2018
king,highland park elementary,319,5,56,8,64,48,101,55,46,167,152,234,17001,seattle,98106,2269,2018
king,ingraham high,1388,11,166,2,168,136,189,758,126,714,674,336,17001,seattle,98133,3276,2018
king,interagency open doors,73,3,6,1,7,21,10,23,9,33,40,75,17001,seattle,98118,5405,2018
king,interagency programs,349,10,22,6,28,148,83,50,30,185,164,310,17001,seattle,98124,1635,2018
king,jane addams middle,915,3,133,0,133,72,99,517,91,477,438,216,17001,seattle,98125,5351,2018
king,john hay elementary,491,2,76,0,76,16,42,283,72,243,248,55,17001,seattle,98109,2063,2018
king,john muir elementary,357,1,33,6,39,181,32,66,38,173,184,235,17001,seattle,98144,2143,2018
king,john rogers elementary,349,4,32,3,35,57,47,148,58,197,152,129,17001,seattle,98125,2975,2018
king,john stanford international,452,0,71,0,71,3,82,203,93,210,242,31,17001,seattle,98105,2081,2018
king,kimball elementary,445,0,123,1,124,85,61,120,55,216,229,219,17001,seattle,98144,3478,2018
king,lafayette elementary,406,3,28,0,28,24,30,272,49,212,194,61,17001,seattle,98116,2733,2018
king,laurelhurst elementary,354,0,48,1,49,16,21,227,41,184,170,83,17001,seattle,98105,2437,2018
king,lawton elementary,453,3,22,0,22,13,27,326,62,245,208,30,17001,seattle,98199,2183,2018
king,leschi elementary,402,3,12,4,16,172,33,133,45,200,202,169,17001,seattle,98122,2121,2018
king,licton springs k-8,164,20,11,1,12,14,22,65,31,87,77,81,17001,seattle,98115,3874,2018
king,louisa boren stem k-8,545,1,45,0,45,76,69,279,75,310,235,135,17001,seattle,98106,5276,2018
king,lowell elementary,370,1,76,9,85,100,45,86,53,190,180,232,17001,seattle,98102,3714,2018
king,loyal heights elementary,398,0,10,0,10,11,30,306,41,187,211,34,17001,seattle,98115,2462,2018
king,madison middle,882,9,61,2,63,90,75,552,93,466,416,173,17001,seattle,98116,2435,2018
king,madrona k-5,237,0,5,0,5,93,22,78,39,124,113,119,17001,seattle,98122,2069,2018
king,maple elementary,532,2,270,3,273,38,88,77,54,287,245,315,17001,seattle,98108,2353,2018
king,martin luther king jr. elementary,277,0,81,6,87,127,35,6,22,143,134,202,17001,seattle,98118,2089,2018
king,mcclure middle,540,1,49,2,51,21,53,360,54,263,277,69,17001,seattle,98119,3517,2018
king,mcdonald international,464,0,20,0,20,2,61,292,89,233,231,14,17001,seattle,98105,5203,2018
king,mcgilvra elementary,242,0,20,0,20,12,9,165,36,112,130,21,17001,seattle,98112,2201,2018
king,meany middle,491,1,56,3,59,159,49,182,41,264,227,212,17001,seattle,98112,5485,2018
king,mercer international middle,1136,2,452,2,454,231,213,150,86,575,561,677,17001,seattle,98108,3095,2018
king,middle college high,64,2,5,0,5,12,6,32,7,24,40,22,17001,seattle,98125,1547,2018
king,montlake elementary,269,0,19,0,19,12,12,183,43,139,130,16,17001,seattle,98112,2322,2018
king,nathan hale high,1228,19,142,6,148,198,129,641,93,648,580,363,17001,seattle,98125,3479,2018
king,north beach elementary,338,0,14,2,16,5,21,248,48,174,164,20,17001,seattle,98117,3218,2018
king,northgate elementary,255,0,16,2,18,58,105,45,29,122,133,185,17001,seattle,98125,3027,2018
king,nova high,312,1,10,0,10,11,26,229,35,132,180,72,17001,seattle,98122,3868,2018
king,olympic hills elementary,373,1,45,4,49,84,101,97,41,173,200,271,17001,seattle,98125,2976,2018
king,olympic view elementary,448,2,58,0,58,51,49,232,56,232,216,154,17001,seattle,98115,2256,2018
king,orca k-8,391,2,24,0,24,81,27,211,46,203,188,113,17001,seattle,98118,4065,2018
king,pathfinder k-8,487,0,16,0,16,19,48,328,76,244,243,65,17001,seattle,98106,1620,2018
king,private school services,174,0,14,0,14,16,23,97,24,120,54,25,17001,seattle,98124,5046,2018
king,queen anne elementary,352,0,19,0,19,7,22,255,49,176,176,29,17001,seattle,98109,5204,2018
king,rainier beach high,747,3,193,17,210,365,104,24,41,406,341,518,17001,seattle,98118,3327,2018
king,rainier view elementary,240,1,78,3,81,94,30,7,27,128,112,181,17001,seattle,98178,3380,2018
king,residential consortium,27,1,0,1,1,7,2,8,8,19,8,11,17001,seattle,98119,4263,2018
king,robert eagle staff middle,715,2,49,4,53,65,98,424,73,378,337,172,17001,seattle,98103,5486,2018
king,roosevelt high,1868,4,214,1,215,75,144,1284,146,907,961,169,17001,seattle,98115,2285,2018
king,roxhill elementary,271,1,32,3,35,79,92,40,24,147,124,197,17001,seattle,98126,3157,2018
king,sacajawea elementary,254,0,25,0,25,23,38,138,30,132,122,64,17001,seattle,98115,3028,2018
king,salmon bay k-8,656,2,33,1,34,11,37,507,65,340,316,44,17001,seattle,98117,1796,2018
king,sand point elementary,213,2,26,2,28,26,33,77,47,118,95,93,17001,seattle,98115,5205,2018
king,sanislo elementary,236,1,40,8,48,54,53,48,32,124,112,159,17001,seattle,98106,3665,2018
king,seattle world,276,0,72,1,73,69,122,10,2,170,106,291,17001,seattle,98122,1596,2018
king,south lake high,61,1,4,7,11,24,16,0,9,29,32,74,17001,seattle,98118,3778,2018
king,south shore pk-8,525,8,120,2,122,244,49,43,59,283,242,339,17001,seattle,98118,4218,2018
king,stevens elementary,287,2,12,2,14,59,28,145,39,139,148,95,17001,seattle,98112,2080,2018
king,the center,242,1,12,0,12,8,27,175,19,86,156,24,17001,seattle,98109,1856,2018
king,thornton creek elementary,533,2,24,1,25,8,30,393,75,278,255,33,17001,seattle,98115,3974,2018
king,thurgood marshall elementary,569,2,98,4,102,125,34,223,83,324,245,187,17001,seattle,98144,2141,2018
king,tops k-8,471,1,89,0,89,55,26,227,73,227,244,116,17001,seattle,98102,1579,2018
king,van asselt elementary,421,1,148,3,151,171,48,14,36,204,217,347,17001,seattle,98108,2120,2018
king,view ridge elementary,550,4,80,0,80,14,34,332,86,274,276,39,17001,seattle,98115,2667,2018
king,viewlands elementary,414,5,40,3,43,47,73,201,45,210,204,148,17001,seattle,98177,2977,2018
king,washington middle,712,6,135,3,138,179,44,275,70,364,348,255,17001,seattle,98144,4064,2018
king,wedgwood elementary,485,0,54,0,54,11,46,286,88,241,244,42,17001,seattle,98115,3026,2018
king,west seattle elementary,441,2,20,2,22,315,41,40,21,217,224,359,17001,seattle,98126,2645,2018
king,west seattle high,1047,6,130,5,135,100,137,574,95,506,541,201,17001,seattle,98116,2234,2018
king,west woodland elementary,566,0,35,0,35,13,36,406,76,274,292,30,17001,seattle,98107,2142,2018
king,whitman middle,566,4,32,2,34,32,49,402,45,310,256,96,17001,seattle,98117,3277,2018
king,whittier elementary,495,0,18,0,18,8,26,389,54,254,241,42,17001,seattle,98117,2092,2018
king,wing luke elementary,337,0,105,6,111,162,18,16,30,172,165,252,17001,seattle,98118,3581,2018
skagit,big lake elementary,334,1,15,0,15,5,26,274,13,156,178,55,29101,mount vernon,98274,2521,2018
skagit,cascade middle,644,13,8,1,9,4,148,449,21,320,324,328,29101,sedro-woolley,98284,3181,2018
skagit,central elementary,458,3,3,0,3,4,113,308,27,244,214,279,29101,sedro-woolley,98284,2380,2018
skagit,clear lake elementary,304,4,2,0,2,0,38,249,11,136,168,141,29101,clear lake,98235,3403,2018
skagit,evergreen elementary,568,32,6,4,10,7,164,328,27,293,275,338,29101,sedro-woolley,98284,3942,2018
skagit,good beginnings center,59,0,0,0,0,0,24,33,2,42,17,59,29101,sedro-woolley,98273,5058,2018
skagit,lyman elementary,176,5,0,0,0,1,21,139,10,87,89,78,29101,lyman,98263,2620,2018
skagit,mary purcell elementary,416,5,0,1,1,0,117,280,13,206,210,261,29101,sedro-woolley,98284,2774,2018
skagit,samish elementary,171,3,0,0,0,0,16,148,4,80,91,79,29101,sedro-woolley,98284,3402,2018
skagit,sedro woolley senior high,1164,27,12,4,16,5,220,860,36,604,560,446,29101,sedro-woolley,98284,2150,2018
skagit,state street high,179,5,0,2,2,5,33,130,4,102,77,137,29101,sedro-woolley,98284,1537,2018
yakima,john campbell primary,835,2,1,2,3,3,229,575,23,457,378,412,39119,selah,98942,5383,2018
yakima,robert lince early learning center,35,0,1,0,1,0,15,19,0,26,9,23,39119,selah,98942,5232,2018
yakima,selah academy,83,1,0,0,0,1,14,67,0,36,47,46,39119,selah,98942,4272,2018
yakima,selah high,1108,8,8,1,9,8,298,758,27,581,527,420,39119,selah,98942,2388,2018
yakima,selah homelink,25,0,0,0,0,0,2,23,0,14,11,4,39119,selah,98942,5231,2018
yakima,selah intermediate,830,7,4,0,4,3,267,522,27,421,409,428,39119,selah,98942,5384,2018
yakima,selah middle,826,4,4,1,5,3,257,533,24,403,423,421,39119,selah,98942,5385,2018
pend oreille,selkirk elementary,128,1,0,0,0,0,4,115,8,60,68,64,26070,metaline falls,99153,5075,2018
pend oreille,selkirk high,78,1,3,0,3,0,5,66,3,33,45,23,26070,ione,99139,5226,2018
pend oreille,selkirk middle,49,0,0,0,0,0,5,44,0,32,17,24,26070,ione,99139,5225,2018
clallam,greywolf elementary,584,3,3,2,5,1,52,477,46,305,279,249,05323,sequim,98382,4378,2018
clallam,helen haller elementary,617,7,7,0,7,4,102,455,42,321,296,334,05323,sequim,98382,2722,2018
clallam,sequim community,140,2,0,0,0,0,16,110,12,80,60,57,05323,sequim,98382,1708,2018
clallam,sequim middle,630,7,5,2,7,2,84,476,54,326,304,255,05323,sequim,98382,4519,2018
clallam,sequim senior high,888,26,21,1,22,5,92,674,69,447,441,272,05323,sequim,98382,2471,2018
san juan,shaw island elementary,11,0,0,0,0,1,0,10,0,5,6,0,28010,shaw island,98286,3725,2018
mason,bordeaux elementary,570,33,1,1,2,1,99,382,53,299,271,361,23309,shelton,98584,3291,2018
mason,evergreen elementary,593,5,0,2,2,10,422,140,14,295,298,529,23309,shelton,98584,2745,2018
mason,mountain view elementary,683,12,3,2,5,2,156,442,66,349,334,478,23309,shelton,98584,3292,2018
mason,oakland bay junior high,698,26,7,0,7,3,208,397,57,369,329,447,23309,shelton,98584,4363,2018
mason,olympic middle,597,15,3,1,4,2,208,321,47,304,293,403,23309,shelton,98584,4586,2018
mason,shelton high,1038,42,8,6,14,9,239,641,93,582,456,518,23309,shelton,98584,3241,2018
king,albert einstein middle,736,3,122,6,128,51,89,400,65,384,352,176,17412,shoreline,98177,3674,2018
king,briarcrest elementary,501,0,54,1,55,51,96,240,59,254,247,169,17412,shoreline,98155,2990,2018
king,brookside elementary,509,1,38,2,40,15,51,322,80,256,253,85,17412,lake forest park,98155,3230,2018
king,cascade k-8 community,224,2,15,0,15,5,35,147,20,115,109,56,17412,shoreline,98155,1942,2018
king,early childhood education,49,0,8,0,8,5,6,26,4,37,12,18,17412,shoreline,98155,5287,2018
king,echo lake elementary,474,1,85,5,90,29,75,211,68,262,212,169,17412,shoreline,98133,3104,2018
king,handicapped contractual services,139,2,9,0,9,10,19,88,11,86,53,26,17412,shoreline,98155,1667,2018
king,highland terrace elementary,496,2,51,4,55,17,40,320,62,240,256,67,17412,shoreline,98133,3231,2018
king,home education exchange,132,0,5,0,5,2,8,106,11,71,61,10,17412,shoreline,98155,1771,2018
king,kellogg middle,652,2,80,2,82,58,92,324,94,336,316,182,17412,shoreline,98155,3387,2018
king,lake forest park elementary,566,1,62,4,66,39,48,347,65,263,303,141,17412,lake forest park,98155,2185,2018
king,melvin g syre elementary,540,0,39,1,40,15,57,350,78,298,242,74,17412,shoreline,98177,3527,2018
king,meridian park elementary,744,1,139,1,140,64,98,348,93,366,378,212,17412,shoreline,98133,3958,2018
king,parkwood elementary,464,3,56,17,73,48,92,203,45,253,211,167,17412,shoreline,98133,3489,2018
king,ridgecrest elementary,539,0,66,3,69,36,72,273,89,290,249,141,17412,shoreline,98155,2703,2018
king,shorecrest high,1450,3,207,7,214,126,160,766,181,737,713,366,17412,shoreline,98155,3343,2018
king,shorewood high,1615,9,266,9,275,135,213,801,182,849,766,410,17412,shoreline,98133,3921,2018
skamania,skamania elementary,87,0,0,0,0,0,5,76,6,36,51,49,30002,skamania,98648,3405,2018
king,skykomish elementary,37,0,0,0,0,0,4,33,0,19,18,32,17404,skykomish,98288,2512,2018
king,skykomish high,14,1,0,0,0,0,1,12,0,8,6,10,17404,skykomish,98288,2513,2018
snohomish,aim high,140,1,0,0,0,2,17,115,5,75,65,37,31201,snohomish,98290,4265,2018
snohomish,cascade view elementary,417,2,5,3,8,2,57,329,19,223,194,97,31201,snohomish,98290,4366,2018
snohomish,cathcart elementary,403,4,5,0,5,8,73,296,17,193,210,86,31201,snohomish,98296,3305,2018
snohomish,centennial middle,790,2,17,1,18,2,97,628,43,392,398,171,31201,snohomish,98290,4395,2018
snohomish,central elementary,245,0,2,1,3,3,45,181,13,120,125,108,31201,snohomish,98290,2446,2018
snohomish,dutch hill elementary,569,6,8,2,10,0,37,484,32,289,280,76,31201,snohomish,98290,4241,2018
snohomish,emerson elementary,316,1,1,0,1,1,74,212,27,174,142,131,31201,snohomish,98290,3005,2018
snohomish,glacier peak high,1794,7,131,1,132,23,178,1336,118,893,901,162,31201,snohomish,98296,5128,2018
snohomish,high school re entry,13,1,0,0,0,0,1,9,2,10,3,6,31201,snohomish,98290,3981,2018
snohomish,little cedars elementary,708,8,69,3,72,9,70,504,45,359,349,67,31201,snohomish,98290,5100,2018
snohomish,machias elementary,513,4,9,0,9,4,31,436,29,278,235,111,31201,snohomish,98290,2073,2018
snohomish,parent partnership,93,1,0,0,0,4,7,80,1,49,44,8,31201,snohomish,98290,1904,2018
snohomish,riverview elementary,562,2,16,0,16,4,78,423,39,285,277,119,31201,snohomish,98290,3561,2018
snohomish,seattle hill elementary,659,1,50,0,50,5,73,447,83,318,341,112,31201,everett,98208,4184,2018
snohomish,snohomish center,36,0,1,0,1,0,3,30,2,25,11,5,31201,snohomish,98290,1730,2018
snohomish,snohomish high,1669,14,35,2,37,13,177,1365,63,863,806,287,31201,snohomish,98290,2428,2018
snohomish,totem falls,437,2,41,1,42,9,20,355,9,233,204,40,31201,snohomish,98296,4383,2018
snohomish,valley view middle,735,3,53,4,57,8,78,547,42,391,344,90,31201,snohomish,98296,4145,2018
king,cascade view elementary,591,1,48,1,49,1,38,450,52,311,280,15,17410,snoqualmie,98065,5015,2018
king,chief kanim middle,795,3,78,2,80,9,54,605,44,404,391,71,17410,fall city,98024,4397,2018
king,edwin r opstad elementary,552,4,10,1,11,7,52,453,25,311,241,82,17410,north bend,98045,4308,2018
king,fall city elementary,562,2,34,0,34,1,41,453,31,295,267,48,17410,fall city,98024,2222,2018
king,mount si high,1853,15,78,8,86,10,134,1542,66,1006,847,135,17410,snoqualmie,98065,2850,2018
king,north bend elementary,494,2,11,1,12,1,62,390,27,243,251,78,17410,north bend,98045,2287,2018
king,snoqualmie access,83,0,3,0,3,1,7,70,2,55,28,13,17410,snoqualmie,98065,5181,2018
king,snoqualmie elementary,556,2,43,0,43,10,47,408,46,307,249,78,17410,snoqualmie,98065,2288,2018
king,snoqualmie parent partnership program,73,0,0,0,0,0,8,60,5,43,30,1,17410,north bend,98045,5296,2018
king,svsd open doors,15,0,0,0,0,1,1,13,0,6,9,7,17410,snoqualmie,98065,5374,2018
king,timber ridge elementary,656,0,98,0,98,3,45,440,70,335,321,13,17410,snoqualmie,98065,5457,2018
king,twin falls middle,820,2,26,1,27,3,61,687,40,412,408,68,17410,north bend,98045,5135,2018
king,two rivers,111,2,2,0,2,0,9,93,5,64,47,30,17410,north bend,98045,1502,2018
grant,smokiam alternative high,19,0,0,0,0,0,9,10,0,8,11,12,13156,soap lake,98851,1518,2018
grant,soap lake elementary,211,1,2,0,2,1,84,121,2,115,96,194,13156,soap lake,98851,2694,2018
grant,soap lake middle & high,280,1,2,0,2,6,84,183,4,153,127,228,13156,soap lake,98851,3089,2018
pierce,soar academy public charter,180,3,1,4,5,56,31,35,50,87,93,99,27909,tacoma,98404,5379,2018
pacific,chauncey davis elementary,286,7,9,1,10,2,131,112,24,148,138,226,25118,south bend,98586,2804,2018
pacific,pacific virtual learning,53,0,1,0,1,0,12,37,3,21,32,10,25118,south bend,98586,5243,2018
pacific,south bend high,269,6,6,1,7,2,98,122,34,128,141,141,25118,south bend,98586,2214,2018
kitsap,burley glenwood elementary,476,5,5,5,10,3,49,364,45,236,240,176,18402,port orchard,98367,4029,2018
kitsap,cedar heights middle,802,10,39,14,53,14,96,554,75,412,390,301,18402,port orchard,98366,3680,2018
kitsap,discovery,203,3,1,2,3,6,20,147,24,102,101,99,18402,port orchard,98366,3899,2018
kitsap,east port orchard elementary,414,5,8,15,23,8,53,272,53,218,196,231,18402,port orchard,98366,2641,2018
kitsap,explorer academy,155,3,2,8,10,1,17,112,12,82,73,81,18402,port orchard,98366,1718,2018
kitsap,hidden creek elementary,451,5,12,2,14,6,61,310,55,230,221,169,18402,port orchard,98367,4348,2018
kitsap,john sedgwick middle,703,8,16,5,21,3,63,531,77,331,372,185,18402,port orchard,98366,4142,2018
kitsap,madrona heights preschool program,101,0,3,0,3,1,11,73,13,76,25,38,18402,port orchard,98366,5072,2018
kitsap,manchester elementary,332,0,3,6,9,5,32,250,36,175,157,130,18402,port orchard,98366,4079,2018
kitsap,marcus whitman middle,664,6,19,14,33,13,79,436,97,351,313,273,18402,port orchard,98366,3046,2018
kitsap,mullenix ridge elementary,420,3,2,1,3,1,40,313,60,232,188,90,18402,port orchard,98367,4350,2018
kitsap,olalla elementary,314,6,1,7,8,2,41,219,38,174,140,129,18402,port orchard,98359,2995,2018
kitsap,orchard heights elementary,680,3,9,4,13,8,81,480,95,364,316,281,18402,port orchard,98366,2650,2018
kitsap,sidney glen elementary,584,5,18,9,27,14,75,373,90,288,296,273,18402,port orchard,98366,4349,2018
kitsap,south colby elementary,335,3,8,4,12,2,27,250,41,157,178,79,18402,port orchard,98366,3110,2018
kitsap,south kitsap high,2787,33,114,53,167,33,329,1932,293,1422,1365,759,18402,port orchard,98366,2272,2018
kitsap,sunnyslope elementary,516,1,28,6,34,10,93,307,71,264,252,149,18402,port orchard,98367,4141,2018
island,south whidbey academy,79,1,0,0,0,0,7,67,4,39,40,23,15206,langley,98260,1682,2018
island,south whidbey elementary,644,7,5,2,7,4,47,548,31,318,326,202,15206,langley,98260,4321,2018
island,south whidbey high,447,4,15,0,15,10,19,385,14,229,218,62,15206,langley,98260,4149,2018
island,south whidbey middle,224,0,10,1,11,1,18,183,11,107,117,61,15206,langley,98260,2511,2018
island,south whidbey special services,9,0,0,0,0,0,1,8,0,8,1,3,15206,langley,98260,1683,2018
mason,southside elementary,215,11,3,0,3,0,21,157,23,101,114,82,23042,shelton,98584,2744,2018
spokane,spokane international academy elementary,406,2,7,0,7,8,44,283,62,176,230,148,32901,spokane,99217,5381,2018
spokane,adams elementary,363,3,8,5,13,9,48,227,63,174,189,262,32081,spokane,99223,2156,2018
spokane,alternative northeast community center preschool,18,0,1,2,3,0,3,9,3,11,7,24,32081,spokane,99207,1566,2018
spokane,arlington elementary,654,12,27,22,49,22,84,406,81,340,314,498,32081,spokane,99217,2381,2018
spokane,audubon elementary,405,8,9,3,12,8,51,279,47,211,194,356,32081,spokane,99205,2128,2018
spokane,balboa elementary,357,0,3,1,4,1,29,287,36,196,161,166,32081,spokane,99208,3357,2018
spokane,bemiss elementary,531,15,0,11,11,27,96,288,94,271,260,459,32081,spokane,99207,2155,2018
spokane,browne elementary,424,3,1,3,4,7,42,309,59,222,202,262,32081,spokane,99205,2218,2018
spokane,bryant center,1045,16,15,2,17,19,101,835,57,513,532,208,32081,spokane,99201,3008,2018
spokane,chase middle,679,5,21,4,25,14,90,452,93,345,334,363,32081,spokane,99223,4457,2018
spokane,cooper elementary,520,5,20,23,43,23,56,313,80,279,241,396,32081,spokane,99217,2129,2018
spokane,daybreak alternative,4,1,0,0,0,0,1,2,0,0,4,3,32081,spokane,99202,1603,2018
spokane,eagle peak at pratt,79,0,0,2,2,3,17,40,17,64,15,105,32081,spokane valley,99212,1567,2018
spokane,ferris high,1803,11,85,8,93,64,156,1311,168,988,815,674,32081,spokane,99223,3412,2018
spokane,finch elementary,536,4,1,0,1,7,52,416,56,279,257,291,32081,spokane,99205,2312,2018
spokane,franklin elementary,429,3,20,0,20,13,31,297,65,223,206,205,32081,spokane,99223,2127,2018
spokane,garfield elementary,446,6,8,7,15,19,60,276,70,226,220,301,32081,spokane,99205,3727,2018
spokane,garry middle,577,12,19,21,40,26,60,331,108,307,270,441,32081,spokane,99207,3758,2018
spokane,glover middle,489,8,7,8,15,17,48,327,74,267,222,391,32081,spokane,99205,3258,2018
spokane,grant elementary,371,5,13,7,20,52,49,161,84,201,170,294,32081,spokane,99202,3729,2018
spokane,hamblen elementary,518,1,6,4,10,6,54,379,68,291,227,192,32081,spokane,99203,3007,2018
spokane,holmes elementary,423,9,5,10,15,25,79,212,83,222,201,369,32081,spokane,99201,2056,2018
spokane,hutton elementary,594,2,8,0,8,17,31,490,46,283,311,106,32081,spokane,99203,2258,2018
spokane,indian trail elementary,333,3,3,1,4,3,30,253,40,179,154,132,32081,spokane,99208,3506,2018
spokane,jefferson elementary,516,3,4,1,5,10,52,398,48,278,238,198,32081,spokane,99203,2111,2018
spokane,lewis & clark high,1876,20,96,37,133,74,156,1308,185,897,979,545,32081,spokane,99204,2172,2018
spokane,libby center,358,0,34,0,34,0,35,246,43,180,178,79,32081,spokane,99202,2401,2018
spokane,lidgerwood elementary,414,7,18,20,38,13,64,219,73,210,204,376,32081,spokane,99208,2952,2018
spokane,lincoln heights elementary,519,15,14,0,14,15,54,359,62,276,243,291,32081,spokane,99223,2951,2018
spokane,linwood elementary,519,2,2,10,12,11,69,315,110,242,277,357,32081,spokane,99208,3190,2018
spokane,logan elementary,399,8,7,14,21,14,68,218,70,209,190,370,32081,spokane,99207,3719,2018
spokane,longfellow elementary,504,6,14,2,16,18,49,320,95,263,241,413,32081,spokane,99207,3718,2018
spokane,madison elementary,358,0,14,1,15,0,44,250,49,177,181,255,32081,spokane,99205,2708,2018
spokane,moran prairie elementary,549,1,23,2,25,14,22,452,35,290,259,115,32081,spokane,99223,4389,2018
spokane,mullan road elementary,679,0,13,3,16,26,51,514,72,344,335,213,32081,spokane,99223,4035,2018
spokane,north central high,1502,26,34,19,53,53,155,1021,194,783,719,724,32081,spokane,99205,2106,2018
spokane,on track academy,298,8,1,3,4,5,25,215,41,142,156,303,32081,spokane,99207,5250,2018
spokane,open doors youth re-engagement spokane,75,0,0,1,1,1,8,54,11,27,48,32,32081,spokane,99201,5344,2018
spokane,regal elementary,491,12,12,12,24,23,50,303,79,268,223,432,32081,spokane,99207,2096,2018
spokane,ridgeview elementary,331,4,3,0,3,6,33,227,58,173,158,239,32081,spokane,99205,2950,2018
spokane,rogers high,1569,38,81,72,153,74,210,858,236,814,755,1120,32081,spokane,99207,2479,2018
spokane,roosevelt elementary,514,2,15,6,21,31,51,333,76,263,251,315,32081,spokane,99204,2086,2018
spokane,sacajawea middle,786,3,23,6,29,33,65,568,88,391,395,277,32081,spokane,99203,3356,2018
spokane,sacred heart hospital,1,0,0,0,0,0,0,1,0,1,0,1,32081,spokane,99204,4286,2018
spokane,salk middle,701,7,8,7,15,5,61,517,96,357,344,341,32081,spokane,99208,3413,2018
spokane,sccp images,51,0,1,0,1,1,6,37,6,29,22,27,32081,spokane,99217,1698,2018
spokane,shadle park high,1341,12,14,11,25,28,112,1013,151,726,615,599,32081,spokane,99205,3189,2018
spokane,shaw middle,573,13,21,45,66,27,66,310,91,298,275,502,32081,spokane,99207,3257,2018
spokane,sheridan elementary,480,12,41,3,44,28,56,276,64,260,220,417,32081,spokane,99202,2110,2018
spokane,spokane public montessori,483,5,4,0,4,6,33,375,60,230,253,141,32081,spokane,99205,5361,2018
spokane,spokane regional health district,239,3,1,2,3,3,9,221,0,134,105,0,32081,spokane,99201,5113,2018
spokane,stevens elementary,452,9,10,44,54,31,57,219,82,211,241,415,32081,spokane,99202,2108,2018
spokane,the community,165,1,0,0,0,2,10,137,15,66,99,73,32081,spokane,99205,5301,2018
spokane,westview elementary,501,1,2,5,7,7,43,360,83,262,239,343,32081,spokane,99205,3063,2018
spokane,whitman elementary,562,3,6,23,29,22,92,328,88,287,275,496,32081,spokane,99207,2191,2018
spokane,willard elementary,528,11,1,2,3,32,54,353,75,267,261,422,32081,spokane,99205,2109,2018
spokane,wilson elementary,366,2,5,0,5,3,24,288,44,187,179,68,32081,spokane,99203,2296,2018
spokane,woodridge elementary,464,10,5,3,8,6,31,373,36,231,233,135,32081,spokane,99208,4192,2018
lincoln,sprague elementary,46,0,0,0,0,0,5,41,0,23,23,26,22008,sprague,99032,3050,2018
lincoln,sprague high,28,0,0,0,0,0,3,23,2,12,16,15,22008,sprague,99032,2186,2018
whitman,st john elementary,68,0,0,0,0,1,10,54,3,32,36,23,38322,saint john,99171,3069,2018
whitman,st john/endicott high,81,0,1,0,1,3,0,75,2,43,38,26,38322,saint john,99171,3068,2018
snohomish,cedarhome elementary,524,5,4,2,6,3,46,432,32,269,255,115,31401,stanwood,98292,4513,2018
snohomish,elger bay elementary,324,4,0,3,3,2,32,261,22,166,158,105,31401,camano island,98282,4553,2018
snohomish,lincoln academy,18,0,3,0,3,0,0,12,3,11,7,9,31401,stanwood,98292,5108,2018
snohomish,lincoln hill high,144,2,0,0,0,0,18,114,10,80,64,62,31401,stanwood,98292,1707,2018
snohomish,port susan middle,486,0,8,2,10,4,47,401,24,249,237,121,31401,stanwood,98292,4512,2018
snohomish,saratoga,179,0,1,0,1,3,15,144,16,84,95,18,31401,stanwood,98292,5004,2018
snohomish,stanwood elementary,455,4,9,1,10,2,44,365,30,244,211,163,31401,stanwood,98292,3125,2018
snohomish,stanwood high,1359,16,19,3,22,12,118,1114,77,679,680,265,31401,stanwood,98292,2581,2018
snohomish,stanwood middle,473,5,4,2,6,3,61,370,28,239,234,121,31401,stanwood,98292,2400,2018
snohomish,twin city elementary,346,4,9,3,12,2,64,243,21,199,147,150,31401,stanwood,98292,4364,2018
snohomish,utsalady elementary,315,1,4,2,6,2,24,277,5,160,155,67,31401,camano island,98282,4551,2018
franklin,star elem,10,0,0,0,0,0,5,5,0,5,5,0,11054,richland,99352,2007,2018
columbia,starbuck,23,0,0,0,0,0,2,21,0,11,12,0,07035,starbuck,99359,2135,2018
chelan,stehekin elementary,6,0,0,0,0,0,0,6,0,3,3,0,04069,stehekin,98852,2265,2018
pierce,anderson island elementary,34,0,0,0,0,1,9,22,2,20,14,14,27001,steilacoom,98388,2040,2018
pierce,birth to three,30,0,1,0,1,3,5,15,6,15,15,5,27001,steilacoom,98388,5389,2018
pierce,cherrydale elementary,380,2,13,7,20,16,69,182,91,194,186,139,27001,steilacoom,98388,3446,2018
pierce,chloe clark elementary,563,1,39,3,42,39,120,281,80,294,269,65,27001,dupont,98327,4562,2018
pierce,pioneer middle,761,4,60,10,70,68,123,385,111,371,390,161,27001,dupont,98327,2237,2018
pierce,saltars point elementary,482,3,36,5,41,40,75,236,87,263,219,89,27001,steilacoom,98388,3827,2018
pierce,steilacoom high,1040,8,98,22,120,72,151,525,164,533,507,182,27001,steilacoom,98388,4131,2018
whitman,steptoe elementary,43,2,0,0,0,0,0,41,0,18,25,0,38304,steptoe,99174,2115,2018
skamania,carson elementary,266,3,1,0,1,0,37,209,16,135,131,130,30303,stevenson,98648,2882,2018
skamania,preschool,18,0,0,0,0,0,3,12,3,13,5,9,30303,stevenson,98648,1765,2018
skamania,stevenson elementary,205,3,0,1,1,0,20,169,12,102,103,91,30303,stevenson,98648,2682,2018
skamania,stevenson high,311,6,3,0,3,3,43,235,21,167,144,122,30303,stevenson,98648,3119,2018
skamania,wind river middle,115,3,0,0,0,1,26,83,2,59,56,56,30303,stevenson,98648,3800,2018
snohomish,gold bar elementary,342,0,0,0,0,5,76,258,3,181,161,219,31311,gold bar,98251,4399,2018
snohomish,open doors youth reengagement sultan,3,0,0,0,0,0,2,1,0,2,1,3,31311,sultan,98296,5329,2018
snohomish,sky valley options,10,0,0,0,0,0,2,8,0,5,5,6,31311,sultan,98294,5114,2018
snohomish,student services,40,0,0,0,0,0,8,30,2,24,16,14,31311,sultan,98294,1670,2018
snohomish,sultan elementary,558,1,16,2,18,10,105,389,35,286,272,309,31311,sultan,98294,2229,2018
snohomish,sultan middle,451,1,5,0,5,4,95,331,15,243,208,255,31311,sultan,98294,2105,2018
snohomish,sultan senior high,551,9,9,0,9,7,103,408,15,297,254,259,31311,sultan,98294,4274,2018
pierce,summit public school: olympus,167,3,6,4,10,32,49,51,22,82,85,107,27905,seattle,98134,5376,2018
king,summit public school: sierra,297,5,31,0,31,121,26,78,36,163,134,123,17902,seattle,98134,5375,2018
stevens,summit valley,77,0,0,0,0,0,6,65,6,43,34,65,33202,addy,99101,4394,2018
pierce,bonney lake elementary,552,2,9,1,10,7,63,409,61,277,275,173,27320,bonney lake,98390,3349,2018
pierce,bonney lake high,1388,15,27,13,40,18,155,1043,117,687,701,330,27320,bonney lake,98391,4585,2018
pierce,crestwood elementary,475,3,11,3,14,5,38,365,50,256,219,120,27320,bonney lake,98390,4435,2018
pierce,daffodil valley elementary,512,3,13,1,14,0,158,300,37,240,272,318,27320,sumner,98390,4541,2018
pierce,eismann elementary,724,1,24,3,27,6,68,539,83,367,357,59,27320,bonney lake,98391,3399,2018
pierce,emerald hills elementary,488,3,11,0,11,5,50,359,60,256,232,123,27320,bonney lake,98390,4250,2018
pierce,lakeridge middle,634,6,12,0,12,5,66,483,62,338,296,142,27320,bonney lake,98391,4132,2018
pierce,liberty ridge elementary,411,3,2,1,3,9,56,303,37,202,209,198,27320,sumner,98390,4402,2018
pierce,maple lawn elementary,638,3,9,7,16,10,115,422,72,327,311,210,27320,sumner,98390,2875,2018
pierce,mountain view middle,707,9,10,2,12,12,86,529,59,364,343,194,27320,bonney lake,98390,4502,2018
pierce,sumner high,1834,10,41,5,46,11,248,1383,136,936,898,384,27320,sumner,98390,3247,2018
pierce,sumner middle,771,9,20,2,22,10,181,490,59,402,369,305,27320,sumner,98390,3499,2018
pierce,sumner special services,36,0,0,0,0,3,6,21,6,26,10,14,27320,sumner,98390,1781,2018
pierce,victor falls elementary,548,2,4,2,6,2,49,445,44,277,271,130,27320,bonney lake,98391,4166,2018
yakima,chief kamiakin elementary,761,0,0,0,0,2,702,53,4,400,361,672,39201,sunnyside,98944,4000,2018
yakima,harrison middle,922,0,0,0,0,1,846,60,15,466,456,719,39201,sunnyside,98944,3313,2018
yakima,outlook elementary,590,0,0,0,0,0,542,43,5,297,293,552,39201,sunnyside,98944,2469,2018
yakima,pioneer elementary,742,0,0,0,0,0,696,35,11,393,349,633,39201,sunnyside,98944,4497,2018
yakima,shs graduation alliance,4,0,0,0,0,0,3,1,0,0,4,6,39201,sunnyside,98944,5352,2018
yakima,sierra vista middle,705,0,0,0,0,1,654,42,8,369,336,612,39201,sunnyside,98944,5049,2018
yakima,sun valley elementary,480,0,0,0,0,1,448,29,2,254,226,405,39201,sunnyside,98944,5137,2018
yakima,sunnyside high,1993,0,0,0,0,3,1836,137,17,1011,982,1490,39201,sunnyside,98944,2959,2018
yakima,washington elementary,684,0,0,0,0,0,633,49,2,349,335,623,39201,sunnyside,98944,2717,2018
kitsap,chief kitsap academy,69,35,0,2,2,1,7,7,16,41,28,54,18902,poulsbo,98370,5319,2018
pierce,angelo giaudrone middle,668,10,89,27,116,162,139,188,53,335,333,454,27010,tacoma,98408,4575,2018
pierce,arlington,367,4,20,21,41,64,89,114,55,193,174,287,27010,tacoma,98409,2940,2018
pierce,baker,741,4,124,30,154,135,202,184,62,373,368,534,27010,tacoma,98408,3054,2018
pierce,birney,434,5,38,16,54,72,130,114,59,216,218,332,27010,tacoma,98408,3449,2018
pierce,blix elementary,537,7,63,22,85,68,183,133,61,279,258,421,27010,tacoma,98404,2094,2018
pierce,boze,435,7,82,22,104,62,155,52,55,229,206,351,27010,tacoma,98404,3646,2018
pierce,browns point,428,1,54,1,55,9,56,230,77,224,204,62,27010,tacoma,98422,2872,2018
pierce,bryant,510,10,16,8,24,57,54,303,62,247,263,208,27010,tacoma,98405,3397,2018
pierce,comm based trans program,73,1,8,0,8,14,7,41,2,51,22,40,27010,tacoma,98405,1585,2018
pierce,crescent heights,466,3,53,11,64,26,82,228,63,235,231,148,27010,tacoma,98422,4537,2018
pierce,day reporting,23,1,0,0,0,6,3,10,3,13,10,24,27010,tacoma,98406,1797,2018
pierce,delong,416,8,22,16,38,87,78,149,56,202,214,290,27010,tacoma,98405,2939,2018
pierce,downing,285,2,11,0,11,31,49,148,44,148,137,153,27010,tacoma,98406,2747,2018
pierce,edison,431,3,23,24,47,68,113,119,81,226,205,335,27010,tacoma,98409,2871,2018
pierce,fawcett,440,5,59,7,66,37,108,152,72,224,216,298,27010,tacoma,98404,2772,2018
pierce,fern hill,306,1,26,18,44,33,82,77,69,168,138,219,27010,tacoma,98444,2167,2018
pierce,first creek middle,733,19,102,39,141,138,253,120,62,378,355,594,27010,tacoma,98404,5170,2018
pierce,foss,793,5,106,26,132,180,152,258,65,441,352,452,27010,tacoma,98405,3880,2018
pierce,franklin,306,4,9,3,12,43,65,119,63,170,136,239,27010,tacoma,98405,2148,2018
pierce,fresh start,382,10,20,3,23,77,73,169,30,189,193,188,27010,tacoma,98405,5307,2018
pierce,geiger,478,1,33,8,41,42,72,248,74,236,242,183,27010,tacoma,98465,2746,2018
pierce,grant,342,2,9,0,9,28,49,212,42,170,172,106,27010,tacoma,98406,3053,2018
pierce,gray,527,1,57,30,87,115,130,153,41,262,265,391,27010,tacoma,98409,2377,2018
pierce,helen b. stafford elementary,517,9,108,29,137,69,142,95,65,258,259,399,27010,tacoma,98444,5066,2018
pierce,industrial design engineering and art,209,3,21,3,24,26,20,132,4,148,61,70,27010,tacoma,98444,5458,2018
pierce,jason lee,548,9,25,15,40,144,87,226,42,281,267,325,27010,tacoma,98403,2338,2018
pierce,jefferson,319,1,9,1,10,24,43,183,58,155,164,165,27010,tacoma,98406,2103,2018
pierce,larchmont,364,3,43,16,59,50,103,91,58,184,180,265,27010,tacoma,98445,2036,2018
pierce,lincoln,1446,28,211,68,279,356,378,278,127,763,683,939,27010,tacoma,98418,2215,2018
pierce,lister,441,11,48,29,77,83,92,84,94,228,213,397,27010,tacoma,98404,2771,2018
pierce,lowell,432,0,7,2,9,20,53,309,41,222,210,64,27010,tacoma,98403,2805,2018
pierce,lyon,347,8,31,6,37,41,97,104,60,191,156,258,27010,tacoma,98404,2336,2018
pierce,manitou park,470,2,30,22,52,60,172,99,85,239,231,373,27010,tacoma,98409,2252,2018
pierce,mann,474,7,26,16,42,56,104,163,102,269,205,315,27010,tacoma,98408,2941,2018
pierce,mason,779,2,44,4,48,42,93,508,86,388,391,203,27010,tacoma,98407,2376,2018
pierce,mccarver,434,5,21,14,35,131,64,88,111,234,200,384,27010,tacoma,98405,3453,2018
pierce,meeker,674,9,71,19,90,66,78,351,80,369,305,183,27010,tacoma,98422,3244,2018
pierce,mt tahoma,1428,23,229,80,309,233,390,369,104,744,684,871,27010,tacoma,98409,3398,2018
pierce,northeast tacoma,372,3,36,12,48,29,67,165,60,192,180,186,27010,tacoma,98422,2247,2018
pierce,oakland high,188,7,5,0,5,56,33,57,30,81,107,150,27010,tacoma,98409,4109,2018
pierce,pearl street center,11,1,0,0,0,2,1,7,0,7,4,10,27010,tacoma,98465,4283,2018
pierce,point defiance,393,5,12,1,13,21,46,261,47,216,177,134,27010,tacoma,98407,2169,2018
pierce,reed,423,4,26,24,50,102,122,63,82,226,197,333,27010,tacoma,98418,2806,2018
pierce,roosevelt,260,8,15,18,33,44,93,43,39,134,126,211,27010,tacoma,98404,2275,2018
pierce,science and math institute,484,2,57,2,59,50,59,295,19,257,227,150,27010,tacoma,98407,5169,2018
pierce,sheridan,522,14,70,14,84,55,212,92,65,251,271,405,27010,tacoma,98404,2168,2018
pierce,sherman,413,1,9,0,9,8,30,323,42,216,197,52,27010,tacoma,98407,2938,2018
pierce,skyline,349,2,14,3,17,42,41,184,63,192,157,210,27010,tacoma,98406,3498,2018
pierce,special services,52,2,0,0,0,16,5,26,3,42,10,33,27010,tacoma,98405,5192,2018
pierce,stadium,1455,19,152,20,172,166,184,818,96,700,755,396,27010,tacoma,98403,2084,2018
pierce,stanley,303,6,7,14,21,79,47,96,54,156,147,216,27010,tacoma,98405,2358,2018
pierce,stewart,532,8,53,27,80,96,158,150,40,278,254,431,27010,tacoma,98465,2359,2018
pierce,tacoma school of the arts,615,11,34,8,42,125,81,335,21,172,443,201,27010,tacoma,98402,1860,2018
pierce,truman,769,10,65,12,77,122,113,391,56,392,377,414,27010,tacoma,98407,3448,2018
pierce,wainwright,390,4,20,3,23,77,62,181,43,189,201,182,27010,tacoma,98466,3116,2018
pierce,washington elementary,479,0,14,4,18,23,42,325,71,228,251,102,27010,tacoma,98407,2083,2018
pierce,whitman,391,3,39,21,60,46,75,116,91,197,194,278,27010,tacoma,98408,2874,2018
pierce,whittier,401,1,24,7,31,44,63,168,94,189,212,206,27010,tacoma,98466,3452,2018
pierce,wilson,1282,11,123,15,138,183,132,737,81,652,630,441,27010,tacoma,98406,3246,2018
grays harbor,taholah elementary & middle,111,79,0,0,0,0,18,0,14,58,53,93,14077,taholah,98587,5032,2018
grays harbor,taholah high,62,50,0,0,0,0,7,0,5,33,29,43,14077,taholah,98587,3580,2018
king,cedar river elementary,594,1,25,2,27,14,44,446,62,332,262,46,17409,maple valley,98038,5489,2018
king,glacier park elementary,655,1,34,14,48,15,78,445,68,342,313,78,17409,maple valley,98038,4453,2018
king,lake wilderness elementary,905,3,42,11,53,23,84,622,120,486,419,132,17409,maple valley,98038,3286,2018
king,maple view middle,967,4,56,11,67,23,113,655,105,486,481,147,17409,covington,98042,3937,2018
king,rock creek elementary,706,3,41,8,49,12,71,513,58,354,352,48,17409,maple valley,98038,4415,2018
king,shadow lake elementary,485,2,14,6,20,6,77,325,55,269,216,119,17409,maple valley,98038,3589,2018
king,summit trail middle,993,3,48,3,51,21,81,763,74,523,470,86,17409,ravensdale,98051,3341,2018
king,tahoma elementary,679,3,15,12,27,12,61,529,47,362,317,81,17409,maple valley,98038,5490,2018
king,tahoma senior high,2611,14,119,15,134,65,267,1934,197,1332,1279,247,17409,maple valley,98038,2849,2018
whitman,tekoa elementary,85,4,0,0,0,2,5,71,3,39,46,47,38265,tekoa,99033,2052,2018
whitman,tekoa high,94,6,0,0,0,1,8,78,1,44,50,52,38265,tekoa,99033,3418,2018
thurston,parkside elementary,317,1,2,0,2,0,42,250,22,175,142,156,34402,tenino,98589,2457,2018
thurston,tenino elementary,300,1,0,0,0,1,29,248,21,167,133,147,34402,tenino,98589,4238,2018
thurston,tenino high,354,4,3,1,4,2,21,317,6,166,188,131,34402,tenino,98589,3509,2018
thurston,tenino middle,292,2,1,0,1,0,19,254,16,166,126,136,34402,tenino,98589,3795,2018
kittitas,thorp elem & jr sr high,174,1,0,0,0,1,10,160,2,84,90,78,19400,thorp,98946,2514,2018
lewis,cowlitz prairie academy,32,1,0,0,0,0,2,25,4,13,19,23,21237,toledo,98591,5190,2018
lewis,toledo elementary,334,9,3,0,3,1,33,280,8,182,152,179,21237,toledo,98591,2998,2018
lewis,toledo high,253,3,2,1,3,2,20,203,22,131,122,101,21237,toledo,98591,2616,2018
lewis,toledo middle,188,3,0,0,0,1,22,154,8,102,86,96,21237,toledo,98591,3977,2018
okanogan,tonasket elementary,527,2,0,0,0,2,215,285,23,274,253,381,24404,tonasket,98855,3176,2018
okanogan,tonasket high,341,2,3,0,3,0,121,205,10,189,152,184,24404,tonasket,98855,2679,2018
okanogan,tonasket middle,295,3,0,1,1,0,124,156,11,144,151,203,24404,tonasket,98855,4196,2018
yakima,computer academy toppenish high,135,28,0,0,0,0,97,10,0,84,51,152,39202,toppenish,98948,1508,2018
yakima,garfield elementary,415,44,1,0,1,1,354,11,4,188,227,389,39202,toppenish,98948,2608,2018
yakima,kirkwood elementary,550,135,3,0,3,0,399,8,5,289,261,493,39202,toppenish,98948,4106,2018
yakima,lincoln elementary,392,50,0,0,0,0,333,5,4,200,192,359,39202,toppenish,98948,2635,2018
yakima,nw allprep,715,12,32,1,33,28,65,574,3,348,367,284,39202,vancouver,98684,5262,2018
yakima,toppenish high,971,102,0,0,0,1,837,27,4,480,491,795,39202,toppenish,98948,2900,2018
yakima,toppenish middle,897,127,0,0,0,2,737,19,12,455,442,803,39202,toppenish,98948,2264,2018
yakima,toppenish pre,55,7,0,0,0,0,45,3,0,34,21,68,39202,toppenish,98948,1831,2018
yakima,valley view elementary,474,26,0,0,0,0,434,13,1,247,227,441,39202,toppenish,98948,4588,2018
walla walla,touchet elem & high,202,1,0,0,0,0,106,93,2,110,92,123,36300,touchet,99360,2160,2018
cowlitz,toutle lake elementary,384,3,0,1,1,1,27,333,19,203,181,162,08130,toutle,98649,4264,2018
cowlitz,toutle lake high,307,5,2,1,3,2,22,266,9,165,142,102,08130,toutle,98649,2560,2018
klickitat,trout lake elementary,91,0,1,0,1,0,8,75,7,41,50,0,20400,trout lake,98650,3062,2018
klickitat,trout lake,151,5,3,0,3,0,26,109,8,73,78,0,20400,trout lake,98650,2676,2018
king,cascade view elementary,492,2,159,12,171,73,164,62,20,259,233,428,17406,tukwila,98168,3226,2018
king,foster senior high,924,9,315,38,353,189,234,95,44,490,434,564,17406,tukwila,98168,2848,2018
king,showalter middle,628,5,189,23,212,107,195,76,33,324,304,424,17406,tukwila,98168,2564,2018
king,thorndyke elementary,373,8,69,16,85,95,121,29,35,200,173,316,17406,tukwila,98168,3635,2018
king,tukwila elementary,542,3,117,13,130,121,157,62,69,259,283,364,17406,tukwila,98168,3488,2018
thurston,a g west black hills high,903,9,34,5,39,19,90,653,93,448,455,184,34033,tumwater,98512,4500,2018
thurston,black lake elementary,405,3,7,0,7,3,46,306,40,197,208,130,34033,olympia,98512,4205,2018
thurston,east olympia elementary,529,2,6,0,6,1,71,403,46,271,258,161,34033,olympia,98501,4365,2018
thurston,george washington bush middle,781,3,13,4,17,8,99,575,79,401,380,216,34033,tumwater,98512,4452,2018
thurston,littlerock elementary,291,0,7,2,9,1,35,213,33,157,134,95,34033,olympia,98512,2816,2018
thurston,michael t simmons elementary,700,2,22,4,26,21,87,486,78,386,314,266,34033,tumwater,98512,2552,2018
thurston,new market high,73,2,0,1,1,2,11,50,7,46,27,17,34033,tumwater,98501,5014,2018
thurston,peter g schmidt elementary,596,4,11,3,14,10,86,422,60,313,283,233,34033,tumwater,98501,3199,2018
thurston,secondary options,125,0,1,0,1,2,10,98,14,60,65,35,34033,olympia,98512,1713,2018
thurston,tumwater high,1251,5,28,11,39,19,150,936,102,656,595,293,34033,tumwater,98501,3362,2018
thurston,tumwater hill elementary,423,1,43,2,45,7,57,262,51,217,206,93,34033,tumwater,98512,4373,2018
thurston,tumwater middle,713,3,27,5,32,13,91,499,75,359,354,202,34033,tumwater,98512,3612,2018
yakima,union gap,605,8,5,0,5,1,484,99,8,317,288,563,39002,union gap,98903,2714,2018
pierce,chambers elementary,498,1,48,11,59,62,93,224,59,256,242,196,27083,university pla,98467,3792,2018
pierce,curtis junior high,970,4,91,10,101,82,141,486,156,486,484,310,27083,university place,98466,3179,2018
pierce,curtis senior high,1424,8,179,14,193,127,159,728,209,729,695,393,27083,university place,98466,3600,2018
pierce,drum intermediate,592,2,57,12,69,65,95,266,95,307,285,195,27083,university pla,98467,4325,2018
pierce,evergreen primary,528,2,58,10,68,39,83,218,118,274,254,160,27083,university place,98466,4447,2018
pierce,narrows view intermediate,686,6,59,6,65,55,110,338,112,343,343,271,27083,university pla,98466,3296,2018
pierce,sunset primary,485,0,23,16,39,33,72,248,93,272,213,170,27083,university place,98466,3601,2018
pierce,university place primary,516,1,24,7,31,56,83,248,97,273,243,239,27083,university pla,98466,2223,2018
stevens,columbia virtual academy,152,0,5,0,5,4,16,112,15,75,77,1,33070,valley,99181,1932,2018
stevens,paideia high,64,1,0,0,0,0,7,53,3,35,29,29,33070,valley,99181,5223,2018
stevens,valley early learning center,8,0,0,0,0,0,1,7,0,5,3,2,33070,valley,99181,5357,2018
stevens,valley,200,3,1,0,1,2,16,161,17,117,83,145,33070,valley,99181,2405,2018
clark,alki middle,629,3,25,2,27,8,63,480,48,329,300,145,06037,vancouver,98685,4406,2018
clark,benjamin franklin elementary,401,1,39,0,39,6,44,236,75,192,209,62,06037,vancouver,98663,3080,2018
clark,chinook elementary,762,2,19,2,21,8,84,579,68,407,355,139,06037,vancouver,98685,4405,2018
clark,columbia river high,1188,8,40,7,47,18,166,859,90,601,587,238,06037,vancouver,98665,3423,2018
clark,discovery middle,680,1,14,12,26,31,260,306,56,335,345,445,06037,vancouver,98663,4503,2018
clark,dwight d eisenhower elementary,569,3,19,9,28,9,104,368,57,292,277,225,06037,vancouver,98665,3733,2018
clark,early childhood education center,311,2,5,7,12,10,93,156,38,208,103,173,06037,vancouver,98668,2636,2018
clark,felida elementary,683,1,27,2,29,10,58,537,48,349,334,83,06037,vancouver,98685,4075,2018
clark,fir grove childrens center,45,2,0,0,0,1,10,28,4,39,6,40,06037,vancouver,98661,1574,2018
clark,fort vancouver high,1559,4,70,90,160,62,638,599,96,755,804,946,06037,vancouver,98661,2179,2018
clark,fruit valley elementary,272,0,5,8,13,6,135,87,31,134,138,239,06037,vancouver,98680,2637,2018
clark,gaiser middle,889,7,34,20,54,36,290,443,59,468,421,459,06037,vancouver,98665,3902,2018
clark,gate program,32,1,0,0,0,1,4,24,2,21,11,13,06037,vancouver,98661,1738,2018
clark,george c marshall elementary,394,4,8,11,19,12,138,190,31,213,181,265,06037,vancouver,98661,3424,2018
clark,harney elementary,670,6,10,20,30,12,270,296,56,335,335,387,06037,vancouver,98661,2643,2018
clark,harry s truman elementary,561,5,25,24,49,19,131,296,61,280,281,341,06037,vancouver,98661,3735,2018
clark,hazel dell elementary,435,0,7,0,7,12,144,228,44,220,215,287,06037,vancouver,98665,2690,2018
clark,hough elementary,300,0,6,0,6,11,56,194,33,152,148,154,06037,vancouver,98660,2610,2018
clark,hudson's bay high,1243,11,20,26,46,47,389,667,83,629,614,654,06037,vancouver,98663,3081,2018
clark,jason lee middle,717,5,39,10,49,16,172,415,60,382,335,300,06037,vancouver,98665,3543,2018
clark,jefferson middle,847,6,24,6,30,12,116,622,61,434,413,196,06037,vancouver,98685,4591,2018
clark,lake shore elementary,441,1,13,3,16,5,44,333,42,239,202,108,06037,vancouver,98665,3017,2018
clark,lewis and clark high,93,0,0,1,1,1,21,63,7,38,55,50,06037,vancouver,98661,3932,2018
clark,lincoln elementary,368,4,8,3,11,15,76,223,39,205,163,220,06037,vancouver,98660,2318,2018
clark,martin luther king elementary,491,1,10,22,32,14,273,126,45,243,248,396,06037,vancouver,98661,3734,2018
clark,mcloughlin middle,1011,3,33,59,92,30,488,325,73,487,524,707,06037,vancouver,98661,3146,2018
clark,minnehaha elementary,531,1,14,18,32,12,118,325,43,252,279,305,06037,vancouver,98663,2723,2018
clark,open doors vancouver,72,2,0,1,1,3,21,41,4,37,35,37,06037,vancouver,98668,5342,2018
clark,peter s ogden elementary,549,5,18,27,45,14,225,218,42,281,268,382,06037,vancouver,98662,2644,2018
clark,roosevelt elementary,671,2,16,45,61,18,336,201,53,374,297,546,06037,vancouver,98661,4410,2018
clark,sacajawea elementary,402,0,7,0,7,9,84,261,41,223,179,193,06037,vancouver,98685,4034,2018
clark,salmon creek elementary,510,1,21,0,21,1,56,387,44,239,271,147,06037,vancouver,98685,2964,2018
clark,sarah j anderson elementary,771,4,18,8,26,19,300,380,42,407,364,402,06037,vancouver,98686,3016,2018
clark,skyview high,1987,4,94,16,110,48,277,1393,155,1058,929,367,06037,vancouver,98685,4504,2018
clark,vancouver home connection,194,2,0,0,0,1,11,165,15,85,109,61,06037,vancouver,98668,3556,2018
clark,vancouver itech preparatory,391,2,15,4,19,6,58,275,31,272,119,86,06037,vancouver,98668,5271,2018
clark,vancouver school of arts and academics,594,5,22,6,28,9,64,450,38,191,403,94,06037,vancouver,98663,1689,2018
clark,vancouver virtual learning academy,399,3,3,7,10,7,99,255,25,213,186,248,06037,vancouver,98668,5149,2018
clark,walnut grove elementary,748,6,31,17,48,22,214,380,78,378,370,470,06037,vancouver,98661,2828,2018
clark,washington elementary,346,2,4,9,13,10,179,119,23,177,169,295,06037,vancouver,98663,3565,2018
king,chautauqua elementary,586,0,7,0,7,2,91,432,54,295,291,147,17402,vashon,98070,4468,2018
king,family link,53,0,0,0,0,0,1,46,6,33,20,8,17402,vashon,98070,1822,2018
king,mcmurray middle,385,0,5,1,6,2,45,290,42,220,165,70,17402,vashon,98070,3667,2018
king,student link,34,1,2,0,2,1,1,24,5,12,22,14,17402,vashon,98070,1938,2018
king,vashon island high,547,2,21,0,21,3,54,432,35,306,241,89,17402,vashon,98070,2419,2018
wahkiakum,julius a wendt elementary/john c thomas middle,331,2,0,2,2,0,31,272,24,169,162,211,35200,cathlamet,98612,2893,2018
wahkiakum,wahkiakum high,154,2,1,0,1,2,11,133,5,91,63,82,35200,cathlamet,98612,3467,2018
grant,developmental pre-school,9,0,0,0,0,0,9,0,0,7,2,6,13073,mattawa,99349,1981,2018
grant,mattawa elementary pre-school,18,0,0,0,0,0,18,0,0,16,2,19,13073,mattawa,99349,5120,2018
walla walla,preston hall middle,71,0,1,0,1,0,17,47,6,32,39,38,36401,waitsburg,99361,2174,2018
walla walla,waitsburg elementary,129,1,3,0,3,0,25,95,5,68,61,81,36401,waitsburg,99361,2712,2018
walla walla,waitsburg high,86,0,1,0,1,0,9,72,4,46,40,33,36401,waitsburg,99361,2386,2018
walla walla,alternative education program,109,0,1,0,1,1,25,82,0,57,52,34,36140,walla walla,99362,2407,2018
walla walla,berney elementary,457,1,6,0,6,5,74,353,18,252,205,175,36140,walla walla,99362,2074,2018
walla walla,blue ridge elementary,352,0,1,0,1,4,251,87,9,172,180,317,36140,walla walla,99362,4193,2018
walla walla,edison elementary school - walla walla,405,2,3,0,3,1,254,134,11,199,206,292,36140,walla walla,99362,2528,2018
walla walla,garrison middle,620,2,10,2,12,7,248,334,17,349,271,296,36140,walla walla,99362,3510,2018
walla walla,green park elementary,425,2,3,0,3,3,169,232,16,220,205,278,36140,walla walla,99362,2078,2018
walla walla,lincoln high,176,2,0,0,0,1,35,133,5,98,78,137,36140,walla walla,99362,4071,2018
walla walla,opportunity youth reengagement,26,2,1,0,1,0,14,8,1,13,13,14,36140,walla walla,99362,5460,2018
walla walla,pioneer middle,665,2,11,1,12,4,278,344,25,342,323,341,36140,walla walla,99362,2780,2018
walla walla,prospect point elementary,467,1,4,0,4,3,93,342,24,240,227,166,36140,walla walla,99362,2159,2018
walla walla,sharpstein elementary,412,2,4,0,4,0,208,176,22,209,203,259,36140,walla walla,99362,3728,2018
walla walla,walla walla high,1711,11,31,0,31,14,649,950,56,826,885,756,36140,walla walla,99362,3468,2018
yakima,adams elementary,369,67,6,0,6,0,268,12,16,212,157,335,39207,wapato,98951,4518,2018
yakima,camas elementary,599,151,12,0,12,0,401,14,21,323,276,554,39207,wapato,98951,5544,2018
yakima,pace alternative high,80,40,0,0,0,0,35,3,2,45,35,62,39207,wapato,98951,4022,2018
yakima,satus elementary,618,97,5,0,5,0,482,16,18,347,271,552,39207,wapato,98951,2757,2018
yakima,wapato high,882,153,18,3,21,1,642,37,28,445,437,679,39207,wapato,98951,3141,2018
yakima,wapato middle,831,178,18,0,18,0,585,24,26,440,391,723,39207,wapato,98951,2131,2018
grant,warden elementary,479,0,0,0,0,4,383,89,3,250,229,393,13146,warden,98857,2792,2018
grant,warden high,283,0,1,0,1,0,219,56,7,141,142,219,13146,warden,98857,3273,2018
grant,warden middle,229,0,0,0,0,1,182,43,3,93,136,202,13146,warden,98857,3909,2018
clark,canyon creek middle,230,2,1,0,1,1,11,203,12,120,110,46,06112,washougal,98671,4549,2018
clark,cape horn skye elementary,331,2,2,0,2,2,19,290,16,175,156,77,06112,washougal,98671,3270,2018
clark,columbia river gorge elementary,411,1,1,1,2,1,62,320,25,211,200,166,06112,washougal,98671,5494,2018
clark,gause elementary,352,0,2,0,2,3,28,298,21,186,166,119,06112,washougal,98671,2911,2018
clark,hathaway elementary,301,1,1,1,2,2,42,231,23,142,159,142,06112,washougal,98671,2509,2018
clark,jemtegaard middle,527,2,3,0,3,3,69,416,34,252,275,204,06112,washougal,98671,4207,2018
clark,washougal high,1051,7,29,3,32,11,108,817,76,565,486,290,06112,washougal,98671,3147,2018
clark,washougal special services,33,0,0,0,0,0,3,24,6,24,9,13,06112,washougal,98671,1899,2018
adams,washtucna elementary/high,48,0,0,0,0,0,5,43,0,29,19,38,01109,washtucna,99371,3075,2018
douglas,waterville elementary,134,7,0,0,0,0,20,105,2,63,71,84,09209,waterville,98858,2161,2018
douglas,waterville high,152,4,1,0,1,0,42,101,4,81,71,62,09209,waterville,98858,2162,2018
stevens,wellpinit elementary,184,147,0,0,0,0,8,6,18,99,85,174,33049,wellpinit,99040,2549,2018
stevens,wellpinit fort simcoe sea,46,1,0,1,1,2,6,34,2,36,10,11,33049,wellpinit,99040,5461,2018
stevens,wellpinit high,84,59,0,0,0,0,10,3,12,46,38,64,33049,wellpinit,99040,2550,2018
stevens,wellpinit middle,79,56,0,0,0,0,3,4,16,46,33,61,33049,wellpinit,99040,4232,2018
chelan,abraham lincoln elementary,521,0,0,0,0,1,393,123,4,274,247,426,04246,wenatchee,98801,3209,2018
chelan,columbia elementary,437,0,0,0,0,3,328,98,8,227,210,361,04246,wenatchee,98801,2301,2018
chelan,foothills middle,604,1,13,0,13,1,261,313,15,296,308,298,04246,wenatchee,98801,4432,2018
chelan,john newbery elementary,475,2,3,0,3,0,199,260,11,251,224,275,04246,wenatchee,98801,4423,2018
chelan,lewis and clark elementary,479,1,6,0,6,1,333,133,5,257,222,352,04246,wenatchee,98801,2279,2018
chelan,mission view elementary,504,1,1,0,1,2,357,141,2,270,234,405,04246,wenatchee,98801,2347,2018
chelan,open doors re-engagement wenatchee,92,2,0,0,0,0,41,48,1,58,34,49,04246,wenatchee,98807,5316,2018
chelan,orchard middle,494,0,3,0,3,3,300,175,13,255,239,352,04246,wenatchee,98801,3370,2018
chelan,pioneer middle,604,7,3,1,4,2,326,256,9,317,287,375,04246,wenatchee,98801,3210,2018
chelan,skill source,3,0,0,0,0,0,1,2,0,1,2,4,04246,wenatchee,98801,1612,2018
chelan,sunnyslope elementary,306,0,5,1,6,0,58,224,18,155,151,76,04246,wenatchee,98801,3208,2018
chelan,valley academy of learning,198,3,4,0,4,2,9,172,8,102,96,31,04246,wenatchee,98801,1742,2018
chelan,washington elementary,559,0,6,1,7,8,194,337,13,298,261,228,04246,wenatchee,98801,2907,2018
chelan,wenatchee high,2075,4,22,2,24,11,946,1027,63,1061,1014,985,04246,wenatchee,98801,2134,2018
chelan,westside high,254,2,0,1,1,2,119,122,8,125,129,155,04246,wenatchee,98801,1613,2018
spokane,centennial middle,635,6,7,1,8,13,65,476,67,346,289,350,32363,spokane,99212,3538,2018
spokane,dishman hills high,318,2,1,3,4,7,32,256,17,158,160,241,32363,spokane,99206,1628,2018
spokane,millwood kindergarten center,220,1,4,0,4,3,16,179,17,124,96,118,32363,spokane,99212,2711,2018
spokane,ness elementary,304,3,0,0,0,5,24,252,20,170,134,189,32363,spokane,99206,3196,2018
spokane,orchard center elementary,246,9,0,1,1,6,20,183,27,134,112,164,32363,spokane,99212,3129,2018
spokane,pasadena park elementary,382,0,10,1,11,2,23,317,29,203,179,134,32363,spokane,99212,3194,2018
spokane,re-engagement,4,0,0,0,0,0,0,4,0,1,3,0,32363,spokane,99212,5356,2018
spokane,seth woodard elementary,279,0,3,2,5,2,28,216,28,147,132,150,32363,spokane,99212,2956,2018
spokane,spokane valley high,98,1,0,0,0,1,3,85,8,48,50,48,32363,spokane,99212,1838,2018
spokane,spokane valley transition,128,0,0,0,0,1,10,104,13,51,77,100,32363,spokane,99212,1842,2018
spokane,west valley city,220,0,1,1,2,1,21,183,13,94,126,78,32363,spokane,99212,1755,2018
spokane,west valley early learning center,85,1,0,0,0,0,3,71,10,56,29,51,32363,spokane valley,99212,5462,2018
spokane,west valley high,929,2,25,2,27,18,80,740,62,462,467,338,32363,spokane,99212,3195,2018
yakima,ahtanum valley elementary,274,7,0,0,0,1,91,165,10,127,147,169,39208,yakima,98908,2822,2018
yakima,apple valley elementary,345,1,8,2,10,3,92,229,10,170,175,95,39208,yakima,98908,3699,2018
yakima,children's village,24,0,0,0,0,0,6,18,0,15,9,0,39208,yakima,98902,5096,2018
yakima,cottonwood elementary,445,1,18,0,18,7,122,276,21,221,224,123,39208,yakima,98908,4448,2018
yakima,mountainview elementary,188,1,0,0,0,0,50,132,5,102,86,104,39208,yakima,98908,2758,2018
yakima,summitview elementary,344,1,1,0,1,3,145,172,22,157,187,165,39208,yakima,98908,3207,2018
yakima,west valley high,1121,11,32,5,37,13,288,743,29,598,523,357,39208,yakima,98908,3074,2018
yakima,west valley high school freshman campus,445,6,7,1,8,3,125,299,4,205,240,166,39208,yakima,98908,5221,2018
yakima,west valley jr high,824,12,23,1,24,4,238,520,26,429,395,356,39208,yakima,98908,4040,2018
yakima,west valley middle,865,8,29,2,31,7,270,516,33,433,432,388,39208,yakima,98908,4506,2018
yakima,west valley preschool,57,1,0,0,0,0,14,40,2,46,11,0,39208,yakima,98903,5008,2018
yakima,west valley virtual academy 7-8,8,0,0,0,0,0,2,6,0,4,4,2,39208,yakima,98908,5505,2018
yakima,west valley virtual academy 9-12,104,0,3,0,3,0,23,76,2,61,43,24,39208,yakima,98908,5506,2018
yakima,west valley virtual academy k-6,6,0,0,0,0,0,0,6,0,3,3,8,39208,yakima,98908,5504,2018
yakima,wide hollow elementary,389,2,13,1,14,2,153,202,16,209,180,238,39208,yakima,98908,2505,2018
lewis,white pass elementary,188,1,0,1,1,3,18,164,1,93,95,129,21303,randle,98377,3555,2018
lewis,white pass jr. sr. high,220,2,0,0,0,3,12,198,5,112,108,133,21303,randle,98377,2859,2018
pierce,elk ridge elementary,427,2,1,0,1,2,41,347,34,211,216,141,27416,buckley,98321,2190,2018
pierce,foothills elementary,577,2,14,0,14,10,88,452,11,296,281,244,27416,buckley,98321,4309,2018
pierce,glacier middle,812,7,5,0,5,4,93,661,42,421,391,244,27416,buckley,98321,3458,2018
pierce,mountain meadow elementary,540,5,5,0,5,8,61,419,42,272,268,143,27416,buckley,98321,4471,2018
pierce,white river high,1197,9,18,2,20,5,104,1001,58,635,562,310,27416,buckley,98321,4569,2018
pierce,white river reengagement program,19,1,0,0,0,0,0,17,1,8,11,9,27416,buckley,98321,5338,2018
pierce,white river special ed services,24,2,0,0,0,0,4,18,0,12,12,7,27416,buckley,98321,5045,2018
pierce,wilkeson elementary,289,1,1,0,1,2,26,239,20,153,136,72,27416,wilkeson,98396,4170,2018
klickitat,columbia high,392,4,4,0,4,0,125,251,8,195,197,141,20405,white salmon,98672,2330,2018
klickitat,hulan l whitson elem,409,2,1,0,1,1,132,261,12,218,191,182,20405,white salmon,98672,2997,2018
klickitat,wallace & priscilla stevenson intermediate,311,4,1,1,2,1,96,198,10,182,129,139,20405,white salmon,98672,5368,2018
klickitat,wayne m henkle middle,188,0,0,0,0,0,68,116,4,103,85,72,20405,white salmon,98672,3394,2018
klickitat,white salmon academy,21,0,0,0,0,0,10,11,0,11,10,12,20405,white salmon,98672,5077,2018
lincoln,wilbur elementary,121,6,0,1,1,0,6,98,10,70,51,54,22200,wilbur,99185,3290,2018
lincoln,wilbur secondary,138,14,0,1,1,0,11,103,9,64,74,54,22200,wilbur,99185,3289,2018
pacific,willapa elementary,169,3,0,0,0,0,21,137,8,83,86,72,25160,menlo,98561,3444,2018
pacific,willapa valley middle-high,194,1,2,0,2,0,22,158,11,99,95,83,25160,menlo,98561,2542,2018
grant,wilson creek elementary,69,0,0,0,0,0,16,52,1,35,34,49,13167,wilson creek,98860,2472,2018
grant,wilson creek high,72,1,2,0,2,0,10,59,0,33,39,42,13167,wilson creek,98860,2473,2018
lewis,winlock middle,163,0,1,0,1,0,41,109,12,87,76,129,21232,winlock,98596,4369,2018
lewis,winlock miller elementary,342,1,0,0,0,0,77,234,28,173,169,281,21232,winlock,98596,2290,2018
lewis,winlock senior high,179,3,0,0,0,0,48,116,12,99,80,141,21232,winlock,98596,3597,2018
lewis,winolequa learning academy,27,1,0,0,0,0,2,22,2,19,8,32,21232,winlock,98596,1829,2018
grays harbor,wishkah valley elementary/high,153,0,1,0,1,3,6,143,0,73,80,79,14117,aberdeen,98520,3375,2018
klickitat,wishram high and elementary,71,9,0,0,0,0,5,51,6,50,21,55,20094,wishram,98673,2605,2018
cowlitz,lewis river academy,56,0,1,0,1,1,8,41,5,33,23,17,08404,woodland,98674,5246,2018
cowlitz,team high,90,1,0,0,0,1,5,81,2,46,44,49,08404,woodland,98674,1795,2018
cowlitz,woodland high,727,2,5,1,6,8,131,561,19,386,341,285,08404,woodland,98674,3546,2018
cowlitz,woodland intermediate,494,2,5,1,6,4,128,343,11,259,235,242,08404,woodland,98674,5408,2018
cowlitz,woodland middle,731,3,3,0,3,6,152,543,24,383,348,344,08404,woodland,98674,5409,2018
cowlitz,woodland primary,351,1,0,0,0,0,83,249,18,184,167,171,08404,woodland,98674,5407,2018
cowlitz,yale elementary,40,1,0,0,0,0,4,33,2,20,20,15,08404,ariel,98603,3513,2018
yakima,adams elementary,695,3,0,0,0,1,665,25,1,350,345,624,39007,yakima,98901,2592,2018
yakima,barge-lincoln elementary,622,5,1,0,1,4,570,33,9,316,306,550,39007,yakima,98901,3138,2018
yakima,davis high,2403,14,16,1,17,20,2013,266,73,1198,1205,1405,39007,yakima,98902,2116,2018
yakima,discovery lab,211,1,0,0,0,2,114,80,14,95,116,95,39007,yakima,98902,3023,2018
yakima,early childhood center,184,0,1,0,1,0,143,36,4,111,73,133,39007,yakima,98902,5019,2018
yakima,eisenhower high,2128,15,18,1,19,15,1506,520,53,1065,1063,1207,39007,yakima,98908,3206,2018
yakima,franklin middle,837,18,1,0,1,3,643,152,20,432,405,604,39007,yakima,98902,2410,2018
yakima,garfield elementary,516,2,1,0,1,4,469,32,8,264,252,469,39007,yakima,98902,2176,2018
yakima,gilbert elementary,565,13,3,1,4,5,376,145,22,286,279,378,39007,yakima,98908,2818,2018
yakima,hoover elementary,762,5,1,5,6,2,661,76,12,402,360,657,39007,yakima,98902,2715,2018
yakima,lewis & clark middle,874,7,1,2,3,2,755,96,11,440,434,667,39007,yakima,98902,3615,2018
yakima,martin luther king jr elementary,626,8,0,0,0,4,572,38,4,325,301,512,39007,yakima,98903,3817,2018
yakima,mcclure elementary school yakima,622,0,2,0,2,6,452,143,19,298,324,467,39007,yakima,98902,2899,2018
yakima,mckinley elementary,454,1,0,0,0,5,364,71,13,227,227,373,39007,yakima,98902,2177,2018
yakima,nob hill elementary,490,3,0,0,0,4,273,190,20,260,230,247,39007,yakima,98902,2819,2018
yakima,ridgeview elementary,631,6,2,0,2,6,512,96,9,317,314,494,39007,yakima,98903,2433,2018
yakima,robertson elementary,520,6,1,0,1,3,381,115,14,255,265,398,39007,yakima,98902,3264,2018
yakima,roosevelt elementary,524,4,4,1,5,8,400,94,13,278,246,411,39007,yakima,98902,2529,2018
yakima,stanton academy,239,3,0,0,0,6,174,48,8,133,106,209,39007,yakima,98902,4093,2018
yakima,washington middle,801,7,0,0,0,6,746,37,5,404,397,697,39007,yakima,98901,2314,2018
yakima,whitney elementary yakima,533,0,7,0,7,4,354,150,18,258,275,317,39007,yakima,98908,3312,2018
yakima,wilson middle,865,13,3,1,4,8,566,245,29,429,436,519,39007,yakima,98908,3368,2018
yakima,yakima online,75,2,0,0,0,0,40,28,5,26,49,56,39007,yakima,98902,5153,2018
yakima,yakima open doors,105,3,0,1,1,1,75,23,2,42,63,74,39007,yakima,98901,5355,2018
yakima,yakima satellite alternative programs,22,0,0,0,0,0,6,13,3,11,11,18,39007,yakima,98902,5224,2018
thurston,fort stevens elementary,535,11,13,4,17,4,78,358,67,270,265,273,34002,yelm,98597,4346,2018
thurston,lackamas elementary,333,6,2,3,5,8,37,242,35,178,155,112,34002,yelm,98597,5018,2018
thurston,mckenna elementary,422,4,2,2,4,1,65,300,48,217,205,196,34002,yelm,98597,2260,2018
thurston,mill pond elementary,457,0,10,6,16,8,78,288,67,241,216,192,34002,yelm,98597,4451,2018
thurston,ridgeline middle,603,14,6,7,13,2,94,414,66,318,285,236,34002,yelm,98597,5052,2018
thurston,southworth elementary,541,28,7,8,15,8,104,319,67,293,248,226,34002,yelm,98597,3848,2018
thurston,yelm extension,115,3,0,0,0,1,7,94,10,59,56,48,34002,yelm,98597,1627,2018
thurston,yelm high school 12,1681,18,26,18,44,34,234,1178,173,829,852,527,34002,yelm,98597,2633,2018
thurston,yelm middle,671,16,12,6,18,5,108,450,74,328,343,301,34002,yelm,98597,2481,2018
thurston,yelm prairie elementary,465,7,1,0,1,2,84,329,42,254,211,191,34002,yelm,98597,4224,2018
yakima,hilton elementary,375,12,0,0,0,0,214,130,19,187,188,229,39205,zillah,98953,2783,2018
yakima,zillah high,432,16,1,0,1,0,210,194,11,235,197,199,39205,zillah,98953,2240,2018
yakima,zillah intermediate,289,11,2,0,2,1,157,106,12,158,131,170,39205,zillah,98953,4221,2018
yakima,zillah middle,207,11,0,0,0,0,109,80,7,123,84,114,39205,zillah,98953,4481,2018
